State,City,Population,None,High School,Associates,Bachelors,Graduate,Total
Alabama,La Fayette,2945,525,858,412,113,84,1992
Alabama,Altoona,890,122,222,191,12,16,563
Alabama,Benton,47,0,6,23,3,11,43
Alabama,Mosses,1073,165,353,121,20,25,684
Alabama,Ohatchee,1293,101,356,306,114,47,924
Alabama,Saks,10763,1380,2544,2352,487,507,7270
Alabama,New Brockton,1127,163,269,244,83,18,777
Alabama,Madrid,301,43,77,78,15,2,215
Alabama,Oakman,691,117,145,114,36,10,422
Alabama,Toxey,118,21,36,13,12,0,82
Alabama,Sylvan Springs,1670,156,460,404,84,86,1190
Alabama,Helena,17861,440,1874,3645,4032,1952,11943
Alabama,Hoover,84480,2143,7677,14869,20516,12926,58131
Alabama,Midfield,5158,549,1396,1099,492,113,3649
Alabama,Vestavia Hills,34163,569,2175,4568,8676,7548,23536
Alabama,Andalusia,8864,870,1928,1858,829,485,5970
Alabama,Horn Hill,262,55,57,51,8,0,171
Alabama,Onycha,119,30,18,15,4,0,67
Alabama,Red Level,324,59,83,62,15,6,225
Alabama,Birmingham,212021,20165,41444,45946,23616,14262,145433
Alabama,Fort Deposit,1630,213,446,170,40,87,956
Alabama,Reece City,729,91,247,170,39,8,555
Alabama,Trafford,640,92,216,95,27,18,448
Alabama,Rock Creek,1369,38,473,338,102,63,1014
Alabama,Babbie,557,58,150,163,14,9,394
Alabama,Shorter,433,82,124,86,29,12,333
Alabama,Tuskegee,8699,836,1101,1408,683,466,4494
Alabama,Clayton,2900,878,818,399,58,29,2182
Alabama,Heath,339,32,51,67,30,16,196
Alabama,Opp,6520,864,1724,1346,345,185,4464
Alabama,Hayneville,1028,209,288,148,22,45,712
Alabama,Carrollton,1056,168,185,205,78,36,672
Alabama,Boaz,9553,1178,1650,2210,744,488,6270
Alabama,Rainbow City,9581,534,1950,2321,1195,829,6829
Alabama,Lowndesboro,99,5,11,46,8,8,78
Alabama,Alexandria,4000,320,870,1058,368,229,2845
Alabama,Brookside,1538,195,421,265,45,27,953
Alabama,Forestdale,9273,414,1884,2725,1179,491,6693
Alabama,Gardendale,13875,614,3046,3377,1722,1019,9778
Alabama,Grayson Valley,5986,369,1226,1901,612,211,4319
Alabama,Graysville,1965,284,635,449,114,27,1509
Alabama,Hueytown,15583,1245,3640,3721,1013,603,10222
Alabama,Berry,1400,237,379,200,76,9,901
Alabama,Belk,243,72,59,31,8,6,176
Alabama,Anniston,21924,2596,4891,4820,1570,1607,15484
Alabama,Atmore,9746,1827,3180,1179,460,256,6902
Alabama,Mignon,974,125,222,256,38,19,660
Alabama,Triana,686,81,121,160,122,40,524
Alabama,Meadowbrook,9387,132,545,2090,2365,1108,6240
Alabama,Dayton,26,0,0,7,2,5,14
Alabama,Demopolis,6918,736,1574,1298,643,436,4687
Alabama,Sweet Water,326,9,57,48,56,12,182
Alabama,Huguley,2273,348,726,477,136,28,1715
Alabama,Shiloh,321,50,74,64,29,5,222
Alabama,Ozark,14456,1566,3493,3481,1122,641,10303
Alabama,Goldville,33,4,8,7,2,4,25
Alabama,Waverly,154,1,31,40,26,27,125
Alabama,Valley,9305,785,2441,2019,651,173,6069
Alabama,Littleville,1104,116,371,198,34,15,734
Alabama,Bear Creek,1256,209,339,245,34,41,868
Alabama,Lexington,927,54,317,146,43,20,580
Alabama,Decatur,54617,6390,9908,12028,6554,2637,37517
Alabama,Lincoln,6600,747,1661,1559,675,239,4881
Alabama,Woodland,204,21,56,38,27,22,164
Alabama,Fairhope,20327,582,2045,3883,4720,2847,14077
Alabama,Hartselle,14405,881,2957,3530,1550,976,9894
Alabama,North Johns,188,19,68,44,2,4,137
Alabama,Powell,1089,304,232,201,27,12,776
Alabama,Camp Hill,1101,160,270,128,38,21,617
Alabama,Lineville,2471,331,544,501,105,93,1574
Alabama,Heflin,3449,519,805,679,225,110,2338
Alabama,Akron,295,55,82,67,5,1,210
Alabama,Moundville,2774,259,587,566,203,124,1739
Alabama,Guntersville,8377,1124,1376,1599,1187,707,5993
Alabama,Pollard,198,20,36,38,6,6,106
Alabama,Orange Beach,5927,246,980,1166,1600,627,4619
Alabama,Goshen,223,31,48,24,22,9,134
Alabama,Bay Minette,9089,963,2184,1791,593,297,5828
Alabama,Elberta,1741,166,472,426,172,53,1289
Alabama,Talladega,15609,2565,3690,2969,810,680,10714
Alabama,New Site,791,92,225,185,57,21,580
Alabama,Wedowee,772,113,216,119,58,38,544
Alabama,Loxley,2077,210,447,310,208,129,1304
Alabama,Sylvania,2413,309,519,445,145,64,1482
Alabama,St. Florian,406,34,121,76,73,23,327
Alabama,Somerville,534,109,135,119,31,33,427
Alabama,Oak Grove,605,114,163,129,21,15,442
Alabama,Vincent,2162,279,516,489,72,30,1386
Alabama,Geraldine,929,121,246,178,58,38,641
Alabama,Point Clear,2482,318,301,291,345,369,1624
Alabama,Mountain Brook,20466,64,383,1552,6113,5304,13416
Alabama,Brighton,2823,332,600,796,147,88,1963
Alabama,Allgood,674,203,137,95,7,10,452
Alabama,Rosa,400,52,93,89,20,19,273
Alabama,Brantley,828,81,244,106,99,39,569
Alabama,Deatsville,1350,39,207,356,158,74,834
Alabama,Frisco City,1459,234,379,214,18,47,892
Alabama,Courtland,771,128,200,130,24,31,513
Alabama,Aliceville,2408,551,562,347,140,62,1662
Alabama,Montgomery,200156,19289,33346,36751,24452,16871,130709
Alabama,Arley,566,76,146,113,32,39,406
Alabama,Bridgeport,2303,329,708,447,114,24,1622
Alabama,Pleasant Groves,416,56,171,45,18,8,298
Alabama,Fayette,4385,359,1132,880,449,159,2979
Alabama,Notasulga,953,88,295,223,59,56,721
Alabama,Baileyton,810,136,246,148,44,14,588
Alabama,West Point,593,66,132,133,52,15,398
Alabama,Oak Hill,22,14,0,2,5,1,22
Alabama,Midway,703,167,186,81,16,23,473
Alabama,Lakeview,154,15,46,27,6,0,94
Alabama,Dutton,411,36,104,59,16,21,236
Alabama,Addison,641,74,211,114,59,29,487
Alabama,Billingsley,121,22,26,22,4,0,74
Alabama,Winfield,4475,405,843,855,479,294,2876
Alabama,Meridianville,6609,292,1174,1609,1171,496,4742
Alabama,Redstone Arsenal,1414,11,73,291,182,136,693
Alabama,Ladonia,3444,281,960,795,167,134,2337
Alabama,York,3078,449,704,477,177,101,1908
Alabama,McKenzie,608,81,148,131,22,21,403
Alabama,Columbiana,4420,706,1400,587,311,238,3242
Alabama,Centreville,2677,199,1041,419,123,198,1980
Alabama,Luverne,2771,502,716,470,222,123,2033
Alabama,Rutledge,363,74,97,79,11,0,261
Alabama,Yellow Bluff,149,25,42,13,1,0,81
Alabama,West Blocton,1352,174,514,199,144,57,1088
Alabama,Gordo,1856,208,586,438,121,26,1379
Alabama,Brent,4840,1060,1392,834,133,86,3505
Alabama,Section,959,158,189,193,44,28,612
Alabama,Skyline,939,128,277,194,21,29,649
Alabama,South Vinemont,630,91,145,132,36,23,427
Alabama,Carolina,258,21,59,90,10,2,182
Alabama,River Falls,646,130,138,113,67,6,454
Alabama,Gu-Win,118,14,34,20,1,0,69
Alabama,Bon Air,87,12,33,11,0,5,61
Alabama,Waldo,261,35,79,58,20,5,197
Alabama,Newton,1722,170,434,445,94,59,1202
Alabama,Coffee Springs,195,23,62,61,8,4,158
Alabama,Linden,2041,266,743,371,111,96,1587
Alabama,Ethelsville,169,19,39,8,6,5,77
Alabama,Pine Apple,155,22,40,27,14,10,113
Alabama,Haleyville,3996,645,1080,751,207,75,2758
Alabama,County Line,274,36,89,44,20,0,189
Alabama,Nauvoo,160,28,45,30,9,0,112
Alabama,Holt,4159,663,1044,805,133,51,2696
Alabama,Northport,25457,1400,4243,4977,3659,2547,16826
Alabama,Hillsboro,618,91,193,101,28,12,425
Alabama,Highland Lake,360,26,82,75,51,39,273
Alabama,Elmore,1607,295,428,191,62,17,993
Alabama,Tallassee,5013,668,1159,1139,242,182,3390
Alabama,Elkmont,490,67,155,78,24,30,354
Alabama,Trussville,21721,453,2918,5007,4049,2222,14649
Alabama,Elba,3852,661,902,748,278,65,2654
Alabama,Columbia,661,72,156,234,52,36,550
Alabama,Grand Bay,4090,382,1044,959,286,51,2722
Alabama,McDonald Chapel,633,130,157,91,31,0,409
Alabama,Sipsey,397,64,94,108,6,6,278
Alabama,Pelham,23242,1293,3057,5740,3909,1966,15965
Alabama,Edgewater,743,56,197,168,26,13,460
Alabama,Vance,1732,67,421,350,173,67,1078
Alabama,Nectar,330,37,91,79,17,5,229
Alabama,Alexander City,14621,1848,2960,3470,1127,609,10014
Alabama,Taylor,2397,381,558,497,107,34,1577
Alabama,Webb,1453,219,480,287,40,31,1057
Alabama,Bayou La Batre,2527,603,420,343,77,14,1457
Alabama,Mooresville,89,4,5,14,29,19,71
Alabama,Tillmans Corner,17814,1698,4646,3540,1389,356,11629
Alabama,Carbon Hill,1402,267,308,239,55,54,923
Alabama,Tuscaloosa,98881,5848,15016,14406,11761,8584,55615
Alabama,Oneonta,6575,1140,1059,1523,467,308,4497
Alabama,Susan Moore,700,166,177,143,29,24,539
Alabama,Fulton,208,40,74,29,0,0,143
Alabama,Gaylesville,191,33,53,40,18,0,144
Alabama,Glenwood,221,14,46,83,11,17,171
Alabama,Marion,3359,378,652,384,87,120,1621
Alabama,Langston,216,15,89,53,24,13,194
Alabama,Hazel Green,3452,333,1128,630,310,53,2454
Alabama,Madison,48275,1174,4133,8515,10784,7914,32520
Alabama,Edwardsville,197,30,40,34,3,3,110
Alabama,Lake View,3028,97,498,800,405,115,1915
Alabama,Snead,702,99,161,181,61,38,540
Alabama,Robertsdale,6521,572,1811,1281,482,128,4274
Alabama,Garden City,553,93,133,130,22,6,384
Alabama,Georgiana,1914,303,680,279,83,72,1417
Alabama,Ider,644,78,237,142,38,23,518
Alabama,Pine Ridge,287,81,29,68,8,4,190
Alabama,Sand Rock,471,50,135,112,38,31,366
Alabama,Valley Head,660,63,182,126,45,13,429
Alabama,Waterloo,195,24,59,28,21,4,136
Alabama,Eva,560,37,130,137,48,22,374
Alabama,Falkville,1373,231,414,276,70,67,1058
Alabama,Priceville,3318,169,652,562,546,317,2246
Alabama,Fyffe,1357,139,315,278,45,47,824
Alabama,Childersburg,4959,682,1221,1137,274,66,3380
Alabama,Avon,463,33,171,92,29,19,344
Alabama,West End-Cobb Town,3346,731,777,848,97,57,2510
Alabama,Kinston,708,116,187,125,35,5,468
Alabama,Rehobeth,1862,132,341,386,177,84,1120
Alabama,Ardmore,1305,160,415,219,80,72,946
Alabama,Athens,25176,2490,5027,5270,3686,1470,17943
Alabama,Citronelle,3911,426,1033,593,299,106,2457
Alabama,Dauphin Island,1229,41,260,313,202,202,1018
Alabama,Attalla,5847,493,1632,1436,105,137,3803
Alabama,Fort Payne,14006,2591,2446,2648,686,750,9121
Alabama,Mentone,305,28,66,93,36,47,270
Alabama,Steele,1133,193,305,222,38,37,795
Alabama,Homewood,25595,510,1646,2985,5284,5032,15457
Alabama,Irondale,12474,1019,2406,2261,1910,992,8588
Alabama,Wilsonville,2246,192,593,548,143,103,1579
Alabama,Sardis City,1763,154,384,493,102,129,1262
Alabama,White Hall,786,182,171,157,36,3,549
Alabama,Mulga,803,163,200,178,20,1,562
Alabama,Monroeville,6011,570,1801,914,473,293,4051
Alabama,Minor,1074,34,334,264,76,7,715
Alabama,Tarrant,6212,829,1681,1279,309,94,4192
Alabama,Florence,40104,3553,7471,7692,4386,2819,25921
Alabama,Hamilton,6664,975,1731,1548,364,227,4845
Alabama,Banks,157,13,41,24,12,7,97
Alabama,Wadley,809,109,96,74,37,15,331
Alabama,Wilton,806,158,193,118,54,12,535
Alabama,Lanett,6318,930,1580,1087,569,234,4400
Alabama,Tuscumbia,8426,996,1962,1698,632,400,5688
Alabama,Boligee,519,11,178,23,22,5,239
Alabama,Malvern,1773,222,388,436,68,41,1155
Alabama,Thorsby,1938,252,440,318,228,64,1302
Alabama,Cardiff,43,10,5,0,2,2,19
Alabama,Mobile,191485,15014,38493,39647,23367,13753,130274
Alabama,Argo,4235,315,807,1234,245,255,2856
Alabama,Bessemer,26759,2918,6850,5823,1843,654,18088
Alabama,Napier Field,418,41,105,113,19,3,281
Alabama,Fairview,497,75,97,101,15,19,307
Alabama,Vredenburgh,363,74,108,54,0,0,236
Alabama,Scottsboro,14527,1408,3792,3236,1434,716,10586
Alabama,Eufaula,12289,1594,2823,2381,876,506,8180
Alabama,Warrior,3209,357,1296,714,101,72,2540
Alabama,Double Springs,1408,258,320,204,61,36,879
Alabama,Natural Bridge,14,2,4,2,2,0,10
Alabama,Selmont-West Selmont,2040,310,710,275,65,0,1360
Alabama,North Courtland,704,151,210,104,12,2,479
Alabama,Margaret,4752,245,909,762,302,188,2406
Alabama,Killen,1196,76,231,278,145,73,803
Alabama,McIntosh,431,5,119,80,49,12,265
Alabama,Muscle Shoals,13874,873,3095,3078,1791,838,9675
Alabama,Forkland,794,135,189,163,28,12,527
Alabama,Albertville,21460,3179,4084,3909,1606,595,13373
Alabama,Hartford,2604,396,656,561,135,42,1790
Alabama,Gilbertown,166,22,52,15,11,1,101
Alabama,Lisman,627,109,137,160,18,36,460
Alabama,Daleville,5113,640,1159,1205,357,150,3511
Alabama,Fairfield,10790,793,2149,2834,895,381,7052
Alabama,Douglas,1077,123,223,242,24,18,630
Alabama,Town Creek,1136,162,321,161,69,15,728
Alabama,Leeds,12348,918,2334,2867,1671,814,8604
Alabama,Lipscomb,2024,379,512,339,62,21,1313
Alabama,Sumiton,2586,233,613,712,126,60,1744
Alabama,West Jefferson,465,38,141,89,16,29,313
Alabama,Needham,113,16,24,26,11,2,79
Alabama,Silas,613,140,149,104,23,17,433
Alabama,Jacksonville,12654,578,1447,2672,1269,1029,6995
Alabama,Weaver,3076,266,578,865,278,75,2062
Alabama,Gordon,237,70,74,35,1,4,184
Alabama,Faunsdale,32,4,8,2,11,2,27
Alabama,Ariton,697,119,139,104,26,46,434
Alabama,Clayhatchee,513,44,136,157,15,16,368
Alabama,Level Plains,2478,162,477,663,174,84,1560
Alabama,Newbern,203,26,66,25,17,6,140
Alabama,Phil Campbell,1513,166,347,223,72,34,842
Alabama,Blue Ridge,1602,31,206,350,325,218,1130
Alabama,Millbrook,15160,633,2796,3319,1840,918,9506
Alabama,Prattville,35657,2636,6898,6637,4493,3262,23926
Alabama,Wetumpka,8117,813,1741,1938,814,401,5707
Alabama,Rockford,714,125,140,201,52,31,549
Alabama,Concord,1690,104,517,331,107,62,1121
Alabama,Adamsville,4374,568,952,967,381,118,2986
Alabama,Parrish,1108,205,306,195,18,0,724
Alabama,Flomaton,1695,174,589,278,46,23,1110
Alabama,Five Points,258,39,72,54,4,2,171
Alabama,Oxford,21208,1750,4656,4849,1988,1198,14441
Alabama,Cowarts,2223,227,564,387,171,89,1438
Alabama,Prichard,21927,2667,5456,4057,916,414,13510
Alabama,Satsuma,6151,500,1840,1298,508,239,4385
Alabama,Maytown,328,43,80,82,14,8,227
Alabama,Morris,1831,122,408,458,285,91,1364
Alabama,Pleasant Grove,10185,504,2201,2800,993,639,7137
Alabama,Glencoe,5120,534,1070,1397,428,459,3888
Alabama,Hokes Bluff,4271,147,1180,1059,421,219,3026
Alabama,Gordonville,185,28,60,31,9,6,134
Alabama,Lockhart,282,49,85,71,6,4,215
Alabama,Autaugaville,821,220,295,89,33,26,663
Alabama,Arab,8234,714,1570,1954,911,499,5648
Alabama,Pell City,13593,1349,2846,3585,1307,532,9619
Alabama,Rogersville,1177,121,285,249,100,27,782
Alabama,Sheffield,8986,1296,2059,1802,902,495,6554
Alabama,Brilliant,1037,153,271,219,7,7,657
Alabama,Brewton,5263,658,1185,968,597,330,3738
Alabama,Harvest,5700,266,668,1315,936,388,3573
Alabama,Eclectic,1042,70,228,196,100,30,624
Alabama,Owens Cross Roads,2029,161,384,476,266,153,1440
Alabama,Brookwood,2192,109,570,481,201,53,1414
Alabama,Walnut Grove,917,132,212,179,45,12,580
Alabama,Dothan,67872,5821,13187,15732,7306,4298,46344
Alabama,Kinsey,2211,280,482,516,109,32,1419
Alabama,Theodore,6483,565,1642,1192,494,135,4028
Alabama,Eldridge,134,9,14,40,10,0,73
Alabama,Jasper,13727,1115,3215,3070,1133,749,9282
Alabama,Kansas,187,43,44,21,5,0,113
Alabama,Fultondale,9097,657,1916,2180,1084,419,6256
Alabama,Foley,17818,1618,3547,5030,2241,1075,13511
Alabama,Underwood-Petersville,3196,276,975,587,288,176,2302
Alabama,Guin,2561,331,777,581,133,70,1892
Alabama,Daphne,25361,637,3411,5754,4878,2457,17137
Alabama,Silverhill,633,56,157,149,89,54,505
Alabama,Leesburg,1092,143,240,284,82,51,800
Alabama,Rainsville,5018,670,1342,1215,139,159,3525
Alabama,Piedmont,4651,519,1257,1034,279,148,3237
Alabama,Huntsville,193663,12566,25133,37166,34088,22071,131024
Alabama,Castleberry,510,110,151,102,24,0,387
Alabama,Abbeville,2582,387,694,527,96,185,1889
Alabama,Greenville,7714,965,1896,1183,655,366,5065
Alabama,Evergreen,3705,331,1107,601,163,88,2290
Alabama,East Brewton,2963,361,852,666,106,26,2011
Alabama,Hurtsboro,551,86,113,190,18,17,424
Alabama,Haleburg,132,15,21,34,23,5,98
Alabama,Newville,402,59,115,82,22,16,294
Alabama,Louisville,496,139,115,47,14,11,326
Alabama,Orrville,175,49,45,43,8,6,151
Alabama,Cuba,410,20,82,69,92,52,315
Alabama,Gainesville,161,10,48,24,17,2,101
Alabama,Libertyville,85,11,17,17,7,4,56
Alabama,Alabaster,32878,2221,4730,7026,4801,2748,21526
Alabama,Harpersville,1506,222,442,279,84,31,1058
Alabama,Gantt,128,19,38,32,13,1,103
Alabama,Glen Allen,435,51,114,112,28,19,324
Alabama,Franklin,186,27,39,31,9,19,125
Alabama,Blue Springs,95,7,34,15,13,3,72
Alabama,Hobson City,724,105,159,176,35,13,488
Alabama,Cottonwood,1291,205,389,259,50,12,915
Alabama,Chickasaw,5837,604,1192,1082,307,179,3364
Alabama,Saraland,14268,1407,3536,2733,1077,563,9316
Alabama,Cordova,1927,327,640,382,32,53,1434
Alabama,New Market,1205,115,286,148,146,77,772
Alabama,Repton,288,31,104,44,22,5,206
Alabama,New Hope,2856,299,676,651,276,52,1954
Alabama,Gurley,738,69,194,139,69,37,508
Alabama,Auburn,62996,1692,3718,7743,9348,7850,30351
Alabama,Opelika,29798,2355,6097,6413,3272,2451,20588
Alabama,Leighton,1088,174,338,171,33,20,736
Alabama,Fort Rucker,5134,21,298,1134,626,235,2314
Alabama,Midland City,2144,243,470,419,127,19,1278
Alabama,Black,197,22,70,36,8,4,140
Alabama,Geneva,4379,878,1291,691,191,154,3205
Alabama,Jacksons' Gap,779,189,225,166,33,0,613
Alabama,Maplesville,752,94,210,119,39,17,479
Alabama,Odenville,3751,490,848,869,363,132,2702
Alabama,Brundidge,2295,268,637,282,119,94,1400
Alabama,Roanoke,5941,901,1341,1359,398,253,4252
Alabama,Rock Mills,486,51,165,85,59,0,360
Alabama,Russellville,9711,1702,2361,1192,315,352,5922
Alabama,Vina,363,112,67,63,21,0,263
Alabama,Providence,179,18,73,34,4,17,146
Alabama,Grant,933,119,191,163,106,54,633
Alabama,Daviston,186,10,35,65,11,9,130
Alabama,Clanton,8724,1178,2473,1542,661,369,6223
Alabama,Moores Mill,6815,443,1497,1416,955,483,4794
Alabama,Excel,1013,72,270,166,59,63,630
Alabama,Pine Hill,782,44,264,134,28,34,504
Alabama,Spruce Pine,149,26,0,75,0,22,123
Alabama,Woodstock,2371,173,824,407,133,54,1591
Alabama,Westover,1603,124,255,384,204,101,1068
Alabama,Valley Grande,3773,138,833,976,315,200,2462
Alabama,Center Point,16460,1067,3109,4364,1221,538,10299
Alabama,Smiths Station,5349,652,1033,1369,516,167,3737
Alabama,Gadsden,35624,5194,7988,7551,2411,1548,24692
Alabama,Abanda,218,121,26,13,0,0,160
Alabama,Mount Vernon,1243,185,508,232,51,17,993
Alabama,Pennington,333,75,89,69,11,20,264
Alabama,Union,295,36,87,96,24,12,255
Alabama,Red Bay,3102,503,883,431,132,58,2007
Alabama,Stockton,709,57,117,175,63,101,513
Alabama,Stapleton,1196,53,283,392,101,81,910
Alabama,Perdido,751,124,324,95,29,0,572
Alabama,Samson,2086,361,440,367,56,48,1272
Alabama,Lillian,1330,40,488,416,111,77,1132
Alabama,Axis,1473,256,84,287,171,107,905
Alabama,Belgreen,76,17,17,20,0,6,60
Alabama,Chelsea,12643,363,1189,2672,2708,967,7899
Alabama,Ashville,2418,329,647,530,105,84,1695
Alabama,Ashland,1943,355,376,378,96,42,1247
Alabama,Ashford,2346,212,569,526,157,115,1579
Alabama,Carlisle-Rockledge,2391,304,720,513,53,31,1621
Alabama,Calvert,957,338,145,0,0,44,527
Alabama,Ballplay,1458,169,332,388,141,0,1030
Alabama,Bucks,68,18,0,50,0,0,68
Alabama,Brook Highland,7116,157,560,1488,1901,1069,5175
Alabama,Bristow Cove,769,97,197,176,0,20,490
Alabama,Brantleyville,987,109,244,214,52,33,652
Alabama,Boykin,134,50,28,40,0,0,118
Alabama,Belle Fontaine,532,108,67,117,52,0,344
Alabama,Bellamy,380,33,265,48,0,0,346
Alabama,Broomtown,198,56,23,23,17,0,119
Alabama,Bon Secour,1011,244,368,108,71,116,907
Alabama,Kimberly,3073,112,757,644,237,213,1963
Alabama,Cottondale,3469,283,760,845,80,90,2058
Alabama,Stewartville,1627,321,401,360,65,25,1172
Alabama,Sterrett,866,194,248,151,82,41,716
Alabama,Tidmore Bend,1237,179,266,281,126,26,878
Alabama,Standing Rock,153,21,21,56,13,0,111
Alabama,Spring Garden,185,0,63,51,0,13,127
Alabama,Sims Chapel,85,0,0,51,0,0,51
Alabama,Tibbie,73,0,0,26,0,11,37
Alabama,Shoal Creek,1398,0,74,262,368,267,971
Alabama,Loachapoka,251,15,49,54,45,19,182
Alabama,Dadeville,3115,643,768,402,102,50,1965
Alabama,Pickensville,883,106,219,169,32,10,536
Alabama,Talladega Springs,188,33,41,38,10,5,127
Alabama,Calera,13557,662,2128,3211,2027,889,8917
Alabama,Coosada,1116,124,238,236,138,60,796
Alabama,Vernon,1811,220,537,315,118,46,1236
Alabama,Uriah,307,0,115,50,2,59,226
Alabama,Vandiver,1016,203,239,127,78,39,686
Alabama,Vinegar Bend,247,0,60,31,34,0,125
Alabama,Semmes,4869,704,1406,912,467,204,3693
Alabama,Morrison Crossroads,253,121,36,51,19,0,227
Alabama,Joppa,690,177,158,192,0,74,601
Alabama,Riverside,2500,193,553,682,187,98,1713
Alabama,Good Hope,2793,376,549,583,133,33,1674
Alabama,Moody,12752,684,2715,3431,1187,429,8446
Alabama,Kellyton,196,16,83,56,2,3,160
Alabama,Twin,457,78,123,98,22,18,339
Alabama,Pinson,7121,281,1644,2042,696,289,4952
Alabama,Munford,1305,148,285,290,92,32,847
Alabama,Cusseta,112,21,23,24,7,10,85
Alabama,Whitesboro,2352,321,552,422,118,78,1491
Alabama,White Plains,770,41,294,185,16,49,585
Alabama,Whatley,178,144,16,18,0,0,178
Alabama,Weogufka,301,28,85,69,0,0,182
Alabama,Bakerhill,278,34,67,60,24,18,203
Alabama,Butler,2136,266,485,449,164,76,1440
Alabama,Camden,2142,149,535,370,175,84,1313
Alabama,Clio,1018,185,216,153,34,2,590
Alabama,Millerville,158,55,20,57,0,0,132
Alabama,Megargel,12,0,12,0,0,0,12
Alabama,Marbury,1573,188,376,179,155,85,983
Alabama,Malcolm,358,11,79,55,0,0,145
Alabama,Macedonia,197,41,76,61,0,0,178
Alabama,Lookout Mountain,1805,194,477,350,80,65,1166
Alabama,Mount Olive CDP (Coosa County),315,35,142,9,0,25,211
Alabama,Leroy,685,30,167,248,31,53,529
Alabama,Holtville,4133,449,985,836,418,246,2934
Alabama,Hollis Crossroads,591,98,203,126,9,17,453
Alabama,Hollins,892,182,275,180,0,33,670
Alabama,Hobson,147,7,72,0,19,9,107
Alabama,Hissop,461,97,224,95,45,0,461
Alabama,Highland Lakes,5500,36,514,760,1748,901,3959
Alabama,Ivalee,886,59,325,119,58,15,576
Alabama,Mount Olive CDP (Jefferson County),4021,161,876,1130,446,168,2781
Alabama,New Union,1091,89,319,257,51,11,727
Alabama,Movico,88,0,57,5,0,9,71
Alabama,Penton,68,4,20,21,6,0,51
Alabama,Perdido Beach,550,84,121,145,87,44,481
Alabama,Peterman,139,9,39,23,6,16,93
Alabama,Pine Level,4574,144,1151,744,501,228,2768
Alabama,Putnam,60,10,33,5,0,0,48
Alabama,Ray,257,13,92,36,55,14,210
Alabama,Redland,4242,87,685,699,836,497,2804
Alabama,Reeltown,306,10,98,48,33,15,204
Alabama,Rockville,16,7,5,0,0,0,12
Alabama,St. Stephens,394,58,148,111,21,0,338
Alabama,Shelby,1305,99,334,328,26,0,787
Alabama,Magnolia Springs,815,25,241,170,232,60,728
Alabama,Clay,9653,506,1957,2441,1168,499,6571
Alabama,Nances Creek,494,16,100,105,49,10,280
Alabama,Nanafalia,42,0,17,16,0,3,36
Alabama,Hatton,106,0,57,33,16,0,106
Alabama,Grimes,731,89,195,167,40,5,496
Alabama,Hackneyville,337,23,142,79,21,21,286
Alabama,Graham,84,26,21,16,10,11,84
Alabama,Uniontown,1969,326,539,290,90,29,1274
Alabama,Stevenson,1847,245,632,272,90,40,1279
Alabama,Springville,4195,158,1033,737,647,309,2884
Alabama,Reform,1907,297,484,364,78,84,1307
Alabama,Pike Road,8884,227,809,1720,1719,1522,5997
Alabama,Jemison,2637,221,786,379,99,106,1591
Alabama,Carlton,36,23,13,0,0,0,36
Alabama,Indian Springs Village,2590,19,231,370,656,502,1778
Alabama,Goodwater,1311,274,348,242,58,25,947
Alabama,Fruithurst,254,45,89,31,11,1,177
Alabama,Florala,1549,272,488,440,81,27,1308
Alabama,Eutaw,2722,613,712,669,107,111,2212
Alabama,Creola,1887,186,513,342,144,53,1238
Alabama,Coaling,1635,162,354,371,158,48,1093
Alabama,Henagar,2059,313,660,434,35,34,1476
Alabama,Catherine,21,0,10,11,0,0,21
Alabama,Choccolocco,2396,156,443,669,277,218,1763
Alabama,Chunchula,142,21,57,32,22,0,132
Alabama,Gallant,743,99,184,143,34,23,483
Alabama,Fruitdale,224,0,70,14,0,0,84
Alabama,Fredonia,220,11,46,85,32,8,182
Alabama,Fitzpatrick,41,18,0,23,0,0,41
Alabama,Fayetteville,1432,225,393,383,50,43,1094
Alabama,Fairford,64,22,26,9,0,0,57
Alabama,Eunola,239,66,82,58,0,0,206
Alabama,Emerald Mountain,3200,76,222,728,416,413,1855
Alabama,Egypt,774,130,114,201,60,10,515
Alabama,East Point,97,65,0,16,16,0,97
Alabama,Dunnavant,914,120,227,233,79,9,668
Alabama,Delta,219,0,151,27,0,0,178
Alabama,Deer Park,134,0,89,24,0,0,113
Alabama,Cullomburg,155,15,49,22,20,0,106
Alabama,Coats Bend,1600,141,516,358,84,22,1121
Alabama,Gulfcrest,321,39,87,39,0,0,165
Alabama,Panola,33,0,8,25,0,0,33
Alabama,Crossville,1945,361,521,297,67,124,1370
Alabama,Ranburne,539,75,133,106,24,21,359
Alabama,Emelle,69,1,12,28,4,1,46
Alabama,Woodville,821,117,229,130,16,4,496
Alabama,Montevallo,6654,378,1174,975,677,356,3560
Alabama,Myrtlewood,122,33,29,33,5,4,104
Alabama,Chatom,980,73,265,247,64,81,730
Alabama,Millry,602,110,182,63,39,31,425
Alabama,Millport,1061,133,361,186,111,59,850
Alabama,Sulligent,2083,274,653,338,105,81,1451
Alabama,Anderson,254,62,71,53,11,7,204
Alabama,Hackleburg,1341,183,295,325,71,38,912
Alabama,Trinity,2972,255,555,623,224,102,1759
Alabama,Gulf Shores,12033,303,2254,3602,2115,1309,9583
Alabama,Summerdale,1026,64,276,198,90,30,658
Alabama,Hammondville,526,76,121,130,25,26,378
Alabama,Slocomb,1953,424,419,369,94,23,1329
Alabama,Hollywood,1088,156,331,184,72,0,743
Alabama,Livingston,3410,130,398,347,304,256,1435
Alabama,Holly Pond,953,100,232,261,33,23,649
Alabama,Colony,434,53,129,83,37,15,317
Alabama,Coker,682,61,150,158,73,21,463
Alabama,Troy,19141,1635,2398,2519,1882,1206,9640
Alabama,Jackson,4851,554,1444,767,289,258,3312
Alabama,Dodge City,554,76,157,143,19,11,406
Alabama,Beaverton,241,28,109,31,10,5,183
Alabama,Detroit,181,27,59,35,15,0,136
Alabama,Kennedy,424,60,111,85,43,32,331
Alabama,Hytop,394,55,121,52,18,6,252
Alabama,Pisgah,761,138,160,151,37,27,513
Alabama,Coffeeville,420,22,82,95,23,5,227
Alabama,Blountsville,1838,298,410,343,66,35,1152
Alabama,Locust Fork,1631,253,467,314,68,19,1121
Alabama,Smoke Rise,2360,112,556,668,187,95,1618
Alabama,Thomasville,3997,628,990,966,423,103,3110
Alabama,Memphis,32,21,3,0,3,0,27
Alabama,Hanceville,3340,689,747,831,159,68,2494
Alabama,Spanish Fort,8324,287,1103,1700,1682,772,5544
Alabama,Our Town,519,150,169,133,13,0,465
Alabama,Geiger,314,32,73,43,13,4,165
Alabama,Sylacauga,12397,1222,2688,2777,886,523,8096
Alabama,Lester,190,7,81,33,11,11,143
Alabama,Grove Hill,1573,162,437,216,125,80,1020
Alabama,Headland,4661,517,1039,863,506,280,3205
Alabama,Enterprise,27859,1848,4389,6844,3678,1889,18648
Alabama,Hodges,324,50,93,49,33,7,232
Alabama,Collinsville,2074,515,464,324,91,15,1409
Alabama,Lynn,562,105,153,115,33,6,412
Alabama,Centre,3505,590,973,821,211,171,2766
Alabama,Moulton,3283,570,987,503,293,90,2443
Alabama,Ridgeville,118,20,41,16,2,2,81
Alabama,Cullman,15558,1514,3042,3156,1630,1013,10355
Alabama,Ragland,1899,296,632,286,40,29,1283
Alabama,Epes,482,22,92,179,48,6,347
Alabama,Petrey,48,1,25,5,4,1,36
Alabama,Union Springs,3596,654,775,494,114,203,2240
Alabama,Dozier,367,80,64,57,27,5,233
Alabama,Beatrice,310,35,67,83,3,15,203
Alabama,Greensboro,2870,352,802,400,177,121,1852
Alabama,Cedar Bluff,2067,299,595,385,96,114,1489
Alabama,Pinckard,458,58,124,133,33,17,365
Alabama,Union Grove,75,2,24,16,15,7,64
Alabama,Riverview,85,14,28,20,2,0,64
Alabama,Phenix City,36641,3704,6747,8387,2820,1812,23470
Alabama,Cleveland,1167,296,280,237,29,30,872
Alabama,Sanford,189,36,46,37,16,9,144
Alabama,Cherokee,814,120,184,221,39,23,587
Alabama,Dora,2200,230,521,418,102,116,1387
Alabama,Selma,18804,2392,3751,3590,1126,1003,11862
Alabama,Paint Rock,184,27,64,32,6,3,132
Alabama,Hayden,1252,143,333,304,81,48,909
Alabama,McMullen,5,3,0,1,1,0,5
Alabama,Thomaston,340,24,124,51,32,15,246
Alabama,Southside,8788,458,1437,2625,1239,542,6301
Alaska,Nelson Lagoon,74,23,24,15,0,0,62
Alaska,Chiniak,0,0,0,0,0,0,0
Alaska,Womens Bay,967,56,214,240,120,35,665
Alaska,Ouzinkie,171,29,43,34,4,0,110
Alaska,Larsen Bay,52,10,12,10,2,8,42
Alaska,Savoonga,921,153,224,53,10,1,441
Alaska,Atmautluak,209,31,61,14,2,0,108
Alaska,Brevig Mission,407,43,108,27,5,6,189
Alaska,Kodiak Station,1354,6,156,227,188,107,684
Alaska,Eek,491,67,131,41,0,0,239
Alaska,Crooked Creek,90,15,16,16,7,0,54
Alaska,Bethel,6424,348,1459,1028,460,390,3685
Alaska,Kalifornsky,8134,171,1683,2107,829,531,5321
Alaska,Beluga,4,2,2,0,0,0,4
Alaska,Nome,3813,228,774,777,292,241,2312
Alaska,Funny River,1251,91,221,297,130,32,771
Alaska,Chevak,1144,110,344,145,35,18,652
Alaska,Cantwell,183,8,68,42,20,14,152
Alaska,Emmonak,761,90,212,68,12,3,385
Alaska,Halibut Cove,71,0,0,18,8,45,71
Alaska,Old Harbor,249,27,55,46,7,8,143
Alaska,Akhiok,57,0,12,13,0,0,25
Alaska,Stebbins,473,60,93,58,8,17,236
Alaska,St. Michael,468,40,133,34,3,0,210
Alaska,Diomede,94,7,25,4,2,0,38
Alaska,Game Creek,0,0,0,0,0,0,0
Alaska,Seldovia Village,164,9,41,60,10,13,133
Alaska,Primrose,99,0,64,31,0,4,99
Alaska,Kenai,7687,708,1719,1725,596,420,5168
Alaska,Fritz Creek,1956,98,296,485,340,195,1414
Alaska,Attu Station,17,0,0,0,0,6,6
Alaska,Wainwright,508,48,132,90,9,5,284
Alaska,Ferry,16,0,6,6,0,0,12
Alaska,Kasilof,531,0,69,129,45,23,266
Alaska,Salcha,995,3,157,217,180,62,619
Alaska,Kwethluk,653,84,124,97,15,2,322
Alaska,Manley Hot Springs,80,3,20,23,10,1,57
Alaska,Fox,566,86,172,181,39,0,478
Alaska,Fairbanks,31677,1366,4766,7203,3324,1518,18177
Alaska,Ester,1312,83,96,228,207,214,828
Alaska,Pleasant Valley,569,0,51,210,59,28,348
Alaska,Tenakee Springs,155,0,52,25,37,11,125
Alaska,Chenega,48,0,12,9,12,3,36
Alaska,Nelchina,171,7,49,17,9,0,82
Alaska,Copper Center,299,14,116,61,3,5,199
Alaska,Mendeltna,26,0,9,17,0,0,26
Alaska,Silver Springs,120,2,13,16,18,13,62
Alaska,Alakanuk,837,121,173,59,6,4,363
Alaska,Anderson,137,6,18,36,9,9,78
Alaska,Nuiqsut,469,67,88,45,32,22,254
Alaska,False Pass,78,3,24,30,0,3,60
Alaska,McGrath,283,12,70,61,17,10,170
Alaska,Tununak,339,40,90,38,7,0,175
Alaska,Big Lake,2765,157,899,769,185,73,2083
Alaska,New Stuyahok,557,52,124,63,7,39,285
Alaska,Nightmute,189,31,47,20,2,0,100
Alaska,Galena,510,38,73,105,47,59,322
Alaska,Coldfoot,132,21,22,54,32,0,129
Alaska,Arctic Village,153,25,22,27,0,9,83
Alaska,Kotzebue,3288,236,772,589,229,106,1932
Alaska,Ambler,299,35,85,28,4,26,178
Alaska,Ekwok,80,15,22,10,0,0,47
Alaska,Aleknagik,204,14,66,46,10,4,140
Alaska,Venetie,141,34,29,23,0,2,88
Alaska,Red Dog Mine,82,16,0,50,16,0,82
Alaska,Tanana,242,33,76,45,13,5,172
Alaska,Rampart,60,7,11,11,0,0,29
Alaska,Grayling,176,15,58,14,1,0,88
Alaska,Fort Yukon,533,47,144,114,15,17,337
Alaska,Stony River,41,4,14,0,0,0,18
Alaska,Akiak,416,29,113,54,5,1,202
Alaska,Kiana,262,12,83,31,3,4,133
Alaska,Kivalina,688,101,169,37,8,25,340
Alaska,Anaktuvuk Pass,274,33,62,36,0,6,137
Alaska,Angoon,523,35,161,166,18,17,397
Alaska,Dry Creek,133,0,13,51,7,6,77
Alaska,Susitna,0,0,0,0,0,0,0
Alaska,Lakes,10098,263,1891,2847,992,469,6462
Alaska,Lake Louise,9,0,9,0,0,0,9
Alaska,Gateway,7037,152,1128,1868,830,468,4446
Alaska,Fishhook,6203,401,923,1336,789,381,3830
Alaska,Farm Loop,1137,59,150,287,118,102,716
Alaska,Tuluksak,415,51,114,46,4,3,218
Alaska,Mekoryuk,226,23,77,40,6,5,151
Alaska,Kongiganak,441,40,128,45,5,0,218
Alaska,Kasigluk,574,86,141,49,2,0,278
Alaska,Aniak,525,56,145,85,31,14,331
Alaska,Akutan,758,111,244,205,55,35,650
Alaska,Ruby,207,23,52,24,5,6,110
Alaska,Koliganek,161,15,36,22,7,7,87
Alaska,Kaltag,172,13,52,44,2,11,122
Alaska,Four Mile Road,4,4,0,0,0,0,4
Alaska,Evansville,11,1,3,3,4,0,11
Alaska,Knik-Fairview,17513,896,3755,4222,1351,810,11034
Alaska,Wasilla,9675,670,1971,2597,675,332,6245
Alaska,Shageluk,75,8,22,10,2,2,44
Alaska,Takotna,23,3,8,4,0,0,15
Alaska,Dillingham,2250,138,476,469,208,123,1414
Alaska,Quinhagak,796,120,173,57,103,0,453
Alaska,Tanaina,10520,425,2122,2605,844,415,6411
Alaska,Pilot Station,576,71,140,40,11,0,262
Alaska,Port Lions,190,12,72,41,12,7,144
Alaska,Mountain Village,828,78,253,73,40,9,453
Alaska,Scammon Bay,585,63,115,43,3,4,228
Alaska,Point Hope,592,42,139,96,7,3,287
Alaska,Hoonah,800,60,258,162,64,35,579
Alaska,Stevens Village,11,3,4,0,0,0,7
Alaska,Glennallen,289,0,28,34,16,54,132
Alaska,Buckland,608,41,176,51,9,4,281
Alaska,Deering,154,16,43,22,4,0,85
Alaska,Central,47,4,21,13,0,8,46
Alaska,Homer,5607,216,845,1511,764,629,3965
Alaska,Soldotna,4589,185,1052,1339,376,262,3214
Alaska,Aleneva,27,20,7,0,0,0,27
Alaska,Salamatof,1015,85,338,314,45,15,797
Alaska,Kodiak,6107,446,1371,1376,670,255,4118
Alaska,Nikiski,4575,226,1243,1150,394,143,3156
Alaska,Cohoe,1217,59,323,372,126,72,952
Alaska,Nikolaevsk,261,37,53,69,25,7,191
Alaska,Chistochina,85,8,51,4,2,0,65
Alaska,Chitina,98,14,18,38,0,0,70
Alaska,Mentasta Lake,205,12,106,13,0,24,155
Alaska,Tonsina,28,0,0,10,18,0,28
Alaska,Whittier,311,22,54,86,28,11,201
Alaska,Huslia,404,19,93,91,13,2,218
Alaska,Seldovia,229,9,45,69,41,19,183
Alaska,Butte,3929,180,870,932,446,241,2669
Alaska,Eielson AFB,2979,41,133,601,267,273,1315
Alaska,Circle,74,8,16,14,3,0,41
Alaska,Chalkyitsik,115,11,27,19,6,15,78
Alaska,Livengood,4,0,4,0,0,0,4
Alaska,Minto,229,17,77,32,5,3,134
Alaska,Nikolai,114,10,54,15,1,0,80
Alaska,Palmer,6978,334,1559,1397,556,303,4149
Alaska,College,13709,344,1476,3027,1952,1496,8295
Alaska,Koyukuk,62,8,17,13,3,0,41
Alaska,Newtok,360,46,102,18,4,2,172
Alaska,Platinum,13,5,6,0,0,0,11
Alaska,Houston,2172,145,530,546,103,67,1391
Alaska,Petersville,0,0,0,0,0,0,0
Alaska,Sutton-Alpine,1586,145,445,498,109,35,1232
Alaska,Beaver,46,4,12,21,0,0,37
Alaska,Bettles,66,0,22,23,0,21,66
Alaska,Nunapitchuk,869,140,205,94,7,0,446
Alaska,Hughes,90,9,34,12,0,0,55
Alaska,Napaskiak,356,30,88,46,0,2,166
Alaska,Toksook Bay,527,68,120,62,15,13,278
Alaska,Craig,1263,80,316,276,106,84,862
Alaska,Mosquito Lake,183,0,120,21,0,13,154
Alaska,Tetlin,144,29,32,26,2,2,91
Alaska,Pope-Vannoy Landing,0,0,0,0,0,0,0
Alaska,Perryville,86,7,29,5,0,1,42
Alaska,Ivanof Bay,0,0,0,0,0,0,0
Alaska,Iliamna,63,1,18,10,1,4,34
Alaska,Levelock,76,14,15,11,2,0,42
Alaska,Alatna,4,0,2,2,0,0,4
Alaska,Point MacKenzie,976,118,412,208,7,14,759
Alaska,Meadow Lakes,7656,349,1837,1977,435,264,4862
Alaska,Lazy Mountain,1800,51,258,466,259,137,1171
Alaska,Chase,9,9,0,0,0,0,9
Alaska,Napakiak,369,63,107,26,7,0,203
Alaska,Goodnews Bay,192,33,37,21,8,0,99
Alaska,Sterling,5321,216,1276,1557,425,293,3767
Alaska,Hope,55,0,10,10,8,16,44
Alaska,Elfin Cove,12,0,12,0,0,0,12
Alaska,Hobart Bay,0,0,0,0,0,0,0
Alaska,Shishmaref,525,54,138,65,14,15,286
Alaska,Teller,182,28,61,12,0,0,101
Alaska,Manokotak,824,62,232,91,45,71,501
Alaska,Kotlik,811,104,215,44,4,9,376
Alaska,Chignik Lake,51,11,13,6,0,4,34
Alaska,St. Mary's,640,43,170,91,10,2,316
Alaska,Kaktovik,178,23,43,22,2,0,90
Alaska,Anchor Point,2093,104,508,609,240,95,1556
Alaska,Cooper Landing,569,17,39,93,154,74,377
Alaska,Ninilchik,749,35,192,200,75,39,541
Alaska,Diamond Ridge,1285,35,165,307,245,162,914
Alaska,Fox River,594,122,40,43,15,6,226
Alaska,Healy,1022,11,175,257,174,74,691
Alaska,Newhalen,121,6,34,18,5,2,65
Alaska,Pedro Bay,20,0,8,11,1,0,20
Alaska,Pilot Point,83,13,15,14,0,18,60
Alaska,South Naknek,41,7,13,9,1,3,33
Alaska,Ketchikan,8224,516,1795,2097,888,367,5663
Alaska,Coffman Cove,130,27,34,36,14,5,116
Alaska,Excursion Inlet,33,0,13,12,0,8,33
Alaska,Egegik,83,4,42,24,0,2,72
Alaska,Port Heiden,78,16,15,9,4,0,44
Alaska,Port Protection,38,0,9,9,10,10,38
Alaska,Portage Creek,0,0,0,0,0,0,0
Alaska,Twin Hills,63,18,14,11,0,0,43
Alaska,Kobuk,143,12,32,8,2,3,57
Alaska,Atqasuk,164,20,36,17,2,2,77
Alaska,Kipnuk,613,90,166,65,1,0,322
Alaska,Kwigillingok,379,35,96,55,2,0,188
Alaska,Lower Kalskag,283,23,98,26,2,2,151
Alaska,Togiak,705,54,147,107,10,11,329
Alaska,Upper Kalskag,222,19,58,41,1,0,119
Alaska,Metlakatla,1635,97,377,437,67,41,1019
Alaska,Karluk,44,5,6,6,0,0,17
Alaska,Eagle,74,2,22,23,8,1,56
Alaska,Northway Junction,37,1,16,8,2,0,27
Alaska,Northway Village,100,30,42,1,0,0,73
Alaska,Tanacross,141,14,60,21,2,0,97
Alaska,Juneau city and borough,32330,878,4584,8138,5735,3144,22479
Alaska,Kenny Lake,9,0,0,0,9,0,9
Alaska,Klawock,876,62,274,195,43,33,607
Alaska,Tyonek,344,13,116,64,10,4,207
Alaska,Gakona,148,3,46,19,18,2,88
Alaska,Tolsona,0,0,0,0,0,0,0
Alaska,Valdez,3870,32,785,992,423,489,2721
Alaska,Klukwan,47,9,13,19,1,3,45
Alaska,Gambell,601,93,175,39,4,2,313
Alaska,Golovin,128,4,23,24,4,3,58
Alaska,Cordova,3055,124,643,695,624,142,2228
Alaska,Harding-Birch Lakes,209,0,92,11,60,42,205
Alaska,Chefornak,501,57,117,47,4,0,225
Alaska,Kake,578,43,188,125,34,9,399
Alaska,Happy Valley,656,49,241,168,49,4,511
Alaska,King Cove,1074,109,404,207,88,20,828
Alaska,Hooper Bay,1101,81,292,97,7,6,483
Alaska,Ridgeway,2617,145,588,568,285,142,1728
Alaska,Allakaket,170,15,49,24,12,4,104
Alaska,St. Paul,425,28,147,84,17,25,301
Alaska,Slana,0,0,0,0,0,0,0
Alaska,Point Baker,0,0,0,0,0,0,0
Alaska,Gulkana,52,4,34,8,0,0,46
Alaska,Naukati Bay,112,27,35,11,9,20,102
Alaska,Crown Point,58,0,25,5,9,0,39
Alaska,Tazlina,354,11,109,46,29,12,207
Alaska,Port Graham,192,15,81,31,6,5,138
Alaska,Chignik,61,0,22,18,0,2,42
Alaska,Anchorage municip,296112,11867,45753,66655,42077,25642,191994
Alaska,Deltana,2613,167,532,644,160,135,1638
Alaska,Two Rivers,399,0,45,85,76,36,242
Alaska,Nenana,383,37,97,82,34,9,259
Alaska,Mertarvik,0,0,0,0,0,0,0
Alaska,Loring,0,0,0,0,0,0,0
Alaska,Goldstream,4389,45,475,969,955,842,3286
Alaska,Farmers Loop,5535,206,405,1728,835,541,3715
Alaska,Eureka Roadhouse,0,0,0,0,0,0,0
Alaska,Chena Ridge,5903,201,404,1301,935,1083,3924
Alaska,Badger,18792,572,3535,5468,2121,623,12319
Alaska,Clark's Point,48,2,16,9,0,0,27
Alaska,Haines,1870,44,389,404,337,183,1357
Alaska,Wrangell city and borough,2484,219,705,563,263,125,1875
Alaska,Gustavus,416,15,63,128,124,27,357
Alaska,Nunam Iqua,167,35,19,20,0,0,74
Alaska,Adak,203,12,76,19,6,6,119
Alaska,Sleetmute,83,10,26,3,6,1,46
Alaska,Selawik,839,140,223,36,11,3,413
Alaska,Tatitlek,78,6,38,14,1,0,59
Alaska,Lake Minchumina,14,3,2,7,0,2,14
Alaska,Trapper Creek,382,35,119,111,8,27,300
Alaska,Glacier View,208,20,41,57,43,16,177
Alaska,St. George,78,2,39,8,5,2,56
Alaska,Eagle Village,25,10,2,13,0,0,25
Alaska,Dot Lake,0,0,0,0,0,0,0
Alaska,Clam Gulch,197,11,51,66,17,3,148
Alaska,Bear Creek,1465,53,451,409,134,23,1070
Alaska,Sand Point,1372,106,341,408,85,38,978
Alaska,Pitkas Point,122,21,34,15,1,0,71
Alaska,Whitestone Logging Camp,0,0,0,0,0,0,0
Alaska,White Mountain,186,18,48,36,7,4,113
Alaska,Unalakleet,693,65,152,136,71,36,460
Alaska,Kasaan,75,6,15,25,7,0,53
Alaska,Hyder,15,0,0,0,15,0,15
Alaska,Hollis,127,0,38,13,13,11,75
Alaska,Port Alexander,97,3,19,26,14,0,62
Alaska,Unalaska,4781,412,1304,1149,487,98,3450
Alaska,Saxman,360,30,120,88,14,10,262
Alaska,Nabesna,0,0,0,0,0,0,0
Alaska,Kupreanof,13,0,6,0,4,3,13
Alaska,Port Alsworth,151,1,11,17,33,5,67
Alaska,Chuathbaluk,124,7,40,6,7,4,64
Alaska,Red Devil,21,4,9,7,0,0,20
Alaska,Noorvik,597,71,157,40,26,1,295
Alaska,Ugashik,8,0,6,1,0,0,7
Alaska,Sunrise,40,0,0,0,0,40,40
Alaska,Seward,2770,159,781,751,205,70,1966
Alaska,Lowell Point,167,0,67,38,37,6,148
Alaska,Holy Cross,183,21,74,22,3,2,122
Alaska,Flat,0,0,0,0,0,0,0
Alaska,Anvik,104,3,30,22,0,2,57
Alaska,Willow,2126,162,350,576,228,98,1414
Alaska,Talkeetna,965,46,178,287,114,28,653
Alaska,Skwentna,42,0,14,23,0,0,37
Alaska,Thorne Bay,614,39,127,204,84,25,479
Alaska,Yakutat,665,37,149,151,76,14,427
Alaska,Nondalton,114,12,29,20,6,4,71
Alaska,Point Possession,0,0,0,0,0,0,0
Alaska,Birch Creek,2,0,2,0,0,0,2
Alaska,Tuntutuliak,566,59,130,57,2,4,252
Alaska,Koyuk,271,17,67,36,0,3,123
Alaska,Naknek,464,17,106,143,66,15,347
Alaska,Marshall,299,25,82,37,0,0,144
Alaska,North Pole,2660,109,342,696,201,126,1474
Alaska,Moose Creek,794,55,20,310,41,54,480
Alaska,Tok,1160,83,220,292,81,111,787
Alaska,Big Delta,457,15,154,127,27,55,378
Alaska,Prudhoe Bay,1893,42,727,662,290,91,1812
Alaska,Sitka city and borough,8738,371,1741,2026,1256,748,6142
Alaska,Point Lay,251,23,47,26,4,0,100
Alaska,Willow Creek,0,0,0,0,0,0,0
Alaska,Wales,170,11,49,26,2,0,88
Alaska,Paxson,0,0,0,0,0,0,0
Alaska,Chisana,0,0,0,0,0,0,0
Alaska,Nanwalek,212,7,63,39,5,10,124
Alaska,Moose Pass,357,17,111,89,26,16,259
Alaska,Covenant Life,35,0,14,13,0,8,35
Alaska,Chignik Lagoon,75,5,15,23,1,5,49
Alaska,Nikolski,26,2,14,0,2,0,18
Alaska,Mud Bay,149,0,12,0,69,50,131
Alaska,Edna Bay,34,6,18,5,0,0,29
Alaska,Fort Greely,161,0,15,21,19,0,55
Alaska,Kachemak,488,8,79,141,94,59,381
Alaska,Whale Pass,48,12,24,0,12,0,48
Alaska,McCarthy,0,0,0,0,0,0,0
Alaska,Utqiagvik,4408,321,931,820,214,149,2435
Alaska,Pelican,93,16,17,20,26,0,79
Alaska,Wiseman,13,0,7,0,0,0,7
Alaska,Chicken,13,0,6,7,0,0,13
Alaska,Alcan Border,177,0,2,23,0,20,45
Alaska,Russian Mission,318,38,67,28,3,3,139
Alaska,Hydaburg,330,18,93,64,19,10,204
Alaska,Lutak,154,0,0,68,0,0,68
Alaska,Kokhanok,150,18,56,11,1,3,89
Alaska,Igiugig,62,9,10,12,7,0,38
Alaska,Atka,35,3,11,6,1,0,21
Alaska,Healy Lake,4,0,0,1,0,0,1
Alaska,Dot Lake Village,38,12,8,14,0,0,34
Alaska,Delta Junction,1053,37,195,286,87,55,660
Alaska,Nulato,257,31,69,61,10,8,179
Alaska,Port Clarence,43,0,0,0,0,0,0
Alaska,King Salmon,385,12,106,88,49,10,265
Alaska,Shaktoolik,294,19,107,23,2,0,151
Alaska,Knik River,833,69,205,197,85,37,593
Alaska,Chickaloon,241,10,37,129,15,35,226
Alaska,Buffalo Soapstone,871,81,190,161,89,22,543
Alaska,Oscarville,64,10,10,4,0,4,28
Alaska,Lime Village,8,1,2,0,0,0,3
Alaska,Akiachak,567,66,102,100,20,1,289
Alaska,Shungnak,288,38,81,23,3,0,145
Alaska,Noatak,422,32,149,38,0,2,221
Alaska,Cold Bay,52,0,13,17,7,5,42
Alaska,Elim,303,15,100,38,0,0,153
Alaska,Denali Park,856,0,143,115,253,139,650
Alaska,Petersburg,3106,202,663,610,435,109,2019
Alaska,Whitestone,80,0,10,32,7,2,51
Alaska,South Van Horn,552,46,102,158,41,9,356
Alaska,Susitna North,882,40,268,260,87,75,730
Alaska,Steele Creek,7380,193,1240,1776,1277,482,4968
Alaska,Northway,102,11,23,17,2,1,54
Alaska,Skagway,1005,49,173,288,213,45,768
Arizona,Bowie,363,116,89,46,5,2,258
Arizona,Brenda,406,18,125,192,6,65,406
Arizona,Bryce,48,0,14,0,0,0,14
Arizona,Buckshot,24,16,8,0,0,0,24
Arizona,Cactus Flats,1378,74,232,434,104,0,844
Arizona,Cactus Forest,955,155,166,200,63,0,584
Arizona,Campo Bonito,133,0,31,102,0,0,133
Arizona,Cane Beds,319,33,49,33,17,0,132
Arizona,Carrizo,119,19,12,19,0,0,50
Arizona,Wellton Hills,310,92,48,51,5,0,196
Arizona,Casa Blanca,1044,191,262,96,25,0,574
Arizona,Bylas,1719,258,375,212,21,11,877
Arizona,Beyerville,116,38,3,19,0,3,63
Arizona,Bear Flat,0,0,0,0,0,0,0
Arizona,Beaver Dam,1547,275,512,519,114,0,1420
Arizona,Aztec,0,0,0,0,0,0,0
Arizona,Avenue B and C,3708,1216,654,406,36,81,2393
Arizona,Washington Park,153,0,82,52,0,19,153
Arizona,Arlington,131,13,17,78,0,0,108
Arizona,Arivaca Junction,1233,287,255,109,68,19,738
Arizona,Walnut Creek,689,0,134,388,32,0,554
Arizona,Wall Lane,375,177,16,17,8,0,218
Arizona,Wahak Hotrontk,161,6,54,19,0,0,79
Arizona,Wagon Wheel,1602,186,272,391,159,109,1117
Arizona,Village of Oak Creek (Big Park),6057,263,924,1937,1299,1104,5527
Arizona,Vicksburg,621,60,282,176,42,39,599
Arizona,Vernon,122,10,29,14,21,0,74
Arizona,Verde Village,12473,845,2603,3441,918,871,8678
Arizona,Beaver Valley,251,22,96,87,0,32,237
Arizona,Cedar Creek,633,77,116,122,0,4,319
Arizona,Charco,28,6,7,5,0,0,18
Arizona,Central,417,0,59,164,20,26,269
Arizona,Benson,4884,462,1129,1436,435,266,3728
Arizona,Rock Point,461,68,143,52,21,23,307
Arizona,Douglas,16453,3090,3157,3736,750,318,11051
Arizona,Huachuca City,2275,152,414,648,123,39,1376
Arizona,Black Canyon City,3172,238,946,1205,229,111,2729
Arizona,Camp Verde,11169,1236,2334,2841,948,466,7825
Arizona,Cornville,3192,324,716,1107,360,224,2731
Arizona,Lake Montezuma,5212,509,1024,1977,350,223,4083
Arizona,Coolidge,12503,1316,2842,2521,801,423,7903
Arizona,Florence,26350,6042,6315,7023,1301,1031,21712
Arizona,Cornfields,313,50,42,68,17,3,180
Arizona,Nazlini,457,63,85,38,18,0,204
Arizona,Kykotsmovi Village,863,25,222,234,24,27,532
Arizona,Winslow,9505,1278,1792,2374,339,300,6083
Arizona,Ajo,3279,383,851,813,148,127,2322
Arizona,Marana,43606,1577,4874,10033,7917,5098,29499
Arizona,Tacna,761,83,156,156,33,15,443
Arizona,Window Rock,2952,337,524,777,218,65,1921
Arizona,Sierra Vista,43550,2075,5107,12997,5313,3003,28495
Arizona,Copper Hill,0,0,0,0,0,0,0
Arizona,Concho,116,26,17,36,0,0,79
Arizona,Comobabi,46,8,0,8,0,0,16
Arizona,Clacks Canyon,283,15,97,30,34,14,190
Arizona,Citrus Park,5033,109,803,1714,586,385,3597
Arizona,Cienega Springs,1882,208,534,559,115,70,1486
Arizona,Clay Springs,349,37,72,93,0,0,202
Arizona,Christopher Creek,125,0,46,61,18,0,125
Arizona,Chloride,385,47,160,116,24,19,366
Arizona,Chiawuli Tak,0,0,0,0,0,0,0
Arizona,Centennial Park,1236,50,183,105,58,29,425
Arizona,Ventana,93,41,11,0,0,0,52
Arizona,Wikieup,118,34,21,24,15,0,94
Arizona,Valle,204,86,24,94,0,0,204
Arizona,Wheatfields,354,104,92,55,18,0,269
Arizona,Whispering Pines,86,0,0,54,8,24,86
Arizona,Whitecone,801,157,139,179,0,8,483
Arizona,White Hills,221,45,75,18,47,36,221
Arizona,White Mountain Lake,2605,300,752,655,178,52,1937
Arizona,Tusayan,353,23,60,97,94,0,274
Arizona,Why,151,9,27,85,9,0,130
Arizona,Whetstone,2146,207,458,756,167,73,1661
Arizona,Theba,87,38,8,0,5,0,51
Arizona,Red Rock CDP (Pinal County),3775,198,430,808,330,179,1945
Arizona,Cottonwood,186,22,10,62,11,7,112
Arizona,Cowlic,168,9,18,19,0,0,46
Arizona,Crozier,40,10,9,13,1,0,33
Arizona,Crystal Beach,134,22,73,39,0,0,134
Arizona,Kohls Ranch,126,0,26,78,22,0,126
Arizona,Komatke,1156,206,124,136,19,13,498
Arizona,Lake of the Woods,3671,313,846,1061,232,225,2677
Arizona,La Paz Valley,762,425,109,128,82,0,744
Arizona,Red Rock CDP (Apache County),148,15,58,25,0,0,98
Arizona,Morristown,182,4,66,70,36,0,176
Arizona,Ko Vaya,8,0,4,4,0,0,8
Arizona,Gold Canyon,11038,414,2190,3244,2636,1327,9811
Arizona,Buckeye,65630,6312,10510,16714,5682,2090,41308
Arizona,Yucca,108,19,20,46,4,0,89
Arizona,York,725,37,155,157,99,3,451
Arizona,Woodruff,199,0,30,92,77,0,199
Arizona,Wittmann,641,52,276,33,14,14,389
Arizona,Wintersburg,24,0,15,0,0,0,15
Arizona,Willow Canyon,0,0,0,0,0,0,0
Arizona,Wet Camp Village,218,67,33,12,0,0,112
Arizona,Valle Vista,2132,166,724,544,232,108,1774
Arizona,Sehili,87,18,12,37,0,0,67
Arizona,Scenic,1792,281,410,446,65,52,1254
Arizona,Valentine,72,35,8,11,0,3,57
Arizona,Vaiva Vo,0,0,0,0,0,0,0
Arizona,Utting,115,22,35,58,0,0,115
Arizona,Upper Santan Village,489,116,172,43,11,0,342
Arizona,Turkey Creek,429,73,41,87,18,0,219
Arizona,Truxton,78,4,24,24,0,0,52
Arizona,Toyei,0,0,0,0,0,0,0
Arizona,Santa Cruz,0,0,0,0,0,0,0
Arizona,Wide Ruins,60,16,15,0,0,29,60
Arizona,Topock,15,0,0,15,0,0,15
Arizona,San Tan Valley,93230,4626,15674,24416,7865,3895,56476
Arizona,Arivaca,646,46,197,157,71,109,580
Arizona,Topawa,237,46,73,53,20,0,192
Arizona,Tonto Village,239,0,26,100,28,30,184
Arizona,Tolani Lake,370,59,75,78,0,0,212
Arizona,Tees Toh,574,83,102,142,17,7,351
Arizona,Tat Momoli,52,52,0,0,0,0,52
Arizona,Tonopah,51,0,51,0,0,0,51
Arizona,Sweet Water Village,73,5,42,0,0,0,47
Arizona,Sunwest,23,0,0,23,0,0,23
Arizona,Sun Valley,175,15,66,47,32,15,175
Arizona,Sunizona,198,20,68,53,23,15,179
Arizona,Summerhaven,157,0,16,18,17,9,60
Arizona,Stotonic Village,342,96,117,37,0,0,250
Arizona,South Komelik,298,15,71,34,11,8,139
Arizona,Solomon,389,39,100,106,18,12,275
Arizona,So-Hi,216,13,106,97,0,0,216
Arizona,Six Shooter Canyon,1065,93,308,171,77,40,689
Arizona,Seven Mile,990,174,268,150,0,20,612
Arizona,Seba Dalkai,123,42,11,31,0,8,92
Arizona,Anthem,22570,401,2023,5505,4908,2331,15168
Arizona,Many Farms,1288,129,175,269,91,77,741
Arizona,Anegam,120,16,50,13,17,0,96
Arizona,Hotevilla-Bacavi,1102,77,324,241,38,33,713
Arizona,St. Michaels,1218,157,267,352,54,71,901
Arizona,Lukachukai,1430,230,304,282,49,27,892
Arizona,Santa Rosa,494,99,157,70,10,0,336
Arizona,Safford,9735,758,1459,2864,611,280,5972
Arizona,Peach Springs,1333,194,301,217,10,22,744
Arizona,Show Low,11014,764,1820,3370,904,708,7566
Arizona,San Manuel,3753,580,841,913,263,78,2675
Arizona,Vail,12044,476,1480,3286,1818,815,7875
Arizona,Mohave Valley,2674,201,655,861,96,10,1823
Arizona,Gila Bend,1782,334,352,239,101,14,1040
Arizona,Somerton,15932,3475,2095,2166,674,189,8599
Arizona,Mojave Ranch Estates,17,3,5,4,2,0,14
Arizona,Leupp,1314,148,220,267,51,27,713
Arizona,Kayenta,4889,299,1167,650,217,222,2555
Arizona,Sierra Vista Southeast,16021,726,1999,4729,2124,1409,10987
Arizona,Corona de Tucson,8326,84,778,1967,1397,761,4987
Arizona,Prescott Valley,43198,4031,9338,11951,3909,2421,31650
Arizona,Paulden,4559,413,1022,1456,183,140,3214
Arizona,Chino Valley,11376,1450,2339,3721,873,333,8716
Arizona,Sedona,10315,433,1519,2647,2345,2044,8988
Arizona,San Simon,140,11,33,29,2,0,75
Arizona,Round Rock,769,144,111,127,18,0,400
Arizona,Chinle,5378,433,680,934,235,219,2501
Arizona,Burnside,602,59,108,116,40,16,339
Arizona,Kearny,2263,195,456,537,60,114,1362
Arizona,Chuichu,324,153,110,0,0,0,263
Arizona,Summit,5027,1236,903,694,75,8,2916
Arizona,Picture Rocks,9452,845,1938,2635,690,484,6592
Arizona,Snowflake,5724,239,565,1480,448,246,2978
Arizona,Drexel Heights,29514,3152,5318,7265,1545,637,17917
Arizona,Quartzsite,3707,657,894,1288,448,151,3438
Arizona,Mesquite Creek,473,64,182,150,22,13,431
Arizona,Gilbert,237484,5895,24173,52163,41875,21925,146031
Arizona,Bouse,1078,166,436,248,29,71,950
Arizona,Mountainaire,776,8,61,208,155,148,580
Arizona,Pima,2507,110,470,564,246,104,1494
Arizona,Phoenix,1610071,189422,239607,306459,184641,103840,1023969
Arizona,Kachina Village,2581,192,440,584,396,360,1972
Arizona,Bitter Springs,426,54,126,39,9,0,228
Arizona,Flagstaff,71202,2447,5686,11157,9736,6801,35827
Arizona,Wickenburg,7021,611,1710,2195,791,585,5892
Arizona,Mesa,491194,38587,81873,119194,57494,28247,325395
Arizona,Glendale,245514,25769,44642,52984,21567,12081,157043
Arizona,El Mirage,35004,3440,6995,6806,2190,925,20356
Arizona,Chandler,248631,11850,28463,52448,44471,27461,164693
Arizona,Wenden,315,83,68,57,32,5,245
Arizona,Bluewater,1004,101,299,279,46,25,750
Arizona,Payson,15439,1038,3437,4964,1967,1228,12634
Arizona,Claypool,1278,245,401,288,30,8,972
Arizona,Cottonwood,11826,947,3053,3063,880,464,8407
Arizona,Cordes Lakes,2410,374,517,824,118,94,1927
Arizona,Seligman,495,53,87,103,68,30,341
Arizona,Willow Valley,857,91,362,284,45,0,782
Arizona,Page,7547,477,1223,1936,531,268,4435
Arizona,Fredonia,1069,173,217,227,67,48,732
Arizona,Queen Creek,36053,762,4309,7893,5196,3080,21240
Arizona,Peoria,164572,8154,27289,40465,23369,12064,111341
Arizona,Cave Creek,5569,195,559,1438,1498,1029,4719
Arizona,Apache Junction,39674,4020,10437,11150,3310,1500,30417
Arizona,Globe,7346,758,1527,1869,559,350,5063
Arizona,New Kingman-Butler,13471,1726,3209,3584,519,232,9270
Arizona,Kingman,29244,2834,6173,8188,2099,1359,20653
Arizona,Antares,140,25,59,24,15,2,125
Arizona,Houck,863,124,195,241,4,6,570
Arizona,Tucson Estates,11758,738,2755,3735,1217,579,9024
Arizona,Rough Rock,471,43,115,95,11,31,295
Arizona,Ganado,1035,144,133,187,81,32,577
Arizona,McNary,657,61,122,119,12,3,317
Arizona,Chilchinbito,892,93,178,128,11,6,416
Arizona,Amado,53,0,20,18,7,8,53
Arizona,Cameron,1077,173,250,156,20,11,610
Arizona,Heber-Overgaard,2542,312,635,610,243,69,1869
Arizona,Kaibab,134,14,26,38,2,0,80
Arizona,Colorado City,4825,1074,402,283,46,20,1825
Arizona,Arizona Village,1288,110,305,291,96,89,891
Arizona,Tumacacori-Carmen,218,16,17,47,19,38,137
Arizona,Yuma,95573,12751,14868,20031,6638,3974,58262
Arizona,Ash Fork,814,121,144,170,22,0,457
Arizona,Tanque Verde,15860,291,1645,3630,3413,3387,12366
Arizona,Eagar,4875,231,661,1379,533,256,3060
Arizona,Pisinemo,339,37,80,9,0,0,126
Arizona,Whiteriver,4185,821,697,699,67,25,2309
Arizona,Catalina,7635,481,1510,2041,827,619,5478
Arizona,Green Valley,21723,871,4429,6810,5244,3889,21243
Arizona,Tucson,539216,51072,80611,116614,54816,36209,339322
Arizona,Valencia West,11919,927,2018,2936,1025,207,7113
Arizona,Fortuna Foothills,29485,3110,8063,8751,2475,1161,23560
Arizona,Casa Grande,54316,5663,10548,12819,3688,2215,34933
Arizona,LeChee,1589,185,372,286,29,10,882
Arizona,Dewey-Humboldt,4026,296,668,1551,452,203,3170
Arizona,Maricopa,47314,2224,8537,12232,4619,2588,30200
Arizona,Ali Chukson,96,0,30,7,0,0,37
Arizona,Ali Molina,54,0,9,9,0,0,18
Arizona,Alpine,119,0,19,56,18,5,98
Arizona,Springerville,1946,190,321,557,127,37,1232
Arizona,Dennehotso,779,112,317,71,15,0,515
Arizona,Tsaile,1296,107,124,169,67,30,497
Arizona,St. David,1332,86,170,393,177,79,905
Arizona,Three Points,5161,811,1218,1378,289,210,3906
Arizona,Second Mesa,1736,180,489,286,6,32,993
Arizona,Hayden,503,89,137,167,0,2,395
Arizona,Arizona City,11761,1507,2378,2807,704,310,7706
Arizona,Sonoita,808,44,123,214,177,114,672
Arizona,Nogales,20288,4446,3532,2696,1179,389,12242
Arizona,Eloy,18083,4567,4651,3511,626,434,13789
Arizona,Pirtleville,1572,465,337,281,19,0,1102
Arizona,Fort Defiance,4209,340,1234,813,143,100,2630
Arizona,Morenci,1510,29,307,446,74,31,887
Arizona,Duncan,662,84,207,149,21,28,489
Arizona,Superior,3018,573,877,694,110,61,2315
Arizona,Stanfield,572,145,234,0,0,0,379
Arizona,Dudleyville,662,91,228,188,0,0,507
Arizona,Blackwater,1566,266,439,152,18,0,875
Arizona,Ak-Chin Village,1185,215,227,114,24,5,585
Arizona,Casas Adobes,69615,3232,10412,18896,9725,7386,49651
Arizona,Winslow West,666,81,124,99,22,10,336
Arizona,South Tucson,5666,1331,1141,999,123,64,3658
Arizona,Pinon,738,90,123,81,57,76,427
Arizona,Pinetop-Lakeside,4330,297,717,1285,443,626,3368
Arizona,Keams Canyon,162,45,49,20,10,0,124
Arizona,Jeddito,258,38,30,51,3,1,123
Arizona,Cibecue,2187,370,416,243,25,0,1054
Arizona,Spring Valley,1636,210,360,568,93,15,1246
Arizona,Prescott,42068,2005,5534,12713,7113,5377,32742
Arizona,Peeples Valley,534,23,120,195,82,56,476
Arizona,Clarkdale,4258,290,1110,1563,363,442,3768
Arizona,Bagdad,1814,127,350,440,116,18,1051
Arizona,Naco,830,125,171,137,66,27,526
Arizona,San Miguel,266,11,71,46,0,9,137
Arizona,Top-of-the-World,325,62,93,66,30,41,292
Arizona,Sanders,533,54,32,125,8,3,222
Arizona,Drysdale,526,232,23,76,0,0,331
Arizona,Dripping Springs,210,20,65,60,15,4,164
Arizona,Dragoon,49,16,17,0,0,16,49
Arizona,Donovan Estates,1276,423,200,153,0,0,776
Arizona,Doney Park,5352,395,609,1211,883,513,3611
Arizona,Del Muerto,253,108,74,32,0,0,214
Arizona,Deer Creek,198,11,71,80,29,7,198
Arizona,Dateland,488,60,115,95,22,22,314
Arizona,Cutter,0,0,0,0,0,0,0
Arizona,Star Valley,1907,151,229,885,96,144,1505
Arizona,Ali Chuk,108,6,56,5,0,0,67
Arizona,Ak Chin,0,0,0,0,0,0,0
Arizona,Aguila,1164,478,107,54,8,0,647
Arizona,East Globe,148,18,21,20,24,24,107
Arizona,Rillito,0,0,0,0,0,0,0
Arizona,Rancho Mesa Verde,629,318,42,42,0,0,402
Arizona,Rainbow City,1008,228,264,81,10,0,583
Arizona,Pinion Pines,175,0,88,73,14,0,175
Arizona,Pinetop Country Club,1634,54,150,426,402,209,1241
Arizona,Pine Lake,79,0,47,32,0,0,79
Arizona,Pinedale,322,0,75,88,79,6,248
Arizona,Pinal,486,77,105,81,46,0,309
Arizona,Pimaco Two,776,108,266,180,58,0,612
Arizona,Picacho,401,61,122,104,5,3,295
Arizona,Palominas,231,0,103,66,26,18,213
Arizona,Padre Ranchitos,185,67,10,25,0,0,102
Arizona,Oxbow Estates,197,0,82,28,31,10,151
Arizona,Orange Grove Mobile Manor,634,241,74,39,8,0,362
Arizona,Alamo Lake,20,2,11,7,0,0,20
Arizona,Oatman,0,0,0,0,0,0,0
Arizona,East Verde Estates,121,0,40,39,42,0,121
Arizona,Elephant Head,794,71,197,249,24,24,565
Arizona,Lake Havasu City,53952,4505,14483,17508,4117,2468,43081
Arizona,Jerome,445,8,75,220,54,26,383
Arizona,Mayer,2101,144,593,623,76,41,1477
Arizona,Tonalea,264,57,39,33,0,9,138
Arizona,Peridot,1643,218,314,172,33,0,737
Arizona,Rio Verde,2107,19,177,545,876,490,2107
Arizona,Scottsdale,246026,6632,23945,51096,66287,42738,190698
Arizona,Sun City,39348,3006,13566,13472,5122,3534,38700
Arizona,Youngtown,6747,801,1559,1577,419,186,4542
Arizona,Poston,322,69,81,25,0,0,175
Arizona,Salome,1215,250,443,265,62,47,1067
Arizona,Bullhead City,40024,5777,11070,9882,2113,1048,29890
Arizona,Golden Valley,8673,1096,3199,2453,385,159,7292
Arizona,El Capitan,104,23,28,5,17,0,73
Arizona,San Carlos,4247,583,631,759,85,39,2097
Arizona,Avondale,83392,9029,13414,19146,6160,2937,50686
Arizona,Tempe,183652,8268,17662,35255,28814,20409,110408
Arizona,Tolleson,7184,1292,1381,1273,254,79,4279
Arizona,Parks,1392,30,322,452,214,222,1240
Arizona,Congress,1540,121,326,544,173,83,1247
Arizona,Wilhoit,933,156,250,335,60,10,811
Arizona,Fort Valley,1549,0,129,177,455,324,1085
Arizona,Fort Thomas,375,0,74,167,34,9,284
Arizona,Fort Mohave,15228,1227,4568,4414,1148,596,11953
Arizona,Fort Apache,198,19,14,62,25,10,130
Arizona,Flowing Springs,62,8,8,10,17,19,62
Arizona,El Prado Estates,547,129,34,31,6,0,200
Arizona,Elfrida,409,88,85,73,0,0,246
Arizona,Swift Trail Junction,3292,269,914,1214,121,86,2604
Arizona,Oak Springs,74,13,9,18,0,3,43
Arizona,Nutrioso,38,0,38,0,0,0,38
Arizona,North Fork,1787,165,345,458,93,31,1092
Arizona,Moenkopi,1300,112,459,257,36,45,909
Arizona,Sahuarita,28949,858,3433,7256,4855,2508,18910
Arizona,Oro Valley,43815,850,5102,9879,8606,8651,33088
Arizona,Winkelman,218,37,45,76,12,0,170
Arizona,Catalina Foothills,50426,623,4213,8145,12141,13518,38640
Arizona,Shonto,605,52,159,57,29,54,351
Arizona,Holbrook,5037,470,1146,1041,316,243,3216
Arizona,Greasewood,441,40,94,118,16,15,283
Arizona,Taylor,4170,417,790,1119,362,156,2844
Arizona,Gadsden,441,262,11,20,12,0,305
Arizona,Parker Strip,748,53,221,283,104,44,705
Arizona,East Fork,613,129,130,64,18,0,341
Arizona,Canyon Day,1466,256,233,208,16,21,734
Arizona,Kaibito,1522,229,324,187,41,3,784
Arizona,Williamson,5297,322,853,1901,814,718,4608
Arizona,Guadalupe,6405,1599,1473,754,96,36,3958
Arizona,Goodyear,77476,3813,11594,21311,9739,6017,52474
Arizona,St. Johns,3500,246,558,993,104,88,1989
Arizona,Red Mesa,386,38,80,105,6,24,253
Arizona,Litchfield Park,5899,160,625,1447,1250,882,4364
Arizona,Sun Lakes,14582,535,3386,5114,3293,2206,14534
Arizona,Sun City West,25444,1205,6747,9226,4909,3258,25345
Arizona,New River,15808,539,2711,5009,2623,992,11874
Arizona,Fountain Hills,24490,660,3003,6843,6216,4025,20747
Arizona,Gisela,611,47,99,215,20,13,394
Arizona,Tuba City,8662,787,1584,1756,490,422,5039
Arizona,Supai,15,6,0,2,0,0,8
Arizona,Williams,3152,283,527,788,372,139,2109
Arizona,Parker,3121,485,616,638,139,87,1965
Arizona,Grand Canyon Village,2130,30,479,718,195,119,1541
Arizona,Paradise Valley,14215,171,826,2004,3819,3770,10590
Arizona,Carefree,3749,4,677,883,1400,624,3588
Arizona,San Jose,589,28,125,136,13,0,302
Arizona,Nelson,591,18,114,114,28,0,274
Arizona,Moccasin,81,0,0,28,53,0,81
Arizona,Miracle Valley,778,267,82,162,32,0,543
Arizona,Mescal,1760,58,339,714,173,109,1393
Arizona,Mesa del Caballo,816,90,158,224,69,0,541
Arizona,Meadview,940,161,412,225,76,18,892
Arizona,Mead Ranch,0,0,0,0,0,0,0
Arizona,Martinez Lake,65,0,39,26,0,0,65
Arizona,Maricopa Colony,727,52,80,151,25,48,356
Arizona,Maish Vaya,169,15,68,20,0,0,103
Arizona,McNeal,140,18,19,35,32,11,115
Arizona,McConnico,0,0,0,0,0,0,0
Arizona,Lupton,18,0,2,5,0,0,7
Arizona,Low Mountain,732,125,132,155,13,3,428
Arizona,Lower Santan Village,206,48,32,0,0,0,80
Arizona,Littlefield,396,0,0,108,0,0,108
Arizona,Linden,2848,78,442,1099,278,204,2101
Arizona,Lazy Y U,285,0,46,96,71,60,273
Arizona,Tonto Basin,1540,178,355,578,99,93,1303
Arizona,Munds Park,868,0,109,160,278,182,729
Arizona,Cibola,293,103,57,47,0,0,207
Arizona,Young,553,9,156,145,79,31,420
Arizona,Central Heights-Midland City,2838,426,598,641,283,46,1994
Arizona,Miami,2084,476,445,315,58,48,1342
Arizona,Pine,1727,65,274,632,294,203,1468
Arizona,Ehrenberg,939,223,203,194,51,18,689
Arizona,Surprise,132904,7273,23402,36112,16499,8752,92038
Arizona,Thatcher,5030,162,644,1115,298,403,2622
Arizona,Desert Hills,2703,206,872,885,247,74,2284
Arizona,Willcox,3549,321,1014,589,57,150,2131
Arizona,Nolic,83,17,0,16,0,0,33
Arizona,Bisbee,5231,631,817,1384,630,450,3912
Arizona,Hunter Creek,19,10,0,0,9,0,19
Arizona,Hondah,1034,105,227,209,79,20,640
Arizona,Hard Rock,85,8,3,15,2,2,30
Arizona,Haivana Nakya,170,30,61,21,0,0,112
Arizona,Haigler Creek,30,0,21,9,0,0,30
Arizona,Hackberry,84,13,15,40,6,0,74
Arizona,Icehouse Canyon,563,47,95,197,64,25,428
Arizona,Tombstone,1375,82,307,570,107,55,1121
Arizona,Greer,38,0,0,18,20,0,38
Arizona,Grand Canyon West,0,0,0,0,0,0,0
Arizona,Goodyear Village,270,54,78,14,0,0,146
Arizona,Golden Shores,1064,148,326,431,0,103,1008
Arizona,Gila Crossing,758,95,139,153,36,15,438
Arizona,Geronimo Estates,0,0,0,0,0,0,0
Arizona,Gu Oidak,62,12,22,18,0,10,62
Arizona,Indian Wells,284,53,73,45,2,0,173
Arizona,Jakes Corner,73,14,24,35,0,0,73
Arizona,Joseph City,1557,30,170,471,58,54,783
Arizona,St. Johns,663,98,42,109,47,15,311
Arizona,Saddlebrooke,10530,205,1145,3244,2838,2469,9901
Arizona,Sacaton Flats Village,506,121,90,38,11,0,260
Arizona,Sacate Village,182,15,46,0,0,0,61
Arizona,Round Valley,640,11,78,221,70,7,387
Arizona,Roosevelt,72,8,21,36,7,0,72
Arizona,Rock House,91,24,37,24,6,0,91
Arizona,Rye,105,25,27,15,1,15,83
Arizona,Rio Rico,19601,2200,3375,3807,1630,771,11783
Arizona,Rincon Valley,5469,108,593,1071,1096,852,3720
Arizona,Kohatk,0,0,0,0,0,0,0
Arizona,Klagetoh,234,33,37,50,0,0,120
Arizona,Kino Springs,314,0,41,61,27,16,145
Arizona,Katherine,69,0,23,46,0,0,69
Arizona,Kaka,119,45,25,18,0,0,88
Arizona,Freedom Acres,135,20,27,44,0,0,91
Arizona,Franklin,54,11,20,11,6,0,48
Arizona,Strawberry,760,61,130,273,159,53,676
Arizona,Dolan Springs,2180,405,423,603,262,31,1724
Arizona,Yarnell,700,84,200,247,78,55,664
Arizona,Clifton,3691,257,738,1004,232,21,2252
Arizona,San Luis,32279,9719,2921,3894,1152,325,18011
Arizona,Wellton,2994,778,683,675,197,141,2474
Arizona,Elgin,117,0,26,30,25,36,117
Arizona,Patagonia,867,43,159,184,131,98,615
Arizona,Tubac,1230,46,167,253,415,319,1200
Arizona,First Mesa,1981,110,562,388,47,22,1129
Arizona,Oljato-Monument Valley,197,17,37,22,0,0,76
Arizona,Shongopovi,1102,45,222,227,29,6,529
Arizona,Dilkon,1215,180,199,209,39,14,641
Arizona,Flowing Wells,15290,1783,3519,3723,727,503,10255
Arizona,Sells,2749,277,686,327,37,10,1337
Arizona,Mammoth,1856,369,466,419,29,30,1313
Arizona,Oracle,3920,424,844,1076,330,225,2899
Arizona,Queen Valley,771,49,302,330,38,52,771
Arizona,Sacaton,2051,532,718,303,28,1,1582
Arizona,Teec Nos Pos,793,87,161,170,25,24,467
Arizona,Sawmill,771,110,214,68,5,3,400
Arizona,Avra Valley,5966,733,1571,1266,397,105,4072
Arizona,Steamboat,364,57,70,96,8,0,231
Arkansas,Hughes,1336,278,310,227,20,6,841
Arkansas,Swifton,836,86,220,128,51,44,529
Arkansas,Gravette,3340,375,784,547,272,117,2095
Arkansas,Lake View,459,61,83,87,23,1,255
Arkansas,Mineral Springs,1131,107,313,265,66,10,761
Arkansas,Hot Springs,36969,3723,8173,9550,3040,1480,25966
Arkansas,Daisy,90,12,24,30,7,2,75
Arkansas,Tupelo,134,16,40,21,12,3,92
Arkansas,Sparkman,434,84,146,55,43,10,338
Arkansas,Garner,175,49,44,35,7,0,135
Arkansas,Russellville,29244,2662,4673,4771,2658,1626,16390
Arkansas,Dover,1989,170,427,395,175,26,1193
Arkansas,Hatfield,434,45,118,90,9,6,268
Arkansas,Rudy,278,14,80,22,0,0,116
Arkansas,Pindall,112,14,26,17,5,4,66
Arkansas,Marshall,1508,242,464,314,51,45,1116
Arkansas,Humphrey,509,49,183,105,24,9,370
Arkansas,Valley Springs,189,30,39,32,0,0,101
Arkansas,Marmaduke,1399,169,381,284,38,19,891
Arkansas,Fordyce,3925,393,927,812,296,67,2495
Arkansas,Marion,12447,689,2521,2391,1377,888,7866
Arkansas,Casa,230,38,61,49,5,0,153
Arkansas,Branch,330,37,109,53,10,4,213
Arkansas,Centerton,13252,510,1888,2472,1965,710,7545
Arkansas,Biggers,291,45,67,64,13,12,201
Arkansas,Gillett,729,52,135,221,53,27,488
Arkansas,Almyra,263,16,89,79,20,2,206
Arkansas,Ratcliff,192,24,91,33,9,1,158
Arkansas,Paris,3426,394,1005,761,146,102,2408
Arkansas,Houston,157,15,83,30,4,0,132
Arkansas,Bono,2487,280,668,446,119,69,1582
Arkansas,Jericho,40,20,13,4,0,0,37
Arkansas,Magazine,918,116,268,197,14,0,595
Arkansas,Haynes,153,12,52,25,13,0,102
Arkansas,Aubrey,139,25,27,40,9,3,104
Arkansas,Russell,220,32,84,23,21,2,162
Arkansas,Anthonyville,138,10,43,28,4,4,89
Arkansas,Zinc,74,10,32,11,0,0,53
Arkansas,Gassville,2519,196,659,524,120,59,1558
Arkansas,Nimmons,85,10,32,12,7,0,61
Arkansas,Datto,94,25,24,5,1,0,55
Arkansas,Sulphur Rock,584,36,149,117,10,34,346
Arkansas,Coal Hill,1189,194,404,157,83,3,841
Arkansas,Booneville,3869,489,1133,546,159,102,2429
Arkansas,Dyer,730,100,156,153,70,23,502
Arkansas,Imboden,713,62,190,148,36,43,479
Arkansas,Lockesburg,886,121,158,231,17,36,563
Arkansas,Luxora,1203,226,295,153,24,7,705
Arkansas,McCaskill,74,10,23,5,0,2,40
Arkansas,Mount Vernon,148,18,41,38,10,6,113
Arkansas,Oakhaven,120,5,24,22,16,5,72
Arkansas,Ogden,185,21,48,29,7,11,116
Arkansas,Ozan,86,0,33,22,9,0,64
Arkansas,Patterson,429,68,112,62,18,1,261
Arkansas,Lexa,267,35,41,47,5,0,128
Arkansas,Peach Orchard,90,6,28,25,13,3,75
Arkansas,Pollard,179,31,79,18,5,4,137
Arkansas,Pottsville,3136,262,780,656,294,113,2105
Arkansas,Hamburg,2741,609,538,405,144,113,1809
Arkansas,Ulm,224,17,54,53,23,9,156
Arkansas,Higginson,698,57,148,155,34,26,420
Arkansas,Griffithville,126,28,57,18,10,0,113
Arkansas,Lepanto,2071,384,460,345,77,58,1324
Arkansas,Reyno,421,47,87,119,27,17,297
Arkansas,Perrytown,434,42,88,105,7,8,250
Arkansas,Lake City,2380,260,815,371,174,65,1685
Arkansas,Knoxville,861,116,239,164,68,8,595
Arkansas,Knobel,183,33,70,27,2,0,132
Arkansas,Salem,1845,241,395,370,122,39,1167
Arkansas,Van Buren,23296,2461,4946,4566,1935,805,14713
Arkansas,Parkin,767,165,264,143,18,4,594
Arkansas,Bonanza,507,58,128,111,34,13,344
Arkansas,Campbell Station,230,28,78,40,22,8,176
Arkansas,Caraway,1121,178,371,173,51,20,793
Arkansas,Cushman,422,57,136,77,11,4,285
Arkansas,De Valls Bluff,634,149,138,93,26,12,418
Arkansas,LaGrange,45,5,28,3,1,2,39
Arkansas,Evening Shade,454,61,126,130,8,11,336
Arkansas,Fisher,277,26,88,80,10,0,204
Arkansas,Fouke,838,87,307,100,17,7,518
Arkansas,Fulton,129,17,37,27,2,0,83
Arkansas,Gilmore,199,57,51,31,13,2,154
Arkansas,Greenway,170,21,71,22,3,4,121
Arkansas,Grubbs,436,31,218,70,3,2,324
Arkansas,Harrell,391,32,184,64,7,2,289
Arkansas,Helena-West Helena,10965,1625,2152,2177,519,373,6846
Arkansas,Jerome,37,11,9,11,2,0,33
Arkansas,Sedgwick,219,55,48,21,5,0,129
Arkansas,Georgetown,85,24,34,9,0,0,67
Arkansas,Grady,288,53,66,66,26,8,219
Arkansas,Paragould,28296,2165,7824,5401,2128,1109,18627
Arkansas,Damascus,464,23,108,121,31,8,291
Arkansas,Huntington,551,126,157,93,9,0,385
Arkansas,Washington,185,19,77,29,18,10,153
Arkansas,Bradley,575,84,177,68,21,7,357
Arkansas,Turrell,539,101,126,117,22,9,375
Arkansas,Buckner,284,47,71,62,29,2,211
Arkansas,Blevins,460,29,96,102,23,22,272
Arkansas,Patmos,63,6,21,23,3,0,53
Arkansas,Wrightsville,1671,469,537,341,21,6,1374
Arkansas,Sherwood,30812,1362,5855,7132,4326,2066,20741
Arkansas,McAlmont,2017,273,338,293,90,57,1051
Arkansas,Guion,161,20,51,21,14,5,111
Arkansas,Ola,1101,229,349,180,42,31,831
Arkansas,Bodcaw,212,23,55,42,12,3,135
Arkansas,Mount Pleasant,574,64,130,148,52,14,408
Arkansas,Stuttgart,8866,1100,2312,1634,548,354,5948
Arkansas,Strawberry,285,21,71,58,5,20,175
Arkansas,Conway,65069,2446,9200,11061,8483,5689,36879
Arkansas,Twin Groves,368,59,106,82,19,13,279
Arkansas,Lamar,2002,267,635,217,129,97,1345
Arkansas,Flippin,1342,190,375,215,57,14,851
Arkansas,Yellville,1162,122,234,278,27,14,675
Arkansas,Etowah,262,65,80,48,1,3,197
Arkansas,Keiser,647,106,129,96,11,3,345
Arkansas,St. Joe,171,20,23,24,12,1,80
Arkansas,Victoria,11,6,0,0,0,0,6
Arkansas,Foreman,1145,144,395,141,77,48,805
Arkansas,Greenbrier,5370,269,995,1207,438,201,3110
Arkansas,Rose Bud,540,57,144,133,26,16,376
Arkansas,Gurdon,2580,249,617,584,151,36,1637
Arkansas,Higden,113,14,20,21,15,10,80
Arkansas,Carthage,514,74,212,45,18,8,357
Arkansas,Magness,180,45,39,25,6,4,119
Arkansas,Piggott,3653,432,946,896,138,146,2558
Arkansas,Success,97,23,28,19,2,1,73
Arkansas,Garland,369,80,153,48,8,0,289
Arkansas,Hot Springs Village,14466,473,2501,4693,3164,1969,12800
Arkansas,Bassett,233,37,59,21,7,1,125
Arkansas,Emerson,253,11,94,42,6,3,156
Arkansas,Winthrop,145,15,45,47,3,1,111
Arkansas,Magnolia,11573,885,2019,2021,816,629,6370
Arkansas,Marianna,3685,686,1017,501,144,46,2394
Arkansas,Hoxie,2641,280,723,610,120,30,1763
Arkansas,Clarksville,9512,1418,2099,1184,608,410,5719
Arkansas,Edmondson,208,55,50,17,11,3,136
Arkansas,Jonesboro,74710,4197,14147,13620,8270,5587,45821
Arkansas,Burdette,175,17,58,43,10,0,128
Arkansas,Dell,226,18,58,56,17,7,156
Arkansas,Manila,3330,423,954,574,182,125,2258
Arkansas,Pine Bluff,43840,4116,10008,8452,3242,2081,27899
Arkansas,Cedarville,1328,168,305,307,74,55,909
Arkansas,Enola,335,29,99,52,43,10,233
Arkansas,Waldo,1409,159,408,132,106,47,852
Arkansas,Lynn,232,49,64,28,9,14,164
Arkansas,Redfield,1620,82,440,277,110,52,961
Arkansas,Star City,1862,200,629,268,110,60,1267
Arkansas,Portia,659,85,210,129,22,18,464
Arkansas,Tuckerman,2119,262,546,440,98,37,1383
Arkansas,Springtown,164,7,82,10,6,2,107
Arkansas,Leola,535,49,147,85,8,9,298
Arkansas,Cotter,930,85,218,197,76,65,641
Arkansas,Holland,643,44,208,125,63,20,460
Arkansas,Stamps,1562,212,427,259,139,39,1076
Arkansas,Hickory Ridge,237,34,68,30,6,10,148
Arkansas,Trumann,7089,760,2172,1114,491,119,4656
Arkansas,Smithville,83,4,34,12,12,3,65
Arkansas,Ward,4957,256,1512,1007,318,69,3162
Arkansas,Oak Grove,411,59,128,63,12,7,269
Arkansas,Mountain View,2834,787,500,703,162,70,2222
Arkansas,Portland,307,45,52,102,35,31,265
Arkansas,Mitchellville,423,84,103,58,15,10,270
Arkansas,Watson,196,46,79,25,12,4,166
Arkansas,Gillham,271,21,71,45,18,13,168
Arkansas,Clarkedale,448,43,79,93,35,27,277
Arkansas,Midway,456,19,133,106,37,14,309
Arkansas,Briarcliff,214,16,40,79,22,7,164
Arkansas,Cherokee Village,5067,349,1563,1162,479,175,3728
Arkansas,DeWitt,3117,371,794,545,284,36,2030
Arkansas,Adona,188,12,58,33,5,17,125
Arkansas,Ravenden,467,54,160,105,12,15,346
Arkansas,Lake Village,2461,294,577,389,245,85,1590
Arkansas,Gould,753,79,258,106,56,8,507
Arkansas,Fountain Lake,417,60,148,64,15,16,303
Arkansas,Diamond City,861,79,230,276,35,31,651
Arkansas,Alicia,155,27,30,44,7,0,108
Arkansas,Powhatan,58,9,19,7,4,3,42
Arkansas,Morrison Bluff,82,5,31,20,4,6,66
Arkansas,Salem,2047,133,442,683,257,52,1567
Arkansas,Midland,248,48,76,52,3,0,179
Arkansas,Oden,177,7,43,40,26,6,122
Arkansas,Allport,127,16,36,22,3,0,77
Arkansas,Central City,602,54,116,151,56,21,398
Arkansas,Hartford,599,90,161,86,28,13,378
Arkansas,Mansfield,1384,103,413,223,59,42,840
Arkansas,Felsenthal,58,4,28,10,4,10,56
Arkansas,Strong,350,77,154,33,5,9,278
Arkansas,Thornton,620,133,101,126,25,11,396
Arkansas,Fountain Hill,142,14,45,47,9,7,122
Arkansas,Bergman,628,63,159,146,39,14,421
Arkansas,Shannon Hills,3774,128,656,1005,432,209,2430
Arkansas,Vandervoort,133,16,23,12,9,0,60
Arkansas,Walnut Ridge,5125,351,1228,1116,326,216,3237
Arkansas,Rondo,339,88,85,43,5,2,223
Arkansas,Murfreesboro,1834,263,410,433,71,74,1251
Arkansas,Gum Springs,132,12,22,22,26,8,90
Arkansas,Lakeview,856,79,258,321,34,35,727
Arkansas,Maumelle,18053,655,1873,4129,3834,2271,12762
Arkansas,Forrest City,14475,1878,3523,3346,610,398,9755
Arkansas,Dermott,2631,415,878,442,164,46,1945
Arkansas,Kensett,1690,399,442,187,58,21,1107
Arkansas,Highfill,819,64,182,134,124,39,543
Arkansas,Eudora,2035,247,528,401,107,11,1294
Arkansas,Tinsman,49,9,17,3,2,0,31
Arkansas,Traskwood,403,60,138,96,6,3,303
Arkansas,Tyronza,943,83,352,176,31,4,646
Arkansas,Vilonia,4491,264,996,936,463,241,2900
Arkansas,Wabbaseka,265,27,86,50,17,4,184
Arkansas,Wilson,994,128,233,154,99,44,658
Arkansas,Wilton,265,52,115,55,4,0,226
Arkansas,Winchester,183,21,51,17,8,0,97
Arkansas,Bethel Heights,2597,398,498,264,206,56,1422
Arkansas,Alexander,3007,336,616,544,247,47,1790
Arkansas,Avilla,1273,39,250,385,207,36,917
Arkansas,Dennard,363,112,141,49,24,0,326
Arkansas,Brookland,3156,179,765,624,315,162,2045
Arkansas,Center Ridge,378,22,115,60,35,17,249
Arkansas,Cherokee City,42,0,14,14,14,0,42
Arkansas,Guy,721,14,206,149,55,47,471
Arkansas,Hagarville,154,0,8,29,29,18,84
Arkansas,Sunset,180,40,42,37,4,2,125
Arkansas,Holiday Island,2108,91,326,745,310,314,1786
Arkansas,Rockport,880,89,295,164,73,25,646
Arkansas,Harrisburg,2607,286,671,474,158,51,1640
Arkansas,Fifty-Six,122,16,43,30,0,6,95
Arkansas,Bauxite,579,59,131,114,63,3,370
Arkansas,Benton,34873,2640,6788,7538,3988,2294,23248
Arkansas,East End,7019,403,1767,1793,531,430,4924
Arkansas,North Crossett,3184,322,1202,628,88,45,2285
Arkansas,Rison,1294,148,362,191,88,54,843
Arkansas,McGehee,3858,399,987,601,252,80,2319
Arkansas,Cale,135,10,63,29,0,0,102
Arkansas,Big Flat,33,13,7,5,3,0,28
Arkansas,Gilbert,15,2,4,1,2,2,11
Arkansas,Letona,277,23,102,54,4,2,185
Arkansas,Amity,730,56,206,134,58,33,487
Arkansas,Fourche,56,14,35,1,0,4,54
Arkansas,Hazen,1321,177,374,224,144,55,974
Arkansas,Beebe,8055,356,1816,1454,819,428,4873
Arkansas,Judsonia,2088,372,649,263,64,49,1397
Arkansas,Arkadelphia,10611,562,1176,1396,1014,762,4910
Arkansas,Danville,2270,295,555,254,149,78,1331
Arkansas,Kirby,846,54,184,235,44,25,542
Arkansas,Landmark,3279,281,1110,748,226,85,2450
Arkansas,Lost Bridge Village,351,26,70,62,103,43,304
Arkansas,Widener,298,59,79,60,15,6,219
Arkansas,Viola,332,15,72,87,5,12,191
Arkansas,Poyen,261,20,50,65,16,10,161
Arkansas,Louann,166,15,44,25,6,0,90
Arkansas,Fredonia (Biscoe),364,52,112,59,19,6,248
Arkansas,Bradford,610,104,170,64,34,37,409
Arkansas,McRae,757,91,215,143,43,2,494
Arkansas,Weiner,745,89,211,133,48,27,508
Arkansas,Dardanelle,4594,843,1061,748,237,139,3028
Arkansas,Jacksonville,28588,1800,5966,6861,2318,1020,17965
Arkansas,Blue Eye,64,10,21,0,0,0,31
Arkansas,Egypt,52,10,11,10,2,1,34
Arkansas,Rogers,64947,7574,11508,9792,8169,4229,41272
Arkansas,Alpena,438,58,118,63,12,9,260
Arkansas,Everton,113,15,17,23,4,6,65
Arkansas,Hope,9847,1760,1870,1781,469,181,6061
Arkansas,Hartman,513,84,185,63,7,6,345
Arkansas,Waldron,3401,527,895,532,62,79,2095
Arkansas,Hensley,56,11,45,0,0,0,56
Arkansas,Havana,526,74,106,36,14,6,236
Arkansas,Perry,283,38,88,47,6,2,181
Arkansas,Maysville,307,0,144,15,0,0,159
Arkansas,Midway,965,168,231,262,12,22,695
Arkansas,Natural Steps,439,18,55,123,73,36,305
Arkansas,New Blaine,126,10,9,48,8,0,75
Arkansas,New Edinburg,370,4,98,55,41,0,198
Arkansas,Reader,194,9,76,38,0,0,123
Arkansas,Roland,537,42,154,203,40,21,460
Arkansas,Rye,181,27,19,17,41,0,104
Arkansas,Mount Ida,1240,168,273,290,109,46,886
Arkansas,Staves,142,21,50,53,0,0,124
Arkansas,Tumbling Shoals,876,120,249,223,87,36,715
Arkansas,Woodlawn,186,6,90,27,12,0,135
Arkansas,Yarborough Landing,430,8,157,97,88,16,366
Arkansas,Hermitage,947,103,168,111,21,2,405
Arkansas,Bella Vista,28328,725,5948,8015,4919,2378,21985
Arkansas,Magnet Cove,573,0,173,148,51,35,407
Arkansas,Southside,3934,386,1024,891,237,184,2722
Arkansas,Prescott,3072,288,868,592,119,90,1957
Arkansas,Sulphur Springs,790,81,347,165,55,0,648
Arkansas,Barling,4844,386,1305,1457,205,160,3513
Arkansas,Black Springs,44,10,14,6,3,3,36
Arkansas,Pleasant Plains,318,30,105,44,13,10,202
Arkansas,Eureka Springs,2011,180,417,494,427,147,1665
Arkansas,Concord,173,25,73,28,5,4,135
Arkansas,Caldwell,408,80,109,87,36,16,328
Arkansas,Moro,218,28,45,52,8,9,142
Arkansas,Blue Mountain,78,8,27,17,2,2,56
Arkansas,St. Charles,324,36,88,51,58,10,243
Arkansas,Franklin,156,46,38,40,7,2,133
Arkansas,Lafe,459,39,176,82,16,14,327
Arkansas,Shirley,295,16,113,32,25,10,196
Arkansas,Roe,80,4,32,30,3,2,71
Arkansas,Carlisle,2294,270,599,386,254,135,1644
Arkansas,Bald Knob,2891,328,779,480,163,55,1805
Arkansas,Amagon,63,13,33,13,0,0,59
Arkansas,Wilmot,477,56,130,77,10,5,278
Arkansas,Pangburn,536,52,228,86,12,6,384
Arkansas,Delight,423,38,121,95,20,8,282
Arkansas,Holly Grove,548,76,119,124,25,15,359
Arkansas,Searcy,23853,1514,3931,3301,2376,2133,13255
Arkansas,Elaine,656,71,159,119,19,14,382
Arkansas,Elm Springs,2268,237,425,360,354,181,1557
Arkansas,Augusta,2402,291,690,440,136,81,1638
Arkansas,Oppelo,764,46,224,170,43,6,489
Arkansas,Pocahontas,6506,721,1485,1458,474,148,4286
Arkansas,Lavaca,2794,199,657,566,172,116,1710
Arkansas,Kingsland,361,71,132,49,13,7,272
Arkansas,Taylor,605,37,173,92,34,9,345
Arkansas,Melbourne,1787,155,413,376,282,21,1247
Arkansas,O'Kean,298,31,69,65,22,0,187
Arkansas,Fort Smith,87639,11014,17557,17097,7640,3952,57260
Arkansas,Hunter,106,19,40,24,3,0,86
Arkansas,Calion,518,114,123,117,31,5,390
Arkansas,Johnson,3665,201,484,606,681,430,2402
Arkansas,Mayflower,1949,228,577,314,149,83,1351
Arkansas,McNeil,423,45,155,55,6,0,261
Arkansas,Ravenden Springs,150,21,45,31,4,2,103
Arkansas,Clinton,2534,290,757,483,116,107,1753
Arkansas,Fairfield Bay,2537,99,755,800,277,251,2182
Arkansas,Greenwood,9357,441,1520,2452,1186,324,5923
Arkansas,Norphlet,605,50,128,191,30,37,436
Arkansas,Rector,2098,197,541,467,78,80,1363
Arkansas,Sidney,199,47,31,34,6,0,118
Arkansas,Warren,5704,876,1639,907,365,114,3901
Arkansas,Wooster,988,60,171,224,98,94,647
Arkansas,Mammoth Spring,919,87,282,243,37,33,682
Arkansas,Decatur,1879,303,374,175,96,25,973
Arkansas,Bearden,1007,121,274,236,53,16,700
Arkansas,Chidester,297,41,139,52,9,0,241
Arkansas,Cotton Plant,595,84,268,115,8,2,477
Arkansas,Prairie Creek,2404,61,516,684,393,194,1848
Arkansas,Bellefonte,428,42,107,93,23,12,277
Arkansas,Tillar,269,59,59,46,15,4,183
Arkansas,Mountain Home,12303,907,3028,3693,1195,549,9372
Arkansas,Perla,280,41,76,44,7,5,173
Arkansas,Huntsville,2475,429,641,261,69,76,1476
Arkansas,Kibler,1122,116,414,180,73,26,809
Arkansas,Camden,11152,1181,2778,2066,733,426,7184
Arkansas,Greers Ferry,976,106,349,257,43,41,796
Arkansas,Glenwood,2085,342,529,360,91,179,1501
Arkansas,Wheatley,385,49,114,97,19,2,281
Arkansas,Tull,465,40,146,80,48,12,326
Arkansas,Black Rock,823,122,207,197,25,7,558
Arkansas,Sherrill,104,0,44,7,7,0,58
Arkansas,Western Grove,514,82,150,105,15,19,371
Arkansas,Keo,207,28,68,24,12,6,138
Arkansas,Bryant,19944,685,3758,4790,2804,1746,13783
Arkansas,Haskell,4552,215,1333,878,239,101,2766
Arkansas,Crossett,5075,456,1109,1219,388,95,3267
Arkansas,Parkdale,239,32,79,19,21,0,151
Arkansas,Cherry Valley,789,91,175,132,44,16,458
Arkansas,Marked Tree,2238,415,585,417,87,78,1582
Arkansas,Belleville,609,108,120,101,32,14,375
Arkansas,Clarendon,1759,254,532,334,105,37,1262
Arkansas,Corinth,70,6,15,23,18,0,62
Arkansas,Crawfordsville,665,49,154,106,75,17,401
Arkansas,Cash,345,69,96,40,8,0,213
Arkansas,Arkansas City,457,58,107,58,22,15,260
Arkansas,Emmet,691,78,159,155,35,9,436
Arkansas,Leslie,759,116,250,157,37,3,563
Arkansas,Highland,1101,60,396,207,64,29,756
Arkansas,Williford,67,17,20,18,0,0,55
Arkansas,Caulksville,250,38,47,67,43,12,207
Arkansas,Harrison,13069,1145,2841,3058,974,627,8645
Arkansas,McCrory,1511,303,444,245,95,38,1125
Arkansas,Bigelow,282,16,95,40,12,4,167
Arkansas,Newport,7695,1187,2244,1740,358,277,5806
Arkansas,Stephens,813,80,297,144,39,19,579
Arkansas,Sweet Home,714,74,161,108,8,33,384
Arkansas,North Little Rock,66282,5003,12877,13652,7662,4357,43551
Arkansas,Minturn,87,10,35,11,1,5,62
Arkansas,White Hall,5158,279,1013,1369,503,264,3428
Arkansas,Altheimer,859,112,250,178,42,2,584
Arkansas,Whelen Springs,38,11,3,5,0,0,19
Arkansas,Gosnell,3326,462,741,798,179,118,2298
Arkansas,Newark,1094,187,278,218,51,19,753
Arkansas,Cave City,2412,291,587,468,124,24,1494
Arkansas,Ben Lomond,86,17,16,15,4,6,58
Arkansas,De Queen,6612,1412,1183,612,282,120,3609
Arkansas,Bluff City,110,21,29,34,0,4,88
Arkansas,Okolona,133,9,34,52,6,9,110
Arkansas,Reed,158,48,44,18,1,9,120
Arkansas,West Crossett,1181,141,332,198,25,35,731
Arkansas,Austin,3043,77,476,721,312,136,1722
Arkansas,Colt,401,49,128,116,9,19,321
Arkansas,Plumerville,924,82,402,125,67,36,712
Arkansas,Madison,929,134,211,199,28,18,590
Arkansas,Cave Springs,3881,58,479,482,987,482,2488
Arkansas,Little Flock,2727,255,422,504,353,244,1778
Arkansas,Omaha,109,34,17,15,5,1,72
Arkansas,South Lead Hill,147,24,44,34,0,4,106
Arkansas,Monticello,9580,871,1529,1725,806,560,5491
Arkansas,Goshen,2061,40,125,463,497,213,1338
Arkansas,Lewisville,1047,88,349,209,51,16,713
Arkansas,Bull Shoals,2097,171,544,604,223,97,1639
Arkansas,Pyatt,271,34,50,80,17,0,181
Arkansas,Summit,426,62,126,106,3,0,297
Arkansas,Hampton,1341,186,367,343,65,24,985
Arkansas,Des Arc,1728,227,492,399,115,9,1242
Arkansas,Caddo Valley,655,24,114,180,79,35,432
Arkansas,Corning,3181,452,892,579,141,92,2156
Arkansas,Woodson,267,28,27,43,23,38,159
Arkansas,Scott,22,0,9,13,0,0,22
Arkansas,Alma,5688,537,1279,1273,306,121,3516
Arkansas,Brinkley,2823,499,823,394,119,49,1884
Arkansas,Palestine,739,138,205,128,11,6,488
Arkansas,Gateway,365,48,134,91,6,3,282
Arkansas,McDougal,138,26,65,19,0,0,110
Arkansas,West Fork,2581,167,611,463,217,211,1669
Arkansas,Winslow,426,44,117,67,15,29,272
Arkansas,Prairie Grove,5493,250,1346,1301,375,317,3589
Arkansas,Huttig,723,45,247,99,19,27,437
Arkansas,Smackover,1897,144,430,434,141,81,1230
Arkansas,Junction City,479,49,118,98,55,4,324
Arkansas,Ozark,3601,369,888,760,174,25,2216
Arkansas,Altus,851,82,229,144,58,15,528
Arkansas,Nashville,4447,546,984,825,309,100,2764
Arkansas,Dierks,1068,199,344,148,66,16,773
Arkansas,Horseshoe Lake,457,69,148,121,24,15,377
Arkansas,Mountain Pine,767,157,138,174,22,5,496
Arkansas,Lead Hill,192,27,69,32,2,3,133
Arkansas,Siloam Springs,16567,1725,3050,2365,1356,669,9165
Arkansas,Perryville,1685,139,497,311,86,29,1062
Arkansas,Waldenburg,44,7,26,0,0,0,33
Arkansas,Gibson,4972,213,1019,1312,495,287,3326
Arkansas,Elkins,3023,177,715,664,271,130,1957
Arkansas,Avoca,519,52,155,97,21,14,339
Arkansas,Oil Trough,228,12,62,51,2,3,130
Arkansas,Garfield,594,52,196,129,55,22,454
Arkansas,Pea Ridge,5485,293,1578,1029,479,178,3557
Arkansas,Calico Rock,2176,327,754,396,137,25,1639
Arkansas,Oak Grove Heights,1005,109,281,175,46,19,630
Arkansas,Batesville,10642,1135,2085,1937,1296,547,7000
Arkansas,Joiner,530,131,157,59,22,8,377
Arkansas,Dyess,295,37,76,32,9,0,154
Arkansas,Birdsong,35,6,9,4,0,3,22
Arkansas,McNab,39,0,11,8,0,0,19
Arkansas,Blytheville,14298,1434,3179,2701,690,677,8681
Arkansas,Monette,1785,329,599,334,137,34,1433
Arkansas,West Memphis,25009,2985,5584,4621,1781,572,15543
Arkansas,Jennette,88,8,46,10,5,0,69
Arkansas,Marie,55,7,19,6,0,0,32
Arkansas,Little Rock,198135,11594,29577,37247,32408,22726,133552
Arkansas,College Station,601,75,88,206,0,12,381
Arkansas,Cammack Village,763,3,48,152,188,155,546
Arkansas,Plainview,623,94,202,102,14,22,434
Arkansas,Sulphur Springs,390,55,126,67,42,8,298
Arkansas,Lowell,8926,1000,1693,1260,1086,579,5618
Arkansas,Bentonville,46857,1939,6310,6876,9443,5304,29872
Arkansas,Tollette,318,43,84,90,16,11,244
Arkansas,Weldon,78,16,32,11,0,4,63
Arkansas,Bay,2077,244,670,401,83,67,1465
Arkansas,Oxford,623,47,217,175,26,23,488
Arkansas,Coy,91,29,18,27,2,0,76
Arkansas,St. Francis,181,27,64,30,6,2,129
Arkansas,Norman,393,102,75,74,26,3,280
Arkansas,Cabot,26176,1539,4480,6478,2828,1354,16679
Arkansas,Osceola,7049,1032,1634,1452,259,156,4533
Arkansas,Leachville,2467,318,716,338,61,48,1481
Arkansas,El Dorado,18129,2132,3526,3332,1896,831,11717
Arkansas,Lincoln,2436,444,530,395,63,73,1505
Arkansas,Quitman,801,103,258,119,26,25,531
Arkansas,Mulberry,1658,233,489,404,61,23,1210
Arkansas,Mena,5597,523,1414,1464,297,125,3823
Arkansas,Hector,619,72,193,79,33,25,402
Arkansas,Beedeville,98,14,26,16,0,0,56
Arkansas,Jacksonport,194,23,53,27,4,0,107
Arkansas,Lonsdale,141,24,30,33,10,0,97
Arkansas,Mountainburg,586,80,113,131,29,18,371
Arkansas,Rockwell,4607,134,900,1401,675,233,3343
Arkansas,Jasper,517,72,135,118,43,23,391
Arkansas,Earle,2179,286,585,340,89,60,1360
Arkansas,Fayetteville,83736,3271,7747,12253,12325,10287,45883
Arkansas,Springdale,78690,12578,13153,11210,6998,3254,47193
Arkansas,Tontitown,3329,258,835,582,484,241,2400
Arkansas,Lake Hamilton,2128,146,751,489,147,106,1639
Arkansas,Marvell,1383,233,235,301,72,59,900
Arkansas,Charleston,2764,191,751,642,170,70,1824
Arkansas,West Point,150,25,41,35,6,1,108
Arkansas,Green Forest,2680,478,631,337,71,57,1574
Arkansas,St. Paul,67,7,14,6,17,12,56
Arkansas,Ashdown,4447,307,1048,1284,167,137,2943
Arkansas,Scranton,255,8,69,45,10,10,142
Arkansas,Delaplaine,100,16,14,22,11,6,69
Arkansas,Pineville,198,17,43,58,5,6,129
Arkansas,Black Oak,258,30,76,52,16,10,184
Arkansas,Subiaco,489,33,117,69,32,27,278
Arkansas,Hackett,863,82,236,131,34,0,483
Arkansas,Gentry,3739,248,979,865,325,109,2526
Arkansas,Willisville,348,22,127,62,9,11,231
Arkansas,Beaver,64,3,10,19,13,6,51
Arkansas,Lonoke,4251,474,908,841,318,174,2715
Arkansas,Norfork,585,83,141,127,48,22,421
Arkansas,Donaldson,336,20,93,69,16,6,204
Arkansas,Texarkana,30104,2920,7454,6589,2402,1316,20681
Arkansas,Friendship,143,17,47,29,14,0,107
Arkansas,Malvern,10853,1213,3214,2732,790,323,8272
Arkansas,Chester,150,43,27,35,0,17,122
Arkansas,Cove,243,38,62,68,25,4,197
Arkansas,Grannis,680,129,176,111,28,15,459
Arkansas,Wickes,1007,218,151,118,31,5,523
Arkansas,Atkins,3034,294,735,627,231,82,1969
Arkansas,Sheridan,4857,218,1083,876,544,346,3067
Arkansas,Heber Springs,7047,649,2137,1315,442,386,4929
Arkansas,Denning,230,45,73,36,3,3,160
Arkansas,Berryville,5421,634,1391,950,243,149,3367
Arkansas,Prattsville,347,19,116,62,10,9,216
Arkansas,East Camden,896,39,195,214,59,19,526
Arkansas,Antoine,64,3,19,23,6,0,51
Arkansas,Diaz,1204,154,281,247,66,30,778
Arkansas,Salesville,374,36,101,116,18,9,280
Arkansas,Hindsville,28,9,9,5,5,0,28
Arkansas,Horseshoe Bend,2464,185,665,746,108,52,1756
Arkansas,Hardy,648,125,228,153,24,14,544
Arkansas,Moorefield,178,14,37,23,34,15,123
Arkansas,Fargo,101,5,18,32,5,5,65
Arkansas,England,2757,285,624,556,218,91,1774
Arkansas,Humnoke,221,33,78,39,8,2,160
Arkansas,Banks,128,23,25,52,0,3,103
Arkansas,Montrose,450,62,107,73,21,0,263
Arkansas,Wynne,8017,753,1783,1610,486,425,5057
Arkansas,Dumas,4287,641,1163,604,224,195,2827
Arkansas,Farmington,6810,288,1432,1208,1026,542,4496
Arkansas,Rosston,317,23,90,57,19,18,207
Arkansas,Wiederkehr Village,25,0,3,7,10,2,22
Arkansas,Ash Flat,1168,168,349,325,61,18,921
Arkansas,Wilmar,317,30,143,46,22,9,250
Arkansas,Piney,4380,395,952,1302,257,160,3066
Arkansas,London,786,111,219,163,55,47,595
Arkansas,Menifee,170,17,46,24,22,6,115
Arkansas,Morrilton,6640,637,1778,1177,493,318,4403
Arkansas,Maynard,491,60,99,126,17,1,303
Arkansas,Horatio,1027,166,163,195,8,16,548
Arkansas,Greenland,1806,96,405,367,147,88,1103
California,Newell,342,132,30,25,0,0,187
California,Pine Flat,149,18,29,28,26,10,111
California,North Richmond,4233,1146,631,485,172,62,2496
California,North Gate,559,18,52,62,109,167,408
California,Norris Canyon,987,36,36,89,204,252,617
California,Nord,426,4,22,149,23,0,198
California,Nipinnawasee,319,32,105,102,4,0,243
California,Nicolaus,166,20,26,68,13,19,146
California,Nicasio,106,11,17,4,28,7,67
California,New Pine Creek,71,8,37,8,0,0,53
California,Pine Mountain Lake,2671,91,601,958,364,211,2225
California,New Cuyama,763,71,127,153,35,21,407
California,Myers Flat,0,0,0,0,0,0,0
California,Mount Laguna,0,0,0,0,0,0,0
California,Mount Hermon,998,63,58,104,209,143,577
California,Newcastle,1167,24,218,395,187,89,913
California,Mountain House,15645,373,1030,3296,2455,1749,8903
California,Mountain Gate,794,46,222,270,92,9,639
California,Mountain Center,0,0,0,0,0,0,0
California,Moskowite Corner,151,16,38,58,5,0,117
California,Monument Hills,1700,125,226,385,218,321,1275
California,Monterey Park Tract,291,83,9,9,0,11,112
California,Montalvin Manor,3023,574,425,658,235,59,1951
California,Monson,380,73,41,43,14,0,171
California,Mono City,98,0,19,0,0,33,52
California,Monmouth,103,33,8,22,0,0,63
California,Miranda,672,74,150,199,53,0,476
California,Minkler,1074,19,423,301,154,40,937
California,Milford,181,0,27,69,30,0,126
California,Midway City,8374,1692,1448,1459,749,165,5513
California,Midpines,1396,55,218,381,161,166,981
California,North San Juan,328,10,110,44,53,16,233
California,Pine Grove,1730,75,339,670,251,101,1436
California,North Shore,2892,1113,605,123,86,43,1970
California,Oak Glen,420,10,167,136,44,35,392
California,Pine Canyon,2294,510,286,368,243,103,1510
California,Pike,167,5,108,38,0,0,151
California,Pierpoint,0,0,0,0,0,0,0
California,Phoenix Lake,4283,257,889,1260,501,291,3198
California,Philo,201,9,44,66,8,0,127
California,Phillipsville,72,15,19,0,22,0,56
California,Phelan,15532,2018,3303,3463,571,391,9746
California,Peters,604,53,135,189,47,5,429
California,Pescadero,226,12,53,30,11,39,145
California,Penryn,925,123,179,243,111,47,703
California,Penngrove,2961,234,401,684,647,206,2172
California,Paynes Creek,53,7,18,26,2,0,53
California,Patton Village,604,84,109,162,40,0,395
California,Patterson Tract,2351,367,310,424,122,47,1270
California,Paskenta,105,9,29,30,0,0,68
California,Pasatiempo,1018,15,50,281,245,264,855
California,Parkway,15885,2302,3110,3245,551,223,9431
California,Parklawn,1082,412,125,33,35,0,605
California,Paradise Park,543,0,83,163,137,36,419
California,Paradise,186,8,23,36,40,18,125
California,Panorama Heights,42,9,8,20,3,2,42
California,Pajaro Dunes,255,0,90,28,41,96,255
California,Orick,296,41,57,101,11,10,220
California,Old Station,35,0,0,26,9,0,35
California,Old Fig Garden,5529,298,689,1111,1069,811,3978
California,Oasis,3020,1285,273,117,26,25,1726
California,Oakville,188,84,0,0,0,0,84
California,Oak Shores,282,18,50,90,49,39,246
California,Oak Hills,9700,1171,2232,2802,574,516,7295
California,Nubieber,20,4,0,9,4,0,17
California,Piñon Hills,7592,657,1580,1953,527,276,4993
California,Coffee Creek,186,7,33,45,28,26,139
California,Plainview,863,304,125,34,9,0,472
California,Dobbins,662,0,177,123,82,33,415
California,Dogtown,2629,417,557,645,242,98,1959
California,Dos Palos Y,242,102,44,36,0,0,182
California,Douglas City,668,59,146,184,105,9,503
California,Downieville,114,10,38,33,6,6,93
California,Doyle,622,59,121,327,19,0,526
California,Drytown,20,0,0,6,14,0,20
California,Dunnigan,1278,276,283,221,117,18,915
California,Dutch Flat,196,3,19,78,41,29,170
California,Eagleville,81,16,17,32,3,1,69
California,East Nicolaus,254,22,64,62,9,12,169
California,East Rancho Dominguez,16734,4630,2562,2050,288,30,9560
California,East Tulare Villa,980,185,185,192,5,55,622
California,Edmundson Acres,514,77,115,32,9,10,243
California,Diablo Grande,841,69,135,279,102,49,634
California,Edna,186,0,45,39,51,0,135
California,Elizabeth Lake,1895,173,475,536,155,68,1407
California,Elk Creek,191,0,35,61,16,2,114
California,El Nido,328,85,39,55,5,0,184
California,El Rancho,65,26,0,23,0,0,49
California,El Sobrante CDP (Contra Costa County),13736,845,2320,3536,2114,1003,9818
California,El Sobrante CDP (Riverside County),13966,799,1675,2873,2340,1560,9247
California,Elverta,5821,520,1316,1479,400,204,3919
California,Eucalyptus Hills,6017,240,919,1366,956,498,3979
California,Fairmead,1876,570,259,342,44,24,1239
California,Fiddletown,329,0,20,169,17,7,213
California,Fieldbrook,921,27,141,186,218,99,671
California,Fields Landing,325,83,109,0,133,0,325
California,Mexican Colony,363,67,100,13,5,0,185
California,Fish Camp,90,0,0,10,0,80,90
California,El Portal,268,3,27,57,53,17,157
California,Desert Palms,6947,52,1368,2638,1791,1098,6947
California,Desert Edge,3343,559,920,1011,298,176,2964
California,Desert Center,264,19,53,53,17,93,235
California,Winchester,2931,623,522,481,50,8,1684
California,Heber,4686,887,615,754,143,67,2466
California,Salton City,5611,1348,1422,599,207,106,3682
California,Cartago,7,0,7,0,0,0,7
California,Furnace Creek,127,15,64,32,11,0,122
California,Oak Park,13730,131,790,2673,3329,2644,9567
California,San Buenaventura (Ventura),110234,8069,14204,27845,16829,10170,77117
California,Clearlake Riviera,3933,274,742,1428,194,61,2699
California,Cleone,804,169,146,220,25,10,570
California,Clipper Mills,319,110,41,53,53,0,257
California,Coarsegold,1643,104,452,416,197,32,1201
California,Cohasset,990,23,175,201,176,136,711
California,Cold Springs CDP (El Dorado County),675,90,118,169,86,42,505
California,Cold Springs CDP (Tuolumne County),108,0,0,46,44,0,90
California,Coleville,515,0,127,125,135,8,395
California,College City,239,37,32,52,35,0,156
California,Collierville,2642,567,541,436,109,58,1711
California,Descanso,1644,53,264,631,148,68,1164
California,Delft Colony,653,73,140,45,17,0,275
California,Davenport,264,48,61,56,23,28,216
California,Daphnedale Park,135,8,54,17,0,0,79
California,Cuyama,9,7,1,1,0,0,9
California,Crows Landing,278,38,65,65,0,0,168
California,Pioneer,1443,98,190,573,158,49,1068
California,Crowley Lake,889,0,180,141,206,74,601
California,Cressey,356,55,55,82,43,4,239
California,Cowan,570,63,103,62,0,0,228
California,Courtland,537,43,87,209,55,0,394
California,Coronita,3138,229,410,689,232,191,1751
California,Comptche,83,8,8,51,0,0,67
California,Coloma,673,21,124,403,26,47,621
California,Creston,30,0,7,16,7,0,30
California,Mesa Verde,584,109,126,118,10,3,366
California,Blairsden,25,0,9,16,0,0,25
California,Mead Valley,19925,4218,4148,2730,427,167,11690
California,Floriston,20,0,0,20,0,0,20
California,Keeler,15,0,0,4,6,5,15
California,Victorville,121861,14842,21025,26232,6004,2995,71098
California,Rainbow,1994,263,352,583,238,123,1559
California,Carrick,47,0,12,35,0,0,47
California,Shandon,1141,288,203,261,59,14,825
California,Oceano,7678,1175,1430,1771,664,247,5287
California,Atascadero,30037,998,4589,8646,4663,2385,21281
California,Arroyo Grande,18039,649,3106,4818,2651,1690,12914
California,Dixon,19759,2638,3175,4216,1418,698,12145
California,Point Arena,418,64,64,93,39,27,287
California,Benicia,28088,718,3580,7280,5713,3176,20467
California,Elkhorn,1151,91,190,417,133,76,907
California,Del Rey Oaks,1596,56,173,445,334,254,1262
California,El Cajon,103285,11419,18674,23572,9434,4038,67137
California,Del Mar,4340,0,143,772,1376,1393,3684
California,Bostonia,17530,1895,3757,3728,1413,369,11162
California,Castroville,6686,1956,927,669,222,56,3830
California,Borrego Springs,2252,211,559,437,267,225,1699
California,Thermalito,6704,956,1444,1546,302,114,4362
California,South Oroville,3181,429,612,711,53,23,1828
California,Daly City,106638,11192,15576,23120,22828,6363,79079
California,Sand City,318,48,34,65,54,34,235
California,Atherton,7185,77,231,659,1630,2235,4832
California,Crest,2746,110,445,847,375,164,1941
California,San Diego Country Estates,10381,184,1486,3237,1576,797,7280
California,Klamath,617,93,157,142,47,14,453
California,Crescent City,6681,1724,1575,1430,255,217,5201
California,Bertsch-Oceanview,2042,319,490,490,56,79,1434
California,Oakhurst,3424,290,689,968,370,67,2384
California,Valley Ranch,10,0,5,0,5,0,10
California,Paxton,0,0,0,0,0,0,0
California,Hilmar-Irwin,5846,1042,1213,1100,529,146,4030
California,Vine Hill,3887,417,651,801,463,202,2534
California,Richmond,109340,16081,16264,21368,13642,7310,74665
California,Byron,1348,202,247,339,110,38,936
California,Rancho San Diego,21289,747,2537,5253,4266,2285,15088
California,Alamo,15317,146,530,1959,5300,2815,10750
California,Ashland,23635,3950,4264,4618,2268,587,15687
California,Beale AFB,1039,7,51,278,78,59,473
California,Tustin,80140,8134,9013,13176,14773,7722,52818
California,Rossmoor,11160,154,899,1920,2646,2103,7722
California,Huntington Beach,200606,10993,23712,48813,39182,23461,146161
California,Dana Point,33913,1545,2917,8585,8125,5241,26413
California,Cypress,48955,2388,6207,10918,9306,4961,33780
California,Brea,42330,1792,4678,9320,8160,4923,28873
California,Fullerton,139866,11812,16213,25894,24055,13689,91663
California,Anaheim,349668,52201,52706,64608,42169,15821,227505
California,Diablo,364,0,0,38,156,170,364
California,Clearlake,15323,2332,3616,3492,562,309,10311
California,Los Banos,38119,6282,7156,6062,1656,733,21889
California,China Lake Acres,1947,177,430,395,270,13,1285
California,Kennedy,3665,969,578,369,100,0,2016
California,Country Club,9846,1311,1936,2355,594,283,6479
California,Susanville,15216,2784,4056,2734,522,264,10360
California,Cameron Park,19902,902,3015,5923,2646,1323,13809
California,Mariposa,1351,80,252,649,123,75,1179
California,Novato,55523,2819,6387,12588,11763,6589,40146
California,Muir Beach,242,0,6,44,75,83,208
California,Madera,64362,14684,8008,9490,2745,822,35749
California,Lake Almanor Country Club,302,12,32,94,114,50,302
California,Almanor,0,0,0,0,0,0,0
California,Merced,82289,12084,11201,15263,4973,3321,46842
California,Wilkerson,431,29,98,109,68,16,320
California,Round Valley,533,67,106,181,91,11,456
California,Big Pine,1568,114,356,427,153,96,1146
California,Toro Canyon,1735,195,100,460,388,268,1411
California,Montecito,8611,106,321,1180,2013,1993,5613
California,Bear Valley Springs,5442,135,832,2138,728,488,4321
California,West Menlo Park,4116,63,98,248,807,1413,2629
California,Palm Springs,47525,4077,7718,12684,8378,6187,39044
California,La Quinta,40704,2703,5985,10173,6402,4120,29383
California,Lake Elsinore,64037,6902,10290,14082,4593,1879,37746
California,Reedley,25493,5346,3145,4470,1597,535,15093
California,West Bishop,2661,128,348,705,445,297,1923
California,Half Moon Bay,12706,1231,1600,2176,2379,2146,9532
California,Portola Valley,4594,56,274,346,1084,1624,3384
California,Meadow Valley,362,4,19,194,44,60,321
California,Walnut Creek,69007,1415,4994,12175,20229,15100,53913
California,Pittsburg,70492,8960,11534,15702,6602,2611,45409
California,Mountain View,2066,106,283,716,364,51,1520
California,Martinez,38117,1426,4983,9851,7375,3659,27294
California,Lafayette,26060,495,996,3617,7251,5738,18097
California,San Bruno,43114,3692,5282,9392,9199,4191,31756
California,Redwood City,85217,8330,9246,13585,14747,13970,59878
California,East Palo Alto,29633,6149,4192,4148,2043,1301,17833
California,Livingston,13997,3910,1447,2209,511,309,8386
California,Twain,33,0,8,25,0,0,33
California,Tracy,88806,8050,14750,19203,8988,3125,54116
California,Storrie,0,0,0,0,0,0,0
California,Lake Almanor West,126,0,5,40,36,45,126
California,Point Reyes Station,290,33,77,70,37,73,290
California,Inverness,1127,29,81,160,308,424,1002
California,Santa Paula,30258,6382,4425,5159,1614,1002,18582
California,Port Hueneme,22215,2909,3687,4865,2027,800,14288
California,Ojai,7555,482,803,1596,1443,1414,5738
California,Rollingwood,3110,643,508,558,99,44,1852
California,Pinole,19264,1693,2554,5782,3283,1372,14684
California,Iron Horse,60,0,0,60,0,0,60
California,Chilcoot-Vinton,147,0,16,86,45,0,147
California,Portola,1912,116,361,628,144,102,1351
California,Middletown,757,36,107,168,51,35,397
California,Arcata,18050,425,1215,2845,2915,1991,9391
California,Humboldt Hill,4268,349,743,1154,241,172,2659
California,Loma Mar,114,46,4,0,10,0,60
California,Loleta,676,40,83,196,92,8,419
California,Lodoga,126,29,44,24,8,0,105
California,Lockwood,604,27,178,83,25,13,326
California,Little River,189,0,11,122,0,0,133
California,Litchfield,178,0,15,55,38,5,113
California,Linnell Camp,686,233,86,35,0,0,354
California,Likely,0,0,0,0,0,0,0
California,Leona Valley,1581,101,291,569,128,38,1127
California,Lemon Hill,14096,2835,2664,2250,332,132,8213
California,Lompico,887,44,134,139,288,84,689
California,Lindcove,438,154,111,49,13,3,330
California,Lee Vining,89,0,0,26,29,26,81
California,La Vina,239,60,0,31,40,0,131
California,Las Flores CDP (Tehama County),294,78,42,34,0,0,154
California,San Marcos,94709,9129,11190,17618,14175,7127,59239
California,Rancho Santa Fe,2591,67,163,407,693,534,1864
California,National City,60896,10064,10532,12639,4640,1166,39041
California,Lakeside,22560,1566,4645,6580,1670,772,15233
California,Hacienda Heights,54970,5237,9378,11358,9439,4095,39507
California,East Pasadena,5971,569,694,1215,1175,691,4344
California,East Los Angeles,119827,36142,17395,14766,4792,1420,74515
California,Leggett,62,0,18,26,0,0,44
California,Desert View Highlands,2496,396,526,529,122,97,1670
California,Long Barn,93,0,93,0,0,0,93
California,Los Berros,541,114,65,57,47,13,296
California,Meadowbrook,3033,478,677,808,180,37,2180
California,Mayfair,5091,1027,697,1136,205,30,3095
California,Maxwell,1096,189,253,230,40,15,727
California,Mather,4408,255,516,1008,833,309,2921
California,Matheny,1134,268,134,170,8,0,580
California,Martell,300,12,36,115,23,0,186
California,Marin City,3173,280,424,723,486,282,2195
California,March ARB,1150,61,142,349,130,129,811
California,Manila,834,37,170,244,116,80,647
California,Manchester,199,30,47,34,24,3,138
California,Lookout,76,3,7,21,12,0,43
California,Mad River,432,38,125,94,45,16,318
California,McSwain,4137,368,527,1040,681,261,2877
California,McGee Creek,0,0,0,0,0,0,0
California,McClenney Tract,41,0,14,8,6,0,28
California,McClellan Park,809,98,121,246,52,47,564
California,Mabie,74,0,14,45,15,0,74
California,Lytle Creek,724,62,309,132,71,64,638
California,Lucerne Valley,5423,497,1647,1384,218,187,3933
California,Los Ranchos,1730,8,148,218,554,306,1234
California,Los Osos,16292,902,1734,4544,3047,2088,12315
California,Los Olivos,831,20,113,171,185,159,648
California,Madison,563,157,90,50,13,10,320
California,Burbank,104275,6813,13922,23754,21899,9608,75996
California,Orange Cove,9564,2685,1304,772,89,0,4850
California,Kingsburg,11839,870,1865,2543,1420,827,7525
California,Oceanside,175389,16086,25034,43060,24488,12183,120851
California,Nipomo,17445,1715,2726,4583,1825,972,11821
California,Rio del Mar,9775,166,669,2138,2516,1798,7287
California,Live Oak,17390,1370,1886,4377,2856,1832,12321
California,Interlaken,7191,1477,1132,1198,426,239,4472
California,West Sacramento,52826,5551,7290,10762,6730,3354,33687
California,Fresno,522277,73146,70881,102098,45134,22559,313818
California,Coalinga,16538,3031,2666,3517,761,451,10426
California,Rodeo,10411,881,1775,2454,1173,580,6863
California,Oakley,40669,3205,6652,10058,3227,1310,24452
California,Markleeville,143,6,17,7,36,13,79
California,Round Mountain,112,3,48,39,6,0,96
California,Tuolumne City,1577,179,336,501,112,25,1153
California,Hercules,25343,1211,2775,6159,5201,2512,17858
California,Jamestown,2687,139,683,1066,198,87,2173
California,Columbia,2217,117,518,663,210,127,1635
California,Calistoga,5285,636,671,1428,743,419,3897
California,Angwin,3424,218,209,617,436,294,1774
California,West Athens,8574,1200,1868,2042,412,375,5897
California,View Park-Windsor Hills,11580,357,977,3012,2613,1991,8950
California,Vernon,90,7,11,35,12,1,66
California,Temple City,36137,3957,5400,6511,6984,3013,25865
California,Millville,682,20,74,226,77,73,470
California,Morro Bay,10592,712,1513,2806,1657,1347,8035
California,Fort Jones,832,70,195,211,50,26,552
California,Grenada,477,44,128,74,30,12,288
California,Fowler,6364,981,986,1290,535,227,4019
California,Del Rey,1498,531,79,131,60,34,835
California,Piedmont,11308,63,240,1041,2798,3739,7881
California,Oakland,421042,56014,46623,72709,73964,55787,305097
California,Atwater,29197,4725,4134,5881,1757,721,17218
California,Ukiah,15946,2026,2620,3728,1522,816,10712
California,Covelo,1165,132,180,296,112,46,766
California,Pleasanton,80847,2115,6054,12552,19183,15967,55871
California,Bethel Island,2010,335,423,593,143,0,1494
California,South Dos Palos,1682,470,135,300,42,0,947
California,Quincy,1895,94,262,484,216,192,1248
California,Prattville,28,6,10,8,0,4,28
California,Plumas Eureka,333,4,31,121,121,45,322
California,Indian Falls,54,0,45,9,0,0,54
California,Graeagle,596,0,119,203,128,56,506
California,Cromberg,253,0,46,146,41,10,243
California,Tecopa,146,14,13,51,4,29,111
California,Pearsonville,29,0,0,20,0,9,29
California,Valley Acres,617,68,151,155,31,0,405
California,Shafter,18923,4683,2959,1770,640,208,10260
California,Pine Mountain Club,1803,75,444,456,260,72,1307
California,Lamont,15222,5247,1814,927,159,35,8182
California,Norwalk,105886,17595,19291,20297,8975,2882,69040
California,Meridian,405,67,82,97,32,5,283
California,Flournoy,171,8,52,31,13,2,106
California,Santee,57615,2643,10331,15683,8093,3570,40320
California,Forest Ranch,538,16,96,204,49,98,463
California,Plymouth,894,128,202,209,24,36,599
California,Jackson,4694,258,1133,1503,552,127,3573
California,Pollock Pines,6905,467,1531,1683,803,377,4861
California,Placerville,10860,888,2249,2615,1285,697,7734
California,Diamond Springs,11989,1179,2725,3633,1305,328,9170
California,Redding,91327,5169,14079,27124,10669,5836,62877
California,Anderson,10265,873,2097,2881,379,252,6482
California,Greenhorn,254,19,28,93,41,19,200
California,East Shore,169,49,38,24,31,5,147
California,C-Road,97,0,0,42,22,22,86
California,Clio,65,0,0,31,18,8,57
California,Sutter Creek,2538,185,528,718,241,212,1884
California,Amador City,167,5,30,44,29,8,116
California,San Ramon,75384,1699,3636,9573,19371,14713,48992
California,Pacheco,4355,447,762,1336,633,263,3441
California,Discovery Bay,15981,396,2421,4734,2342,1057,10950
California,Danville,44417,734,2399,6927,12649,7363,30072
California,Concord,128758,11172,18157,30197,22561,9979,92066
California,Clayton,11967,163,893,2535,3016,1586,8193
California,Cherryland,16387,2692,3029,3112,1480,467,10780
California,North El Monte,4028,223,672,972,641,254,2762
California,Bishop,3765,211,903,757,475,420,2766
California,Darwin,56,0,0,37,7,12,56
California,Lone Pine,1837,373,347,363,148,68,1299
California,Mesa,317,13,65,96,75,10,259
California,Selma,24598,4602,4165,4092,925,363,14147
California,Riverdale,3625,928,576,545,118,53,2220
California,Caruthers,2773,730,323,346,127,74,1600
California,Union City,74601,5117,14582,14413,12953,7373,54438
California,Sunol,962,74,145,246,179,119,763
California,Friant,548,41,65,223,37,18,384
California,Desert Hot Springs,28430,4840,5570,4931,1616,739,17696
California,Weaverville,3240,355,428,1153,366,143,2445
California,Pine Hills,3146,191,484,1023,353,215,2266
California,Myrtletown,5290,339,986,1803,496,363,3987
California,Whittier,86523,7817,15034,20035,9095,5700,57681
California,Cobb,920,9,223,404,113,29,778
California,Big Bend,96,9,21,29,2,6,67
California,Taft Mosswood,951,430,89,135,32,8,694
California,Ripon,15367,1069,2488,3659,1712,970,9898
California,Manteca,77073,7987,16591,17253,5687,1975,49493
California,Whitehawk,66,10,0,37,12,7,66
California,Spring Garden,13,0,13,0,0,0,13
California,Lake Davis,65,0,16,21,0,28,65
California,Hamilton Branch,612,36,110,212,84,55,497
California,Chester,2116,131,548,846,219,47,1791
California,Caribou,0,0,0,0,0,0,0
California,Palo Cedro,1151,12,175,397,147,73,804
California,Westmorland,2643,547,346,402,94,14,1403
California,Rolling Hills,1630,34,102,213,362,479,1190
California,Solana Beach,13370,468,1081,2005,3647,2989,10190
California,Signal Hill,11538,1246,1029,2589,2065,1251,8180
California,Pico Rivera,63432,12097,13473,11184,3985,1349,42088
California,Montebello,63099,11563,11987,10662,5938,2231,42381
California,Mayflower Village,5822,410,997,1109,1217,412,4145
California,Culver City,39295,2244,3464,6986,9190,7269,29153
California,Las Lomas,3755,1024,452,495,11,39,2021
California,Santa Clarita,209478,12927,25365,49744,32958,15425,136419
California,Taft,9307,1518,2215,1403,437,111,5684
California,San Pablo,30839,6645,5272,5246,1831,636,19630
California,Port Costa,186,28,0,74,58,26,186
California,South Whittier,60096,8358,12366,11985,4132,1496,38337
California,Yosemite Valley,1110,174,165,299,261,33,932
California,La Selva Beach,2917,90,190,639,658,560,2137
California,Lake Sherwood,1835,27,117,251,525,425,1345
California,Lake Riverside,1049,23,263,340,74,63,763
California,Lake Mathews,6848,638,1348,1354,588,411,4339
California,Lake Hughes,587,8,166,178,67,67,486
California,Lakehead,617,60,147,229,52,11,499
California,Lake Don Pedro,1030,146,261,222,132,39,800
California,Lake City,59,8,9,29,13,0,59
California,Lake California,3281,243,362,1076,418,95,2194
California,La Honda,711,27,114,157,211,124,633
California,Las Flores CDP (Orange County),5877,91,230,1223,1294,702,3540
California,Davis,67988,853,2298,5477,10681,15443,34752
California,Walnut Park,16034,5630,2188,1856,569,207,10450
California,Willow Creek,1539,54,311,509,220,55,1149
California,Fort Bragg,7298,801,1626,1552,612,303,4894
California,Duarte,21713,2506,3229,5070,2703,2018,15526
California,Eldridge,1351,35,101,402,294,104,936
California,Mendocino,782,0,42,153,191,281,667
California,Agoura Hills,20636,573,2102,3651,5136,3193,14655
California,Los Molinos,1845,176,315,392,148,118,1149
California,La Presa,37437,4198,5964,9885,3436,1078,24561
California,Poplar-Cotton Center,2436,894,518,201,60,0,1673
California,Lemoore,25791,2386,3792,6484,1887,569,15118
California,Santa Ana,333499,86024,45731,45030,20958,7727,205470
California,Westlake Village,8424,119,631,1200,2398,2026,6374
California,Lake Forest,82911,4472,8291,18234,17536,9799,58332
California,Mountain View,80993,3873,5567,9169,17122,23289,59020
California,West Point,571,24,220,188,20,25,477
California,El Dorado Hills,45599,972,3638,9042,10251,6326,30229
California,Niland,515,169,98,46,0,0,313
California,Bombay Beach,415,13,116,177,16,24,346
California,Westhaven-Moonstone,1084,11,128,213,255,223,830
California,Trinidad,272,0,11,39,81,71,202
California,Fortuna,12117,1117,2556,3099,1077,327,8176
California,Upper Lake,1050,35,293,311,37,33,709
California,Nice,2393,142,613,751,181,103,1790
California,Bonsall,4464,384,597,1022,790,488,3281
California,Esparto,3783,474,591,750,243,214,2272
California,Aptos Hills-Larkin Valley,1993,150,202,366,336,428,1482
California,Ben Lomond,7071,187,666,1972,1361,696,4882
California,Tipton,3218,1042,329,275,0,0,1646
California,San Juan Capistrano,35952,3770,4647,6688,5882,3182,24169
California,Ivanhoe,4198,1185,748,472,155,0,2560
California,East Porterville,6679,1967,1034,545,105,12,3663
California,Waterford,8823,1940,1511,1336,200,98,5085
California,Bystrom,4099,1215,491,344,98,22,2170
California,Perris,76276,13986,12774,11112,2551,963,41386
California,Indian Wells,5317,133,597,1385,1508,1295,4918
California,Hemet,84069,10746,17324,20247,4197,2134,54648
California,Mission Canyon,2755,62,166,423,800,667,2118
California,Woodville,1852,593,256,113,36,11,1009
California,Los Alamos,1623,282,311,259,72,39,963
California,Morongo Valley,3262,285,677,1009,346,252,2569
California,Joshua Tree,6980,732,1265,2067,621,361,5046
California,Yucca Valley,21543,1980,4689,6286,1265,1178,15398
California,Highland,54859,7605,8026,10721,3705,2749,32806
California,Westwood,1545,81,313,580,144,78,1196
California,Alturas,2577,227,643,878,187,43,1978
California,McArthur,386,79,115,57,0,0,251
California,Burney,3807,489,861,817,247,103,2517
California,Soulsbyville,2286,42,518,728,178,41,1507
California,Windsor,27506,2573,3819,6724,3599,1862,18577
California,Ontario,173580,29736,28568,31828,12540,4707,107379
California,Sonoma,11074,779,1522,2668,2420,1356,8745
California,Rancho Santa Margarita,48792,1401,4278,9882,11035,5519,32115
California,Big Bear Lake,5229,336,862,1627,627,358,3810
California,Thousand Oaks,128481,6138,11964,26971,26037,18641,89751
California,Olancha,213,59,63,35,4,0,161
California,Independence,542,27,170,132,79,19,427
California,Ione,7439,1100,1882,2203,529,253,5967
California,Bonadelle Ranchos-Madera Ranchos,8971,590,1352,2451,824,537,5754
California,Seeley,1699,321,200,388,77,0,986
California,Palo Verde,85,21,28,36,0,0,85
California,Calipatria,7458,2158,1748,1183,41,72,5202
California,Palm Desert,52124,3302,8610,14446,8667,5709,40734
California,Exeter,10505,1117,1772,2667,545,242,6343
California,Olivehurst,13309,2244,2227,3236,509,150,8366
California,Ducor,651,173,116,77,6,9,381
California,Auburn,13946,708,1806,4076,2322,1514,10426
California,Boulder Creek,4712,197,409,1750,840,513,3709
California,Aptos,5797,156,279,1446,1482,986,4349
California,South San Gabriel,8643,1895,1529,1592,1113,337,6466
California,Rosemead,54417,13265,10242,8063,5401,1528,38499
California,Willows,6022,885,1081,1523,440,158,4087
California,Wilton,5307,233,964,1528,735,446,3906
California,Gold River,7523,247,303,1458,2289,1585,5882
California,Citrus Heights,87061,6018,15709,26845,9118,3586,61276
California,Arden-Arcade,100548,6361,15757,21913,15540,9010,68581
California,Dollar Point,786,25,172,271,175,83,726
California,Ladera Ranch,30288,674,1119,4064,7916,3969,17742
California,Monte Rio,1156,118,268,326,120,117,949
California,Hanford,55893,6605,8304,13652,4308,2106,34975
California,Alameda,78462,5483,6928,15028,18698,11539,57676
California,San Gabriel,40242,6158,7869,5845,7227,2249,29348
California,Sierra Madre,11006,113,1059,2021,3066,2237,8496
California,Santa Fe Springs,17791,2255,3760,3825,1479,539,11858
California,San Marino,13285,217,645,1515,3459,3912,9748
California,Redondo Beach,67700,1825,5317,13277,18176,11425,50020
California,Quartz Hill,10164,816,1841,2708,820,543,6728
California,Palmdale,156904,24237,23516,31076,9416,4568,92813
California,Monrovia,37006,2781,5093,8662,5776,3707,26019
California,Maywood,27542,8587,4665,2451,717,144,16564
California,Albany,19758,636,858,1914,4579,5329,13316
California,Manhattan Beach,35573,514,1712,4055,10058,8502,24841
California,Downey,112901,16463,18563,22753,11707,5402,74888
California,Del Aire,10065,902,1304,1802,1991,828,6827
California,Covina,48403,4562,7895,11371,6273,2323,32424
California,Bell Gardens,42641,12797,6492,3792,941,254,24276
California,Tranquillity,839,270,140,100,0,0,510
California,Mendota,11393,3982,1479,552,116,0,6129
California,Beverly Hills,34362,1054,2833,5577,8826,7283,25573
California,Laton,2166,586,234,357,18,0,1195
California,Lanare,234,80,17,38,0,0,135
California,Capitola,10135,553,1484,2923,1482,1203,7645
California,Glendale,200372,20107,30498,40354,38101,20980,150040
California,San Juan Bautista,2106,134,347,530,230,151,1392
California,Lynwood,71022,18541,12133,8723,2182,686,42265
California,San Lorenzo,25388,2889,5025,5192,3601,1195,17902
California,Dos Palos,5272,984,982,800,182,186,3134
California,Delhi,11735,2996,1514,1815,219,136,6680
California,Lake Los Angeles,11469,1782,2676,2213,363,157,7191
California,Huntington Park,58694,19122,8192,5421,1595,466,34796
California,Glendora,51773,3584,6977,12777,7874,5074,36286
California,El Monte,115669,32040,20257,14828,7044,1793,75962
California,Claremont,36025,1366,2618,6210,5887,7364,23445
California,Altadena,45146,3728,5159,9434,7587,7088,32996
California,Alondra Park,8097,1105,1017,1589,1120,316,5147
California,Orange,139873,13042,17600,27944,22840,10840,92266
California,Fairview,10299,594,1543,2682,1953,1130,7902
California,Costa Mesa,113198,12008,13481,22173,21958,9774,79394
California,Dublin,59172,2211,4279,8266,15008,10897,40661
California,Placentia,52049,4718,5450,11106,8672,4683,34629
California,Laguna Beach,23147,424,1397,4144,6372,5724,18061
California,Richgrove,2611,1102,316,154,16,4,1592
California,Stanton,38509,7466,6453,6865,2931,1196,24911
California,Rolling Hills Estates,8187,90,622,1210,2165,1875,5962
California,Palos Verdes Estates,13523,114,510,1701,4071,3231,9627
California,Los Angeles,3959657,623109,526462,648724,598869,315451,2712615
California,Oakdale,22599,1921,4052,5061,1827,902,13763
California,Denair,5131,626,1025,1101,311,165,3228
California,Emeryville,11724,357,841,1664,3973,2944,9779
California,Knights Landing,869,374,110,90,63,28,665
California,Kingvale,73,0,0,0,40,0,40
California,Keswick,430,41,93,93,32,16,275
California,Delano,52713,13921,8659,6856,1684,421,31541
California,Bodfish,1384,214,457,294,136,73,1174
California,Corte Madera,9866,123,557,1481,2421,2123,6705
California,Bolinas,1077,7,101,241,297,298,944
California,Ocotillo,58,0,34,17,0,0,51
California,Desert Shores,619,290,66,63,63,0,482
California,Calexico,39934,8767,5059,6699,2643,1071,24239
California,Thousand Palms,7814,1114,2013,1642,557,234,5560
California,Murrieta,111427,6214,15752,25920,13824,6792,68502
California,Indio,88291,12894,21225,16746,5926,3428,60219
California,Channel Islands Beach,2864,85,366,646,635,355,2087
California,Romoland,2227,509,281,361,47,86,1284
California,Truckee,16377,928,1414,3531,3883,1748,11504
California,Lake of the Pines,4137,48,538,1133,707,570,2996
California,North Lakeport,3141,326,714,889,273,149,2351
California,Lucerne,2956,364,582,782,207,184,2119
California,Imperial,17175,1312,1895,4056,1295,679,9237
California,Holtville,6458,1181,956,1053,317,180,3687
California,El Centro,43898,7653,6149,7917,2969,1699,26387
California,Brawley,26009,4552,3780,4914,1623,452,15321
California,Home Gardens,11442,2229,1978,1777,700,180,6864
California,Calimesa,8651,701,2105,2418,823,390,6437
California,Dillon Beach,219,0,15,50,44,21,130
California,Banning,30942,4344,6303,6811,1985,1221,20664
California,Torrance,146392,6127,16813,29038,34848,18231,105057
California,La Mirada,48974,3415,7852,11311,6903,3258,32739
California,Coulterville,38,0,10,28,0,0,38
California,Avila Beach,1273,16,277,537,198,188,1216
California,Jurupa Valley,103784,18781,18230,18417,5246,2382,63056
California,East Whittier,10391,826,1963,2963,838,484,7074
California,Vincent,17008,2479,3597,3210,1074,494,10854
California,Temescal Valley,26709,1472,3849,6709,3368,1867,17265
California,Pleasure Point,6277,467,703,1427,1354,677,4628
California,Whitewater,976,148,151,195,22,93,609
California,Eastvale,61337,4022,7442,12162,8940,4164,36730
California,Contra Costa Centre,6497,314,335,868,2443,1328,5288
California,Valinda,25296,5092,5093,4362,1617,444,16608
California,Kennedy Meadows,20,0,0,20,0,0,20
California,June Lake,508,12,148,149,11,44,364
California,Junction City,688,22,246,206,87,25,586
California,Johnstonville,1185,21,166,438,62,64,751
California,Jenner,32,0,7,7,0,18,32
California,Janesville,1278,97,267,446,79,75,964
California,San Dimas,34239,1711,4301,9327,5762,3239,24340
California,Marina del Rey,9771,134,696,1774,3586,1987,8177
California,Littlerock,1766,422,239,146,133,0,940
California,Lawndale,33007,5997,5577,6621,2926,1035,22156
California,La Verne,32358,1788,4042,8386,5158,3182,22556
California,Kelly Ridge,2679,180,630,1031,232,58,2131
California,University of California-Davis,7379,0,0,159,232,381,772
California,Jacumba,202,60,0,123,0,0,183
California,Indianola,686,81,113,235,65,47,541
California,Graniteville,0,0,0,0,0,0,0
California,Grangeville,586,0,104,99,93,37,333
California,Goodyears Bar,29,0,20,9,0,0,29
California,Good Hope,9173,2578,1433,803,180,76,5070
California,Gold Mountain,0,0,0,0,0,0,0
California,Geyserville,928,160,159,206,88,46,659
California,Gerber,1259,381,227,310,64,39,1021
California,Gasquet,620,124,99,191,20,7,441
California,Garnet,5057,995,1124,655,195,214,3183
California,Garey,160,92,14,19,6,1,132
California,Greeley Hill,687,130,179,237,43,38,627
California,Garden Farms,345,0,78,38,125,39,280
California,Fulton,566,111,76,39,34,60,320
California,Fuller Acres,841,267,81,37,30,8,423
California,Fruitridge Pocket,6215,1567,1082,906,293,67,3915
California,French Valley,33818,1545,4155,8213,4447,1888,20248
California,Freeport,81,22,59,0,0,0,81
California,Franklin CDP (Sacramento County),117,15,22,51,0,6,94
California,Franklin CDP (Merced County),7314,1410,1284,1327,302,116,4439
California,Fort Washington,783,0,23,50,130,190,393
California,Fort Irwin,9086,83,807,1669,767,373,3699
California,Fort Bidwell,181,18,39,25,10,18,110
California,Garberville,1126,122,153,375,64,0,714
California,Indio Hills,708,216,115,95,13,0,439
California,Green Acres,2542,325,568,419,43,25,1380
California,Green Valley CDP (Los Angeles County),973,48,166,300,144,93,751
California,Idlewild,0,0,0,0,0,0,0
California,Hyampom,165,22,118,0,25,0,165
California,Hornitos,61,0,34,27,0,0,61
California,Hopland,921,95,161,184,91,5,536
California,Hood,303,26,94,77,8,0,205
California,Honcut,135,10,32,39,19,0,100
California,Homewood Canyon,35,0,26,9,0,0,35
California,Homestead Valley,2723,364,659,873,312,98,2306
California,Herlong,1353,332,500,321,29,24,1206
California,Herald,1058,74,193,340,132,68,807
California,Greenfield,3534,866,701,653,102,63,2385
California,Hat Creek,164,23,8,97,24,0,152
California,Hasley Canyon,1085,55,165,296,146,77,739
California,Hartley,2907,346,605,794,306,164,2215
California,Hartland,0,0,0,0,0,0,0
California,Hardwick,30,12,11,6,1,0,30
California,Happy Camp,810,122,221,202,56,28,629
California,Guinda,175,28,29,54,0,0,111
California,Groveland,307,17,147,86,47,10,307
California,Grizzly Flats,1087,49,98,471,129,66,813
California,Grimes,358,69,39,58,0,0,166
California,Green Valley CDP (Solano County),1572,28,256,472,449,242,1447
California,Hiouchi,433,17,114,157,17,17,322
California,Forbestown,221,17,94,39,20,51,221
California,University of California-Merced,0,0,0,0,0,0,0
California,Fort Dick,830,19,281,214,127,146,787
California,Lompoc,43511,5911,7480,10369,2342,1126,27228
California,Twentynine Palms,26109,1176,3177,5397,1800,755,12305
California,San Antonio Heights,3034,109,626,755,687,348,2525
California,Mountain View Acres,4260,716,757,752,177,68,2470
California,Montclair,38865,6634,6409,7131,2790,992,23956
California,Lenwood,3884,606,426,693,155,31,1911
California,Arbuckle,3636,935,439,564,154,41,2133
California,Tulare,62838,9214,10600,11702,2859,1097,35472
California,Terra Bella,3304,1071,378,435,54,0,1938
California,Pixley,3796,1269,313,187,10,0,1779
California,Solvang,5734,175,810,1457,1122,559,4123
California,Lindsay,13232,3904,1769,1419,224,66,7382
California,Earlimart,8790,2971,1157,573,74,11,4786
California,Watsonville,53616,12451,7792,7076,2441,1076,30836
California,Valley Springs,3428,132,655,1552,244,156,2739
California,Avery,559,0,117,172,62,61,412
California,Walnut Grove,1300,155,305,335,107,26,928
California,Sacramento,495011,50723,69596,103716,68421,39758,332214
California,Folsom,77007,4049,7428,15311,15892,10958,53638
California,American Canyon,20306,2064,2268,4829,2927,865,12953
California,Woodlake,7636,1759,1053,1105,231,128,4276
California,Traver,740,222,140,64,2,0,428
California,East Orosi,955,214,99,41,0,0,354
California,Lemon Cove,267,0,63,82,54,18,217
California,Vandenberg Village,7861,351,1045,1977,1121,879,5373
California,North Highlands,48968,5090,9869,11163,2721,1055,29898
California,Ladera,1465,15,0,69,360,549,993
California,Kenwood,800,0,124,120,213,169,626
California,La Cañada Flintridge,20374,307,893,2528,5062,5095,13885
California,Malaga,1337,440,96,143,31,7,717
California,Angels,3811,216,506,1384,473,280,2859
California,Orosi,7441,1758,913,1357,273,0,4301
California,North Tustin,24736,759,1888,4825,6211,4369,18052
California,Wildomar,36162,3475,7021,9018,2702,1328,23544
California,Menifee,88515,7893,15955,24211,7155,4218,59432
California,Rancho Cordova,72056,5431,12155,18184,9221,3427,48418
California,Foothill Farms,33749,2888,7422,7857,2584,966,21717
California,Moraga,17398,78,696,2062,4179,3896,10911
California,Goleta,30790,2182,3199,5751,5410,4134,20676
California,Elk Grove,168503,10174,18849,40048,27849,11781,108701
California,Aliso Viejo,50925,1403,3760,10063,12202,6775,34203
California,East Oakdale,3344,85,628,925,515,358,2511
California,Soquel,10862,514,1221,2648,1877,1126,7386
California,Rancho Palos Verdes,42271,820,2554,6617,10827,10014,30832
California,Malibu,12846,245,1081,2419,3717,2669,10131
California,Lakewood,80771,5525,12155,21552,11736,5026,55994
California,La Habra Heights,5383,261,544,1134,1228,825,3992
California,La Crescenta-Montrose,19500,922,2024,3822,4474,2649,13891
California,Yountville,2982,135,535,827,853,381,2731
California,Fairhaven,145,21,30,20,17,18,106
California,Dinuba,23871,4994,3890,3050,706,290,12930
California,Three Rivers,2397,59,313,671,488,445,1976
California,Bonita,13324,995,1999,3047,2037,1638,9716
California,Santa Clara,126209,6669,11326,17705,26222,24037,85959
California,San Francisco,870044,79408,84630,131509,236593,157411,689551
California,San Martin,7010,1041,1109,1564,800,410,4924
California,San Jose,1026658,110795,119374,171182,177902,121477,700730
California,Raisin City,389,143,22,39,16,0,220
California,Kerman,14649,3562,2396,1806,454,131,8349
California,Easton,2206,402,402,447,131,51,1433
California,Newark,46276,3300,9866,8790,7016,3650,32622
California,Los Alamitos,11628,758,1269,2338,2462,1302,8129
California,Harbison Canyon,4223,335,814,1114,374,289,2926
California,Irvine,265502,6250,13657,34021,66143,51344,171415
California,Avenal,12923,4101,1825,1566,142,78,7712
California,Fountain Valley,56372,3799,6174,13112,11647,5692,40424
California,Temelec,1564,23,250,608,467,216,1564
California,Santa Rosa,181038,18108,23774,43840,25477,15153,126352
California,Boyes Hot Springs,7863,1066,767,1546,834,621,4834
California,Bodega Bay,733,13,25,175,179,239,631
California,Westside,182,78,11,20,0,0,109
California,Pala,1143,162,198,202,27,23,612
California,Little Valley,18,10,8,0,0,0,18
California,Hoopa,3573,244,615,813,346,37,2055
California,Kettleman City,1395,584,127,86,0,0,797
California,West Modesto,5911,1378,1089,745,109,62,3383
California,Julian,930,87,127,422,129,99,864
California,Ramona,20260,1835,4028,4810,2077,1043,13793
California,Empire,3667,1053,784,577,104,33,2551
California,Day Valley,3439,71,338,756,934,559,2658
California,Loomis,6753,182,1054,2087,1108,308,4739
California,Granite Bay,22439,475,1813,4894,5228,3488,15898
California,Del Rio,1235,26,64,272,251,285,898
California,Foresthill,1546,151,311,496,160,16,1134
California,Keyes,6185,1092,1193,1036,202,58,3581
California,Grayson,1224,320,172,99,13,0,604
California,Rocklin,63127,1601,5962,14927,11766,5954,40210
California,Bermuda Dunes,6817,375,1568,1479,795,473,4690
California,Pine Valley,1669,59,281,426,283,135,1184
California,Beaumont,45403,3447,7567,10561,4789,2514,28878
California,Hayfork,2421,139,847,552,172,129,1839
California,Bootjack,768,57,217,195,42,32,543
California,Stinson Beach,556,0,46,156,188,138,528
California,Sausalito,7139,21,402,1418,2050,2527,6418
California,Santa Venetia,4790,119,717,922,1256,536,3550
California,San Rafael,58939,6072,5289,9312,12169,8801,41643
California,Kentfield,6930,53,222,690,1862,1903,4730
California,El Verano,3424,265,670,876,618,257,2686
California,Winter Gardens,23088,1635,5955,5788,1996,848,16222
California,Vista,100108,12732,15880,20042,10031,4552,63237
California,Lewiston,1340,105,399,367,147,11,1029
California,Simi Valley,126199,7314,19006,31908,19441,9693,87362
California,Greenacres,5757,324,1301,1308,399,149,3481
California,Casa Conejo,3366,150,587,864,411,238,2250
California,Blue Lake,981,41,143,300,190,105,779
California,Hydesville,978,29,190,397,102,47,765
California,Piru,2019,379,348,377,90,49,1243
California,Oak View,4720,550,704,961,726,348,3289
California,Meiners Oaks,3508,454,353,832,645,329,2613
California,Weldon,2181,338,564,567,140,127,1736
California,Tupman,186,39,33,25,8,5,110
California,Ridgecrest,28736,1996,4326,6987,3771,1574,18654
California,Maricopa,1175,209,278,181,27,0,695
California,Fellows,49,1,19,13,1,0,34
California,North Edwards,944,77,289,282,19,26,693
California,East Sonora,2189,205,543,633,306,214,1901
California,Cutten,3029,52,542,682,639,316,2231
California,Rail Road Flat,283,21,121,113,11,2,268
California,Parkwood,1853,398,187,394,116,15,1110
California,Madera Acres,9946,1605,1749,1819,645,164,5982
California,Keddie,41,0,0,8,11,12,31
California,Johnsville,0,0,0,0,0,0,0
California,East Quincy,2622,107,682,1008,99,64,1960
California,Mono Vista,3504,209,653,1301,384,106,2653
California,Upland,76382,5376,10926,18830,10198,6223,51553
California,Rancho Cucamonga,175679,10230,23525,43158,24194,15426,116533
California,Fontana,208943,31017,35218,36200,15783,5307,123525
California,Chino Hills,79298,3445,8954,16336,16370,8148,53253
California,Big Bear City,13312,805,2955,3967,1144,493,9364
California,Hamilton City,2224,551,318,275,111,0,1255
California,Mokelumne Hill,637,53,54,251,43,51,452
California,Rosemont,23617,1471,3562,6605,3068,987,15693
California,Ferndale,1365,31,224,401,198,159,1013
California,Clyde,676,7,138,267,93,15,520
California,St. Helena,6079,556,774,943,1442,793,4508
California,Napa,79516,9121,10068,17270,11966,6083,54508
California,Murphys,2100,145,419,774,343,159,1840
California,Copperopolis,4299,299,1051,1349,459,211,3369
California,West Whittier-Los Nietos,27144,4878,6122,4758,1925,781,18464
California,West Carson,22537,2673,3705,4919,4588,1319,17204
California,Walnut,30008,1723,3042,5634,8420,3244,22063
California,Val Verde,2996,391,459,735,191,92,1868
California,South San Jose Hills,20593,5258,3711,2909,823,467,13168
California,Pomona,152494,28818,22418,24622,11949,4405,92212
California,Pasadena,141246,12273,14728,23235,28150,24602,102988
California,Long Beach,468883,61807,57189,97448,61321,34022,311787
California,Antioch,110730,9417,19539,27704,10529,4493,71682
California,Lomita,20628,1908,3669,4281,3413,1635,14906
California,El Segundo,16850,443,1506,3644,3920,2335,11848
California,Rancho Murieta,5603,124,362,1672,1286,943,4387
California,Lakeport,4855,493,847,1562,634,178,3714
California,Stockton,306283,44577,52724,58105,22828,10584,188818
California,Morada,4068,297,342,806,504,741,2690
California,Lockeford,3390,481,571,796,216,79,2143
California,South Lake Tahoe,21814,2015,3564,6311,2931,1209,16030
California,Shingle Springs,3865,107,606,1410,607,361,3091
California,Lake Isabella,3454,291,1089,1030,248,31,2689
California,Orinda,19431,234,384,1735,5562,5984,13899
California,Knightsen,1500,134,240,435,252,17,1078
California,Kensington,5415,35,173,327,1487,2137,4159
California,Irwindale,1405,235,255,301,68,25,884
California,Mission Hills,3796,366,532,987,446,344,2675
California,Isla Vista,27690,306,453,445,769,1280,3253
California,Yucaipa,53264,4116,9755,13304,4824,3297,35296
California,Washington,53,0,11,27,15,0,53
California,Warner Valley,0,0,0,0,0,0,0
California,Warm Springs,1903,422,604,314,33,0,1373
California,Walker,863,129,229,241,45,61,705
California,Volta,216,30,53,48,0,0,131
California,Volcano,44,0,0,44,0,0,44
California,Vista Santa Rosa,2967,753,730,298,106,40,1927
California,Vina,210,18,42,39,20,83,202
California,Victor,444,146,10,77,0,0,233
California,Verdi,187,0,14,106,15,12,147
California,Valley Wells,0,0,0,0,0,0,0
California,Valley Home,202,37,67,57,10,9,180
California,Waterloo,719,112,128,170,72,38,520
California,Valley Ford,148,43,35,0,0,0,78
California,Tuttle,63,10,31,22,0,0,63
California,Trowbridge,296,6,60,112,11,2,191
California,Trona,37,0,22,0,0,0,22
California,Trinity Village,279,19,112,93,30,7,261
California,Trinity Center,161,13,91,37,0,0,141
California,Tres Pinos,662,43,102,183,76,47,451
California,Topaz,234,64,0,9,0,0,73
California,Topanga,7449,110,438,1212,1979,1962,5701
California,Tooleville,309,183,9,12,0,0,204
California,Tonyville,881,334,61,57,0,0,452
California,Timber Cove,149,3,44,31,26,36,140
California,Three Rocks,210,151,39,0,0,0,190
California,Tuttletown,941,92,185,343,61,66,747
California,Waukena,215,3,49,50,1,1,104
California,Wawona,196,0,13,93,17,0,123
California,West Rancho Dominguez,22932,4617,4092,4829,1002,478,15018
California,Lake Arrowhead,9765,820,1373,2551,1096,1116,6956
California,Hesperia,93609,12086,18640,18104,3595,1825,54250
California,Grand Terrace,12482,863,2767,2933,1256,1080,8899
California,Crestline,9381,400,1677,3043,951,618,6689
California,Mountain Ranch,1306,33,338,559,214,33,1177
California,Shasta Lake,10142,747,1986,3186,812,253,6984
California,Montgomery Creek,61,3,11,30,10,0,54
California,Clear Creek,226,12,33,48,11,5,109
California,Clay,1083,103,137,328,143,89,800
California,Clarksburg,442,6,53,216,24,14,313
California,Cherokee Strip,191,82,49,0,0,0,131
California,Cherokee,139,8,50,48,7,0,113
California,Chalfant,999,93,207,169,151,17,637
California,Centerville,366,32,61,132,11,12,248
California,Cedarville,360,33,92,76,43,17,261
California,Cedar Slope,0,0,0,0,0,0,0
California,Zayante,939,10,86,381,140,51,668
California,Yolo,429,102,54,75,9,18,258
California,Yettem,441,112,56,0,0,0,168
California,Yankee Hill,301,37,50,113,37,47,284
California,Woodlands,1743,0,187,433,474,412,1506
California,Woodbridge,3865,426,625,838,508,446,2843
California,Wilsonia,0,0,0,0,0,0,0
California,Whitley Gardens,164,16,14,57,17,0,104
California,West Park,1035,269,225,155,39,9,697
California,West Goshen,567,89,73,118,6,0,286
California,Weott,271,0,64,27,51,11,153
California,Colton,54415,8168,9702,9794,3699,1732,33095
California,Cedar Ridge,1037,45,234,366,115,69,829
California,Loma Linda,24078,1805,3164,4261,4287,3792,17309
California,Muscoy,13726,3630,2094,969,323,77,7093
California,Mill Valley,14343,112,566,1736,4283,3813,10510
California,Tara Hills,5405,651,1139,1419,433,187,3829
California,Deer Park,906,33,89,275,182,148,727
California,Winters,7132,843,879,1780,607,502,4611
California,Canyon Lake,11106,437,2351,3044,1272,995,8099
California,Clearlake Oaks,2279,249,610,686,286,81,1912
California,French Camp,3857,1212,940,450,133,25,2760
California,Mammoth Lakes,8091,681,982,2078,1407,338,5486
California,Woodcrest,17310,1172,2918,4521,1736,1415,11762
California,Corona,165355,15691,26350,35696,19596,9470,106803
California,Cabazon,3367,607,695,696,151,0,2149
California,Bakersfield,375699,43834,57979,73090,31962,16822,223687
California,Le Grand,1726,461,237,313,68,12,1091
California,Fair Oaks,31002,1290,2909,8275,6721,3968,23163
California,Ladera Heights,7090,138,414,1713,1294,1621,5180
California,Isleton,583,71,164,193,19,12,459
California,Eureka,27020,2545,4557,7034,3472,1547,19155
California,Boron,2312,230,568,525,173,23,1519
California,South Taft,1526,388,317,201,49,19,974
California,San Mateo,104035,7532,10398,16938,23032,16836,74736
California,El Granada,5819,93,613,1092,1590,890,4278
California,Lathrop,21393,2857,3588,4507,1763,635,13350
California,Rancho Mirage,18075,772,2841,5647,4053,3265,16578
California,Yosemite Lakes,5647,220,944,1730,636,441,3971
California,San Anselmo,12567,172,448,1806,3985,2610,9021
California,Montara,2692,0,462,532,661,343,1998
California,Westmont,33723,6290,6083,6050,1222,457,20102
California,Beckwourth,214,0,0,113,0,54,167
California,Brentwood,60446,2782,7886,16081,8908,3643,39300
California,Roseville,133049,4515,15047,33906,25639,11212,90319
California,Barstow,23812,2825,4308,4990,976,575,13674
California,Apple Valley,72359,6685,14174,17862,4872,3045,46638
California,Rancho Calaveras,7035,519,1723,2253,288,183,4966
California,Suisun City,29379,2187,4610,8841,3109,912,19659
California,Seaside,34077,4304,5310,7069,3333,1647,21663
California,San Ardo,554,163,87,28,21,6,305
California,Pacific Grove,15567,446,1599,3525,3226,2987,11783
California,Greenfield,17276,4882,2369,1606,306,102,9265
California,Concow,743,18,127,329,72,37,583
California,Valley Center,9059,738,1443,2336,1256,659,6432
California,Poway,49842,2786,5213,9704,10350,5875,33928
California,Imperial Beach,27290,2897,4470,6857,2238,1065,17527
California,Pleasant Hill,34785,778,2534,7909,9447,4548,25216
California,Fairbanks Ranch,2901,95,150,492,701,291,1729
California,Running Springs,4296,162,667,1493,377,324,3023
California,Orland,7541,1284,1313,1382,313,120,4412
California,San Bernardino,215182,39015,35114,35198,10163,4378,123868
California,Vallecito,183,0,26,88,22,40,176
California,El Rio,6505,1513,1092,900,269,82,3856
California,Fillmore,15598,2762,2188,3299,872,450,9571
California,Salton Sea Beach,355,102,87,30,13,0,232
California,Chino,87735,13623,14365,20702,9036,3969,61695
California,East Richmond Heights,3214,91,429,823,829,565,2737
California,Sunnyside-Tahoe City,1222,29,112,235,454,84,914
California,Loyalton,1149,72,263,409,31,15,790
California,Williams,5223,1359,829,694,259,101,3242
California,Delleker,514,28,100,93,37,48,306
California,Carpinteria,13550,1687,1785,2998,1954,1239,9663
California,Mi-Wuk Village,1133,36,205,713,25,0,979
California,Rowland Heights,50602,5117,8173,9052,10999,3485,36826
California,Arvin,21005,6659,1999,1600,154,85,10497
California,San Jacinto,47474,7020,8144,9761,2378,1079,28382
California,Arnold,2605,166,649,799,505,150,2269
California,La Riviera,10851,473,1410,3120,1772,744,7519
California,Galt,25675,2926,4802,5786,1935,721,16170
California,Dorrington,205,28,41,84,36,12,201
California,Porterville,59797,11058,9585,9629,2391,1336,33999
California,Riverdale Park,1301,261,312,144,78,22,817
California,Newman,11119,1649,2128,2387,601,82,6847
California,Escondido,151115,21436,22219,31104,15446,7623,97828
California,Encinitas,62713,2173,4184,11710,16118,12150,46335
California,Coronado,23620,368,1369,4057,5034,4971,15799
California,California City,13646,1962,2927,3152,614,366,9021
California,Camp Pendleton South,11459,0,1691,1935,701,309,4636
California,Monterey,28512,1428,2191,5925,5720,4771,20035
California,Chualar,1442,453,179,80,34,0,746
California,Mount Shasta,3284,148,272,1183,421,405,2429
California,Mount Hebron,78,15,0,15,0,26,56
California,Carmel Valley Village,4293,259,369,1046,933,670,3277
California,Lake San Marcos,4890,222,523,1543,1045,674,4007
California,Bucks Lake,15,0,8,0,7,0,15
California,Belden,0,0,0,0,0,0,0
California,Shoshone,13,0,0,3,5,5,13
California,Dixon Lane-Meadow Creek,2760,218,651,719,328,138,2054
California,Vandenberg AFB,3379,45,62,703,349,191,1350
California,Summerland,923,27,96,150,549,101,923
California,Soledad,25597,7333,4780,4131,877,342,17463
California,Derby Acres,380,77,57,90,11,5,240
California,Yreka,7551,597,1216,2355,633,314,5115
California,El Paso de Robles (Paso Robles),31656,3370,4646,8226,3641,1443,21326
California,Lancaster,159662,17668,29315,35410,10062,5876,98331
California,Hidden Valley Lake,6044,331,1012,1826,531,395,4095
California,Willowbrook,22402,5855,3467,1996,586,154,12058
California,Parlier,15120,4460,2150,1461,265,84,8420
California,Lemoore Station,7063,77,571,1488,569,167,2872
California,Sebastopol,7666,249,847,2173,1514,1032,5815
California,Cantua Creek,273,116,40,6,0,0,162
California,Ridgemark,3062,74,516,900,545,233,2268
California,Escalon,7509,441,1618,1985,578,243,4865
California,August,8774,2067,1522,844,76,0,4509
California,Shingletown,2272,237,548,821,132,121,1859
California,Cottonwood,3289,214,589,1045,209,27,2084
California,Montague,1517,98,286,580,99,0,1063
California,McCloud,1072,56,294,373,80,23,826
California,Georgetown,2668,171,411,1115,146,49,1892
California,Granite Hills,2833,138,471,961,481,334,2385
California,Fallbrook,33021,4232,4557,7122,3636,1684,21231
California,Spreckels,385,0,23,129,59,38,249
California,San Lucas,472,71,115,75,4,0,265
California,Del Monte Forest,4197,75,316,778,1113,942,3224
California,Carmel-by-the-Sea,3855,90,354,674,1255,957,3330
California,Lexington Hills,2603,28,261,376,678,535,1878
California,East Foothills,6278,376,778,1370,1209,786,4519
California,Sutter,2994,222,585,799,211,84,1901
California,Live Oak,8622,1630,1197,1578,365,173,4943
California,Etna,735,51,156,218,62,12,499
California,Lake Nacimiento,2884,142,575,848,236,163,1964
California,Mentone,9847,647,1702,2577,1040,658,6624
California,Big River,1145,164,314,302,89,12,881
California,Cazadero,288,0,63,118,29,17,227
California,Castle Hill,1145,0,16,206,386,215,823
California,Monterey Park,60792,10072,10945,10716,10487,4329,46549
California,La Puente,40268,9825,7667,5307,2324,532,25655
California,Hawaiian Gardens,14411,3350,2448,2002,678,287,8765
California,Ceres,47975,7984,8704,8459,2047,577,27771
California,Santa Cruz,64273,2258,4582,10082,10050,8663,35635
California,Biola,1451,367,167,130,30,18,712
California,Taft Heights,2424,240,336,514,46,23,1159
California,California Pines,488,52,164,82,44,9,351
California,California Hot Springs,36,1,9,9,4,10,33
California,Butte Valley,510,35,66,226,68,13,408
California,Butte Meadows,53,0,0,53,0,0,53
California,Butte Creek Canyon,931,7,101,222,341,131,802
California,Paramount,54776,11842,8682,8089,2435,1212,32260
California,Burnt Ranch,338,20,123,67,61,28,299
California,Buck Meadows,51,0,34,0,0,0,34
California,Buckhorn,2246,173,605,786,211,122,1897
California,Brooktrails,3709,152,527,963,348,241,2231
California,Brookdale,2345,57,397,506,453,327,1740
California,Bridgeport,464,70,101,140,96,0,407
California,Boulevard,445,58,142,133,57,0,390
California,Boonville,852,190,189,140,38,46,603
California,Bonny Doon,3009,61,330,784,629,478,2282
California,Bodega,473,46,36,130,141,78,431
California,Bloomfield,387,0,71,31,132,98,332
California,Blacklake,892,0,67,329,240,219,855
California,Blackhawk,9860,55,559,1471,2929,2052,7066
California,Buena Vista,526,0,89,243,17,14,363
California,Big Lagoon,118,0,4,29,15,58,106
California,San Fernando,24585,5843,4745,3554,1342,355,15839
California,South El Monte,20727,6025,3831,2224,991,339,13410
California,Squirrel Mountain Valley,1159,107,231,343,173,16,870
California,McKittrick,127,29,36,40,2,0,107
California,Frazier Park,2570,199,679,714,186,100,1878
California,Edwards AFB,2571,7,116,525,267,301,1216
California,South San Francisco,67294,7158,10189,14684,12929,4107,49067
California,San Carlos,30080,601,1788,4285,7447,7141,21262
California,Burlingame,30459,1060,2247,4330,8075,6322,22034
California,Inyokern,740,0,262,173,160,31,626
California,Tahoe Vista,1288,107,213,198,266,155,939
California,French Gulch,441,42,123,135,32,23,355
California,Fall River Mills,273,15,43,131,27,7,223
California,Moss Beach,3799,198,554,486,780,413,2431
California,Santa Monica,92078,3759,5990,13734,28076,20834,72393
California,Santa Barbara,91325,8494,8696,15443,18240,13168,64041
California,Buellton,5092,486,759,1318,620,608,3791
California,Santa Maria,105483,24052,11692,15757,5496,2486,59483
California,Wheatland,3747,352,594,1155,179,192,2472
California,Linda,19314,2710,2605,4610,1178,250,11353
California,Challenge-Brownsville,864,31,147,393,64,39,674
California,Yorba Linda,67815,2132,6091,13735,15858,9286,47102
California,Laguna Niguel,65652,2243,6111,13914,15548,9838,47654
California,Garden Grove,174010,30589,29280,33942,18736,6278,118825
California,West Hollywood,36384,906,3486,8006,14588,6030,33016
California,West Covina,107242,10927,19397,21842,15436,5686,73288
California,South Pasadena,25824,699,1762,3992,6020,5870,18343
California,South Gate,95103,25479,14648,12302,3887,1491,57807
California,Guadalupe,7350,1785,870,1094,252,64,4065
California,Big Creek,188,2,22,35,25,6,90
California,Bieber,178,20,44,58,0,0,122
California,Berry Creek,1241,124,395,431,62,32,1044
California,Richfield,272,8,46,61,22,20,157
California,Reliez Valley,3575,94,218,557,1247,730,2846
California,Redwood Valley,1376,66,304,424,173,78,1045
California,Redcrest,23,0,13,10,0,0,23
California,Red Corral,1930,122,511,612,196,43,1484
California,Rackerby,189,3,41,78,7,6,135
California,Proberta,165,12,71,41,0,0,124
California,Princeton,297,49,101,63,22,0,235
California,Potter Valley,437,28,96,204,36,21,385
California,Potrero,625,55,61,29,73,39,257
California,Poso Park,2,0,0,2,0,0,2
California,Posey,0,0,0,0,0,0,0
California,Richvale,99,0,0,45,54,0,99
California,Ponderosa,0,0,0,0,0,0,0
California,Marysville,12282,1431,1871,3326,780,343,7751
California,Westminster,91417,14602,14764,19529,12378,4674,65947
California,East San Gabriel,15932,1417,2281,2672,3301,1699,11370
California,Diamond Bar,56434,2507,6027,10403,14216,7273,40426
California,Compton,97301,21861,16039,14557,3425,1170,57052
California,Carson,92517,12672,13992,20267,12416,4603,63950
California,Bell,35809,10722,5201,4187,1416,135,21661
California,Arcadia,58207,3309,6474,9823,14115,8122,41843
California,Acton,7185,347,1197,2283,1076,447,5350
California,Woodland,59044,7433,9809,11555,6084,3991,38872
California,Avalon,3763,259,772,999,290,276,2596
California,Moorpark,36274,2524,3447,7951,6589,3634,24145
California,Plumas Lake,7367,415,809,2147,590,335,4296
California,Rio Oso,406,43,73,71,46,29,262
California,Smith River,632,19,92,164,35,0,310
California,Snelling,101,10,20,29,2,8,69
California,Thornton,1038,233,214,103,33,11,594
California,Thermal,1359,498,225,112,1,0,836
California,Teviston,1027,377,136,56,0,18,587
California,Terminous,411,34,168,147,0,29,378
California,Tahoma,867,15,92,207,237,58,609
California,Swall Meadows,218,0,19,83,47,65,214
California,Sun Village,13516,3075,2229,2372,407,60,8143
California,Tarpey Village,3390,189,889,861,234,119,2292
California,Sunny Slopes,80,0,0,7,73,0,80
California,Sunnyside,4451,376,544,880,556,478,2834
California,Sultana,1030,247,155,69,2,3,476
California,Sugarloaf Village,10,4,4,1,0,1,10
California,Sugarloaf Saw Mill,0,0,0,0,0,0,0
California,Sugarloaf Mountain Park,0,0,0,0,0,0,0
California,Strawberry CDP (Tuolumne County),5,1,2,2,0,0,5
California,Strawberry CDP (Marin County),5759,64,335,730,1608,1240,3977
California,Stonyford,136,58,25,21,21,0,125
California,Stirling City,307,55,38,29,9,9,140
California,Stevinson,331,97,89,60,11,0,257
California,Stevenson Ranch,19364,545,1583,3918,3931,2532,12509
California,Spring Valley Lake,7744,291,1167,2414,909,602,5383
California,Spring Valley CDP (San Diego County),31591,2489,4686,8111,3685,1704,20675
California,Spring Valley CDP (Lake County),1081,62,248,351,43,39,743
California,Spaulding,110,0,93,17,0,0,110
California,South Monrovia Island,7192,1414,1355,1046,610,184,4609
California,Soda Springs,21,0,0,0,21,0,21
California,Soda Bay,941,47,338,292,144,23,844
California,Weedpatch,2238,863,268,111,0,0,1242
California,Catheys Valley,794,38,87,288,119,102,634
California,Mira Monte,6912,436,963,2493,916,767,5575
California,Black Point-Green Point,1655,50,186,291,436,331,1294
California,Benton,313,7,62,174,32,17,292
California,Bend,457,63,182,111,46,8,410
California,Benbow,161,0,26,41,35,10,112
California,Bell Canyon,2391,44,155,307,586,504,1596
California,Bella Vista,2614,152,400,979,177,156,1864
California,Bear Valley CDP (Mariposa County),203,0,18,76,0,17,111
California,Bear Valley CDP (Alpine County),58,0,5,9,14,15,43
California,Bear Creek,157,57,37,37,0,0,131
California,Bayview CDP (Humboldt County),2617,290,419,901,231,125,1966
California,Bayview CDP (Contra Costa County),1954,183,387,488,210,42,1310
California,Bass Lake,500,0,95,160,77,81,413
California,Bangor,372,66,49,167,12,51,345
California,Sheridan,1250,274,291,195,82,18,860
California,Ballico,401,69,85,109,16,2,281
California,Baker,607,88,159,67,4,0,318
California,Auburn Lake Trails,3499,27,488,1248,373,478,2614
California,Aspen Springs,67,0,0,22,18,0,40
California,Artois,292,47,56,74,11,0,188
California,Anza,3151,289,623,854,317,99,2182
California,Antelope,47326,2468,8597,11810,5179,1681,29735
California,Anchor Bay,314,19,69,122,96,8,314
California,Alto,765,16,28,125,250,218,637
California,Alta,485,15,81,177,70,51,394
California,Allensworth,527,183,43,47,0,0,273
California,Allendale,1362,43,238,504,189,104,1078
California,Alleghany,30,0,0,30,0,0,30
California,Ballard,473,51,57,174,49,38,369
California,Alhambra Valley,739,8,97,127,181,94,507
California,Sierra Brooks,299,7,33,142,29,9,220
California,Sierra Village,330,0,0,184,104,0,288
California,Castaic,18921,921,2162,4770,3062,1195,12110
California,Cassel,176,0,62,93,0,21,176
California,Caspar,812,40,103,149,224,95,611
California,Casmalia,111,30,10,51,0,0,91
California,Carnelian Bay,463,11,60,123,141,22,357
California,Carmet,0,0,0,0,0,0,0
California,Canby,497,136,0,62,0,156,354
California,Camptonville,162,14,20,60,18,14,126
California,Campo,3482,571,522,494,186,182,1955
California,Camp Nelson,0,0,0,0,0,0,0
California,Camino Tassajara,3798,204,179,270,809,795,2257
California,Camino,1799,69,266,553,354,122,1364
California,Sierra City,152,0,37,32,28,55,152
California,Camanche Village,620,77,253,119,21,12,482
California,Calpine,216,0,39,73,28,20,160
California,Calpella,562,106,175,82,91,9,463
California,Callender,1583,53,131,537,199,102,1022
California,Smith Corner,664,218,90,18,0,0,326
California,Smartsville,163,18,42,20,0,1,81
California,Sky Valley,2430,225,591,765,211,127,1919
California,Sisquoc,148,24,39,35,6,0,104
California,Silver Lakes,5966,231,785,1868,764,492,4140
California,Sleepy Hollow,2200,136,57,275,549,469,1486
California,Silver City,0,0,0,0,0,0,0
California,Silverado Resort,937,23,26,221,275,244,789
California,Sierraville,103,0,14,23,28,36,101
California,Camanche North Shore,1029,153,225,285,32,9,704
California,Alderpoint,157,9,76,72,0,0,157
California,Albion,302,2,69,44,3,39,157
California,Airport,1222,300,241,207,27,0,775
California,Rose Hills,2612,145,297,681,655,248,2026
California,Rolling Hills,896,9,119,265,129,134,656
California,Rodriguez Camp,87,59,0,0,0,0,59
California,Robinson Mill,35,0,19,16,0,0,35
California,Robbins,321,65,65,90,12,2,234
California,River Pines,607,115,114,227,0,13,469
California,Ripley,408,161,91,8,0,0,260
California,Buttonwillow,1591,299,343,108,32,0,782
California,Woodside,5541,82,192,484,1340,1788,3886
California,Blythe,19581,3587,3887,4739,688,439,13340
California,Emerald Lake Hills,4594,16,315,615,1077,1348,3371
California,Colma,1450,101,274,358,218,50,1001
California,Rough and Ready,828,65,121,324,50,31,591
California,Broadmoor,5286,365,729,1518,1093,277,3982
California,Planada,4418,1401,432,608,157,16,2614
California,Tobin,0,0,0,0,0,0,0
California,Taylorsville,244,0,35,79,0,32,146
California,Lake Almanor Peninsula,416,3,72,172,71,41,359
California,Greenville,1108,111,318,399,24,27,879
California,Penn Valley,1424,27,263,450,180,22,942
California,Grass Valley,12932,953,2220,4090,1389,874,9526
California,Woodacre,1303,91,147,336,329,315,1218
California,Tamalpais-Homestead Valley,11261,134,500,1285,3062,3126,8107
California,San Geronimo,466,15,63,46,177,54,355
California,Ross,2309,85,27,212,680,622,1626
California,Lucas Valley-Marinwood,6841,230,389,1178,1709,1367,4873
California,Winton,11761,2963,1761,1192,346,46,6308
California,Rouse,2420,580,344,216,18,25,1183
California,Ruth,145,4,50,81,0,0,135
California,Rutherford,72,16,7,6,28,5,62
California,Ahwahnee,2461,19,589,795,456,115,1974
California,Agua Dulce,3728,244,661,1143,475,215,2738
California,Adin,201,0,65,30,19,17,131
California,Acampo,294,0,52,156,19,31,258
California,Acalanes Ridge,889,0,15,159,233,119,526
California,Shelter Cove,501,38,187,96,129,51,501
California,Shell Ridge,1281,0,83,173,306,421,983
California,Shasta,1804,58,327,595,195,158,1333
California,Seville,691,171,64,42,5,2,284
California,Sereno del Mar,82,0,10,19,43,10,82
California,Sequoia Crest,28,0,28,0,0,0,28
California,Sea Ranch,1161,73,41,218,355,351,1038
California,Seacliff,3201,67,366,926,661,398,2418
California,Scotia,602,13,154,156,4,1,328
California,Saticoy,1201,297,238,126,12,23,696
California,Saranap,6492,13,432,961,2013,1138,4557
California,Santa Susana,1050,10,186,412,164,13,785
California,Sattley,77,30,9,38,0,0,77
California,Santa Rosa Valley,3180,35,245,706,837,528,2351
California,Santa Nella,2508,456,417,244,127,22,1266
California,Santa Margarita,1252,44,253,304,187,107,895
California,San Simeon,583,71,105,135,29,19,359
California,San Pasqual,1932,93,139,209,491,637,1569
California,San Miguel CDP (San Luis Obispo County),2807,458,365,611,209,20,1663
California,San Miguel CDP (Contra Costa County),2993,22,218,448,878,621,2187
California,Samoa,284,38,51,61,38,6,194
California,Salmon Creek,20,0,0,0,0,20,20
California,Oxnard,207568,39844,29447,36708,15734,6210,127943
California,Golden Hills,9407,507,1853,2456,717,418,5951
California,Aguanga,835,60,249,249,70,29,657
California,Mohawk Vista,63,0,24,24,0,0,48
California,Crescent Mills,287,14,61,94,15,26,210
California,La Porte,0,0,0,0,0,0,0
California,Little Grass Valley,0,0,0,0,0,0,0
California,Chinese Camp,206,51,15,47,0,0,113
California,Sonora,4822,360,1152,1199,444,312,3467
California,Twain Harte,2523,69,597,836,358,156,2016
California,Redway,1199,207,191,244,77,162,881
California,Rio Dell,3382,331,780,850,205,21,2187
California,Moss Landing,61,0,41,20,0,0,61
California,Canyondam,66,21,20,25,0,0,66
California,Belvedere,2098,0,56,157,671,661,1545
California,West Puente Valley,23629,5290,5078,3890,1524,400,16182
California,Colusa,5902,936,703,1299,448,156,3542
California,Forest Meadows,1516,157,96,343,394,52,1042
California,El Cerrito,5471,868,861,1075,623,265,3692
California,Idyllwild-Pine Cove,2459,108,446,645,438,338,1975
California,Winterhaven,210,106,104,0,0,0,210
California,Chowchilla,18533,3659,3392,4617,735,285,12688
California,Parksdale,2493,613,412,365,29,12,1431
California,Cathedral City,54037,8209,10569,10282,4606,2560,36226
California,Fairfax,7591,165,604,1460,2045,1545,5819
California,Highgrove,4986,764,810,847,325,156,2902
California,Lennox,21329,6286,3217,2241,822,164,12730
California,Industry,344,30,59,53,49,2,193
California,La Habra,61910,7033,9625,13204,7631,3622,41115
California,Seal Beach,24364,1041,2485,6821,6202,3804,20353
California,Villa Park,5912,280,538,1244,1257,1064,4383
California,Meadow Vista,3460,165,529,1046,602,290,2632
California,Hayward,158241,19341,29630,29532,21090,8016,107609
California,Livermore,89027,4506,10629,21033,16291,9678,62137
California,Lemon Grove,26767,3833,4319,6527,2025,1100,17804
California,Fetters Hot Springs-Agua Caliente,4697,856,730,731,473,260,3050
California,Healdsburg,11802,777,1470,2677,2376,1302,8602
California,Inglewood,110327,17791,15464,25008,10360,4676,73299
California,Petaluma,60635,4571,7185,14239,10917,6235,43147
California,Red Bluff,14132,1079,2897,4025,737,367,9105
California,Laytonville,1175,142,280,231,195,26,874
California,Hollister,37835,5458,6206,8029,2569,992,23254
California,Cerritos,50172,2484,5181,9858,12171,6841,36535
California,Artesia,16817,2384,2794,3214,2633,890,11915
California,Azusa,49544,6019,7616,8718,4285,1948,28586
California,Baldwin Park,76222,16560,15254,11601,5240,1060,49715
California,Commerce,12933,3541,1868,2103,732,271,8515
California,Hidden Hills,1634,32,72,240,438,298,1080
California,Mineral,292,26,35,72,47,3,183
California,Laguna Woods,16228,773,2876,4731,4320,3495,16195
California,Norco,26569,2678,5469,7001,2284,1296,18728
California,Temecula,112230,5185,14808,27489,14630,8452,70564
California,Auberry,2476,150,454,793,258,119,1774
California,Squaw Valley,3449,406,609,706,278,200,2199
California,Avocado Heights,15903,3016,3240,2916,1163,435,10770
California,Bellflower,77529,11493,13062,15964,6362,2301,49182
California,Calabasas,24077,472,1766,3607,5465,5164,16474
California,Tiburon,9151,67,387,1389,2602,2527,6972
California,Prunedale,19584,2481,3004,4463,1877,1148,12973
California,Grover Beach,13538,1063,1950,3475,1703,881,9072
California,Hornbrook,215,47,30,74,6,9,166
California,Fremont,233083,10914,28087,33251,48071,44284,164607
California,Tennant,18,0,10,4,0,4,18
California,Los Altos Hills,8517,168,265,559,1718,3620,6330
California,Monte Sereno,3492,35,95,469,781,976,2356
California,Saratoga,30886,615,1518,3016,8011,9726,22886
California,Sunnyvale,152323,8523,11971,19656,33573,36995,110718
California,Cotati,7470,419,984,1898,1047,595,4943
California,Forestville,3685,166,631,1096,823,398,3114
California,Graton,1877,109,150,388,382,338,1367
California,Occidental,833,9,88,265,219,199,780
California,Corning,7535,897,1695,1360,351,114,4417
California,Yuba City,66388,9724,10133,15541,5222,2558,43178
California,Riverside,323935,39336,52399,62466,26631,18463,199295
California,Berkeley,120926,2748,4999,12516,25298,29474,75035
California,Loma Rica,3088,213,350,841,330,152,1886
California,Gustine,5774,1057,1290,1018,338,228,3931
California,Pacifica,39065,1539,4821,9572,7956,4867,28755
California,Dustin Acres,590,41,176,151,5,4,377
California,Ford City,4365,819,900,545,85,79,2428
California,Kernville,1007,24,162,244,308,80,818
California,Lower Lake,1595,153,492,469,105,38,1257
California,Lagunitas-Forest Knolls,1504,42,166,453,287,261,1209
California,Larkspur,12375,254,744,1762,3799,2930,9489
California,Tomales,253,0,36,76,75,66,253
California,Firebaugh,8295,2363,1383,782,213,29,4770
California,Farmington,89,10,28,12,0,17,67
California,Amesti,2832,506,354,696,188,56,1800
California,Corralitos,2381,196,270,605,571,209,1851
California,Lodi,65006,8057,10898,14008,5313,2719,40995
California,Freedom,3719,1116,393,553,211,75,2348
California,Scotts Valley,11900,130,934,2437,2779,1527,7807
California,Coto de Caza,14931,193,944,2625,3873,2583,10218
California,La Palma,15733,931,1919,3174,3639,1818,11481
California,Newport Beach,86280,1309,5087,15560,25964,17927,65847
California,San Clemente,65045,2628,5440,15386,14834,7930,46218
California,Mission Viejo,96124,4187,10223,22203,22332,10923,69868
California,Visalia,131066,13700,17753,28851,12233,6546,79083
California,Strathmore,2915,684,483,406,60,0,1633
California,Farmersville,10742,2512,1887,1372,94,67,5932
California,Garden Acres,10701,3077,1838,936,139,42,6032
California,Oroville East,7368,631,1572,2284,499,330,5316
California,Chico,91998,3593,9208,20526,13199,6698,53224
California,Rohnert Park,42694,2864,6315,11286,5386,2215,28066
California,Glen Ellen,727,36,15,373,122,142,688
California,Clovis,106666,6418,13870,25832,13937,7393,67450
California,Castro Valley,63288,3677,8423,13853,12926,6883,45762
California,Cloverdale,8798,955,1302,2299,1028,506,6090
California,Lost Hills,1943,577,242,82,0,0,901
California,Lincoln Village,4768,308,614,1037,613,378,2950
California,Calwa,1974,468,284,358,0,0,1110
California,Vallejo,120977,10141,20625,31249,16188,5668,83871
California,Burbank,5252,621,787,1179,703,433,3723
California,Colfax,2029,83,375,647,161,66,1332
California,San Joaquin,4021,1321,388,324,37,0,2070
California,Shaver Lake,498,7,90,158,129,69,453
California,Alum Rock,11791,2253,2169,1956,831,369,7578
California,Fruitdale,899,60,62,254,158,167,701
California,Los Altos,30588,339,772,2607,6835,10867,21420
California,Milpitas,77457,6471,8930,13232,15722,10475,54830
California,Keene,313,17,38,83,21,43,202
California,Morgan Hill,43876,2472,4637,9084,8133,4335,28661
California,Carlsbad,113670,3822,8374,20012,26950,20582,79740
California,Hidden Meadows,3386,117,276,869,841,585,2688
California,Larkfield-Wikiup,8926,765,856,2578,1332,833,6364
California,Gilroy,55525,6432,7048,11561,6026,3323,34390
California,Cupertino,60614,1151,2304,5527,13876,18206,41064
California,Campbell,42470,1737,4636,8069,10521,6406,31369
California,Cambrian Park,3094,115,431,589,688,416,2239
California,Weed,2677,223,470,801,212,38,1744
California,Macdoel,105,27,0,0,12,0,39
California,Greenview,283,12,66,117,24,0,219
California,Dunsmuir,1589,99,305,528,192,73,1197
California,Chula Vista,266468,30907,34259,57115,34160,15185,171626
California,Templeton,7938,320,1137,2050,1164,794,5465
California,Mesa Vista,278,21,118,41,52,11,243
California,Vacaville,97943,7264,16338,27543,10472,5245,66862
California,Pajaro,3561,967,521,283,33,0,1804
California,Marina,21608,2272,2744,4954,2348,1496,13814
California,Gonzales,8402,2104,1007,1129,449,61,4750
California,Boronda,1066,251,340,162,167,0,920
California,Aromas,2553,154,319,782,474,104,1833
California,La Mesa,59562,3424,8089,15408,9884,5448,42253
California,Jamul,5384,280,813,1360,981,856,4290
California,Cayucos,2692,56,322,951,484,311,2124
California,Magalia,12671,838,2406,4473,1120,468,9305
California,Paradise,26543,1553,5135,8786,2735,1559,19768
California,Willits,4893,459,795,1535,406,254,3449
California,Hickman,566,111,120,124,8,5,368
California,Hughson,7370,653,1193,1852,534,308,4540
California,Cutler,5774,1768,755,407,7,24,2961
California,Goshen,3316,974,387,314,95,17,1787
California,Springville,872,44,303,224,105,27,703
California,Kings Beach,2833,133,532,813,502,240,2220
California,Lincoln,46939,2555,6774,13069,7482,3802,33682
California,North Auburn,13707,930,2746,3961,1486,841,9964
California,Bluewater,161,17,59,56,5,0,137
California,Rio Linda,15460,1634,3915,3245,1117,292,10203
California,Rialto,102873,18456,18444,16764,4688,1767,60119
California,Orcutt,30493,1388,4368,8810,4178,2164,20908
California,Santa Ynez,4401,104,639,1379,659,323,3104
California,Carmichael,64785,2950,10003,18283,9467,5939,46642
California,Florin,49132,8421,8670,10294,3202,995,31582
California,Vineyard,28315,2209,3714,6932,3640,1604,18099
California,Corcoran,22301,6453,4608,4018,373,101,15553
California,Stratford,878,224,129,63,26,0,442
California,Laguna Hills,31185,1708,2824,6736,7175,3809,22252
California,Alpaugh,1074,372,84,77,5,7,545
California,Wrightwood,4283,182,551,966,622,427,2748
California,Westley,838,241,92,82,0,0,415
California,Turlock,72335,8688,11480,14454,7422,3812,45856
California,Salida,14658,1908,2656,2926,879,339,8708
California,Talmage,921,80,135,133,116,75,539
California,Home Garden,1643,392,270,230,25,0,917
California,Guerneville,4808,251,734,1581,942,459,3967
California,Manton,372,21,73,126,19,9,248
California,Rancho Tehama Reserve,1922,397,508,330,47,0,1282
California,Durham,5863,216,567,1739,1035,575,4132
California,Armona,3795,619,673,744,133,77,2246
California,Huron,7019,2915,579,426,19,0,3939
California,Buena Park,82781,8991,12260,17669,12782,3834,55536
California,San Leandro,90103,11547,15933,17752,13216,6176,64624
California,Bowles,194,26,49,23,27,0,125
California,Sanger,24978,4881,3700,4561,1333,470,14945
California,Alhambra,84974,11411,14872,15405,14378,6949,63015
California,Bradbury,916,62,58,176,263,153,712
California,Citrus,10771,2008,2176,1940,644,234,7002
California,San Andreas,3085,297,481,897,224,67,1966
California,London,1854,515,259,86,21,6,887
California,Felton,3810,83,302,1037,856,590,2868
California,Twin Lakes,5642,553,427,1555,831,788,4154
California,Bret Harte,5319,1456,744,308,18,11,2537
California,Modesto,211336,24624,37966,49123,17482,8577,137772
California,Gridley,6585,1025,822,1506,418,117,3888
California,Tehama,445,60,107,130,26,29,352
California,Casa de Oro-Mount Helix,19635,820,2442,4824,3412,2557,14055
California,San Diego,1401932,116291,146458,261992,257286,177434,959461
California,Nuevo,7033,979,1383,1264,415,237,4278
California,Moreno Valley,205034,28233,35314,38250,12975,6587,121359
California,Mecca,7174,2916,760,222,49,0,3947
California,Lakeview,2566,603,422,326,86,24,1461
California,Lakeland Village,13170,1786,3043,2363,592,190,7974
California,Cherry Valley,7755,574,1969,2200,710,468,5921
California,Linden,1790,35,352,581,176,117,1261
California,Coachella,44849,12288,11568,4157,734,185,28932
California,Rosedale,16737,930,2791,3798,2020,1334,10873
California,Oildale,34723,4425,7923,7459,1460,693,21960
California,Mojave,4230,580,871,944,162,62,2619
California,Johannesburg,138,0,25,86,0,0,111
California,North Fair Oaks,14547,3074,2002,1850,1285,1244,9455
California,Hillsborough,11439,260,512,995,2673,3312,7752
California,Highlands-Baywood Park,4564,100,188,801,949,1117,3155
California,Foster City,33784,927,1760,4636,8739,8597,24659
California,Millbrae,22703,1215,2633,4364,5598,3112,16922
California,Wallace,1063,99,130,507,19,138,893
California,Adelanto,33416,6230,4627,6048,651,223,17779
California,Bloomington,21783,5806,3332,3281,917,338,13674
California,Needles,4962,558,1458,1071,211,182,3480
California,Camarillo,67543,3372,6931,17223,12292,7193,47011
California,Elmira,285,25,85,61,23,0,194
California,Wasco,26708,7430,4975,3300,339,72,16116
California,Stallion Springs,3625,257,467,1158,162,151,2195
California,Rosamond,20028,2760,3227,4146,1466,875,12474
California,Randsburg,64,20,8,36,0,0,64
California,Onyx,588,66,192,111,48,51,468
California,Mountain Mesa,1236,94,218,296,166,16,790
California,Menlo Park,33869,1478,2008,3487,6465,9564,23002
California,Mettler,138,38,8,32,0,3,81
California,Lake of the Woods,768,152,86,273,61,38,610
California,McKinleyville,16612,780,2144,4489,2431,1024,10868
California,Lake Wildwood,5208,167,477,1845,1129,618,4236
California,Alta Sierra,7207,310,1020,2568,1048,568,5514
California,Kelseyville,3332,435,928,811,162,144,2480
California,Nevada City,3128,220,391,979,561,400,2551
California,Searles Valley,1646,190,350,446,49,65,1100
California,Redlands,71012,5221,9625,13906,9988,8112,46852
California,Lebec,1802,314,434,300,194,27,1269
California,Brisbane,4692,300,517,975,969,867,3628
California,Rio Vista,8618,350,1818,3071,1280,885,7404
California,El Cerrito,25203,1196,2013,4069,6080,5875,19233
California,Pismo Beach,8116,223,1161,2146,1704,1529,6763
California,Cambria,5725,353,811,1592,1242,882,4880
California,Dorris,868,151,173,171,25,9,529
California,Camp Pendleton North,7903,100,371,1186,580,238,2475
California,Alpine,15233,663,2051,4520,2192,1308,10734
California,Stanford,15668,66,105,158,1972,3029,5330
California,Loyola,3364,23,56,182,901,1121,2283
California,Los Gatos,30922,748,2082,4540,8428,6837,22635
California,Gazelle,46,8,21,16,0,1,46
California,San Luis Obispo,47160,1800,2858,7700,7255,4918,24531
California,Kirkwood,76,3,30,14,19,6,72
California,Alpine Village,155,22,6,58,13,9,108
California,Fairfield,114101,10690,16126,27880,14188,5576,74460
California,Salinas,156550,37672,20486,21518,8649,3575,91900
California,Bradley,107,11,52,13,5,2,83
California,King City,13834,4616,1581,1187,238,60,7682
California,Belmont,27110,848,1707,4194,5778,6539,19066
California,Tulelake,838,233,114,92,26,0,465
California,Palo Alto,67019,1226,2131,5240,13489,25316,47402
California,Edgewood,40,3,11,7,2,9,32
California,Oroville,19040,2094,3805,4923,942,352,12116
California,Crockett,3094,96,501,906,623,346,2472
California,Biggs,2323,349,430,541,59,22,1401
California,Valle Vista,16879,1810,3389,4626,927,714,11466
California,Homeland,7326,1488,1508,1135,196,150,4477
California,East Hemet,20679,2711,3939,4483,1008,624,12765
California,Bay Point,25165,4369,4467,4349,1489,432,15106
California,McFarland,14456,3889,2217,1097,142,138,7483
California,Orangevale,34757,1457,5574,9698,5644,2133,24506
California,Riverbank,24237,4233,4566,4790,1479,566,15634
California,Wofford Heights,1973,94,676,615,146,99,1630
California,Patterson,21783,3275,4783,3760,866,415,13099
California,Hermosa Beach,19650,366,982,2526,7663,4009,15546
California,Hawthorne,87370,12939,13688,17459,8684,3446,56216
California,Gardena,59924,7520,10768,14073,7756,2666,42783
California,Florence-Graham,64162,20366,8552,5609,1423,415,36365
California,Cudahy,24016,6841,3165,2644,702,232,13584
California,Tehachapi,12753,2039,2890,3300,728,434,9391
California,Charter Oak,9760,844,1544,2538,1309,452,6687
California,Palermo,5544,1007,1164,1185,166,118,3640
Colorado,Snowmass Village,2824,0,238,194,1610,124,2166
Colorado,Idaho Springs,1886,26,437,658,246,60,1427
Colorado,Avondale,727,0,193,268,22,8,491
Colorado,Granada,660,202,85,59,36,11,393
Colorado,Hillrose,286,18,79,62,19,6,184
Colorado,Manzanola,478,98,149,85,27,5,364
Colorado,Walsenburg,2931,281,664,814,322,89,2170
Colorado,La Veta,772,43,134,244,118,88,627
Colorado,Swink,766,50,91,202,81,29,453
Colorado,Crowley,314,14,52,140,16,1,223
Colorado,Pierce,1031,150,317,196,31,33,727
Colorado,Springfield,1347,151,237,326,146,65,925
Colorado,Keystone,978,19,122,87,188,236,652
Colorado,Sugar City,519,16,48,139,61,9,273
Colorado,Romeo,312,65,62,49,13,6,195
Colorado,Eaton,5148,312,865,1047,810,283,3317
Colorado,Evans,20393,2209,4180,4143,1449,439,12420
Colorado,La Salle,2539,278,562,524,99,74,1537
Colorado,Buena Vista,2746,31,576,666,359,322,1954
Colorado,Brush,5386,683,1018,936,427,325,3389
Colorado,Fort Morgan,11309,1839,2137,2105,521,372,6974
Colorado,Towaoc,1099,112,299,105,18,21,555
Colorado,Ouray,883,16,167,231,124,179,717
Colorado,Campo,91,14,15,33,7,0,69
Colorado,Walsh,638,122,144,149,79,24,518
Colorado,Eldora,39,0,0,0,14,25,39
Colorado,Foxfield,636,11,80,138,159,110,498
Colorado,Weston,23,3,0,20,0,0,23
Colorado,Wolcott,0,0,0,0,0,0,0
Colorado,Woody Creek,182,0,0,27,33,83,143
Colorado,Castle Pines Village,4701,61,105,661,1424,925,3176
Colorado,Phippsburg,225,6,132,7,13,39,197
Colorado,Watkins,598,25,187,136,73,36,457
Colorado,Castle Pines,10573,38,448,1402,2979,1823,6690
Colorado,Del Norte,1539,268,432,350,108,42,1200
Colorado,Bow Mar,893,16,20,93,260,202,591
Colorado,Hugo,683,65,196,150,35,28,474
Colorado,Sawpit,43,0,3,8,10,15,36
Colorado,Glendale,5170,419,650,1052,1504,439,4064
Colorado,Boulder,107360,2173,4128,9840,21593,23993,61727
Colorado,Niwot,4106,0,246,393,1330,928,2897
Colorado,Fort Carson,15410,167,1067,2852,580,220,4886
Colorado,Security-Widefield,38134,1747,6857,10160,3354,1930,24048
Colorado,Aspen Park,997,8,130,256,148,132,674
Colorado,Golden,20798,721,2135,2853,4115,3119,12943
Colorado,Fleming,590,15,117,212,45,11,400
Colorado,Iliff,326,15,66,123,13,9,226
Colorado,Vilas,90,3,12,25,4,0,44
Colorado,Nederland,1385,24,148,283,345,204,1004
Colorado,Gleneagle,6936,157,580,1261,1364,1461,4823
Colorado,Deer Trail,478,14,164,104,34,5,321
Colorado,Air Force Academy,6633,28,188,489,206,134,1045
Colorado,Steamboat Springs,12777,336,1516,2271,3710,1583,9416
Colorado,Leadville,2679,258,415,444,682,221,2020
Colorado,Ovid,216,26,75,58,12,3,174
Colorado,Grand View Estates,674,9,163,77,134,88,471
Colorado,Garden City,208,41,54,35,7,6,143
Colorado,Fairplay,865,32,174,178,104,44,532
Colorado,Brookside,226,10,50,66,29,13,168
Colorado,Dacono,5243,375,1245,1224,531,168,3543
Colorado,Severance,4187,69,648,1001,866,218,2802
Colorado,Haswell,60,2,22,16,3,7,50
Colorado,Bethune,180,8,59,42,3,5,117
Colorado,Edgewater,5334,546,989,1193,804,447,3979
Colorado,Pagosa Springs,2064,294,403,383,279,96,1455
Colorado,Penrose,2990,127,716,734,379,232,2188
Colorado,Naturita,484,59,169,110,28,20,386
Colorado,Jamestown,195,5,30,46,56,24,161
Colorado,Byers,1307,74,437,303,131,33,978
Colorado,La Junta,6914,577,1393,1550,451,337,4308
Colorado,Salt Creek,601,82,107,168,15,13,385
Colorado,Vail,5469,24,275,1215,1999,797,4310
Colorado,Craig,8888,628,2413,2091,748,355,6235
Colorado,Collbran,626,33,90,107,23,8,261
Colorado,Stratmoor,5883,712,1018,1340,432,302,3804
Colorado,Gunbarrel,9791,38,586,1449,3214,2138,7425
Colorado,Columbine,25094,361,3309,5922,5737,2670,17999
Colorado,Manassa,1020,73,174,241,75,48,611
Colorado,Englewood,33820,2439,5902,6826,6465,3323,24955
Colorado,Arriba,140,11,40,50,5,1,107
Colorado,Julesburg,1259,82,291,383,90,60,906
Colorado,Otis,530,18,89,166,38,20,331
Colorado,Dinosaur,278,31,91,43,15,0,180
Colorado,Sedgwick,135,12,41,31,17,2,103
Colorado,Silverthorne,4559,523,658,654,1074,492,3401
Colorado,Kiowa,809,30,214,195,126,20,585
Colorado,Ponderosa Park,3617,64,685,954,696,229,2628
Colorado,Lakewood,153522,8973,25211,32917,28110,15000,110211
Colorado,West Pleasant View,4691,262,859,871,612,520,3124
Colorado,Crook,164,14,70,26,10,2,122
Colorado,Simla,693,80,139,146,85,40,490
Colorado,Coal Creek,388,67,107,69,26,1,270
Colorado,Lincoln Park,3290,146,763,981,336,206,2432
Colorado,Williamsburg,549,34,163,153,23,24,397
Colorado,Black Forest,14274,384,1150,2637,3211,2676,10058
Colorado,Central City,731,35,164,252,97,59,607
Colorado,Marble,105,9,26,22,18,14,89
Colorado,Pitkin,100,0,25,6,31,5,67
Colorado,Fort Collins,162511,3305,14091,25477,30236,21155,94264
Colorado,Telluride,1826,97,115,164,728,290,1394
Colorado,Allenspark,401,0,37,108,102,60,307
Colorado,Louisville,20705,422,1352,2546,4981,5230,14531
Colorado,Ward,137,2,6,74,32,3,117
Colorado,Fountain,29339,894,4651,8406,2954,990,17895
Colorado,Crested Butte,1332,0,99,292,391,206,988
Colorado,Estes Park,6297,157,1053,1467,1386,1081,5144
Colorado,Loveland,75395,2211,13232,18641,12185,7088,53357
Colorado,Winter Park,650,0,188,150,149,81,568
Colorado,Merino,249,8,50,57,13,2,130
Colorado,Fort Garland,587,105,69,114,14,8,310
Colorado,Kittredge,998,0,171,137,232,190,730
Colorado,Peyton,281,0,17,0,116,0,133
Colorado,Piedra,35,0,3,10,12,3,28
Colorado,Pine Brook Hill,1045,13,21,150,232,436,852
Colorado,Portland,88,0,14,28,31,12,85
Colorado,Raymer (New Raymer),62,5,9,16,8,7,45
Colorado,Redstone,72,0,0,18,54,0,72
Colorado,Redvale,241,10,120,50,32,9,221
Colorado,Rock Creek Park,111,0,14,34,14,13,75
Colorado,Rollinsville,218,0,52,69,97,0,218
Colorado,Saddle Ridge,84,0,7,12,35,6,60
Colorado,St. Ann Highlands,440,0,57,60,141,91,349
Colorado,San Acacio,91,8,6,39,7,0,60
Colorado,Segundo,143,6,75,20,0,6,107
Colorado,Seven Hills,167,0,0,0,43,86,129
Colorado,Shaw Heights,5459,841,956,999,579,169,3544
Colorado,Smeltertown,52,0,9,37,0,0,46
Colorado,Snyder,147,13,56,29,0,0,98
Colorado,Peoria,221,17,17,95,17,19,165
Colorado,Cheraw,234,16,41,77,8,26,168
Colorado,Fowler,1311,85,333,377,109,16,920
Colorado,Haxtun,849,40,136,233,117,34,560
Colorado,Rifle,9600,1084,1972,1884,722,350,6012
Colorado,Arvada,117251,4668,20186,26486,21560,12015,84915
Colorado,Montrose,19096,1596,3636,4812,2279,1190,13513
Colorado,Cortez,8637,651,1689,1789,872,551,5552
Colorado,Fruitvale,8021,348,1860,2239,799,367,5613
Colorado,Eads,823,17,230,183,52,21,503
Colorado,Victor,429,11,116,123,43,52,345
Colorado,Red Feather Lakes,443,5,101,150,93,27,376
Colorado,Southern Ute,137,4,53,52,3,4,116
Colorado,Gunnison,6322,92,675,855,1147,498,3267
Colorado,Branson,76,0,23,18,10,8,59
Colorado,Denver,693417,64043,84265,110388,145105,92772,496573
Colorado,Crawford,277,17,73,69,12,2,173
Colorado,Franktown,107,0,26,24,9,40,99
Colorado,Crestone,89,0,4,55,5,8,72
Colorado,Beulah Valley,646,0,158,143,89,126,516
Colorado,Hartman,83,8,35,13,0,1,57
Colorado,Holyoke,2407,257,424,531,197,151,1560
Colorado,Tabernash,400,0,63,93,66,36,258
Colorado,Stonewall Gap,40,3,0,13,10,14,40
Colorado,Sugarloaf,393,0,15,95,188,81,379
Colorado,Sunshine,223,0,27,16,24,86,153
Colorado,Eckley,310,37,51,77,8,4,177
Colorado,Dillon,1169,13,113,359,282,144,911
Colorado,Yampa,452,34,133,55,55,21,298
Colorado,South Fork,332,8,75,108,52,41,284
Colorado,Basalt,3955,209,599,667,1132,387,2994
Colorado,Aspen,7234,197,587,1258,2528,1054,5624
Colorado,Paoli,71,25,24,21,1,0,71
Colorado,Ridgway,1060,0,142,245,278,154,819
Colorado,Yuma,3482,309,937,598,324,294,2462
Colorado,Log Lane Village,1224,267,334,167,50,6,824
Colorado,Thornton,134588,10806,23190,27588,17047,7213,85844
Colorado,Keenesburg,1380,93,318,400,80,42,933
Colorado,Greeley,103773,9864,16283,20285,9595,5581,61608
Colorado,Erie,22965,438,1622,3781,5652,3523,15016
Colorado,Calhan,817,25,176,218,91,35,545
Colorado,Gold Hill,124,0,0,10,27,87,124
Colorado,Sanford,935,33,160,243,69,26,531
Colorado,Montezuma,78,0,12,24,21,4,61
Colorado,Alamosa,9780,787,1460,1706,774,607,5334
Colorado,Sedalia,113,0,0,45,19,11,75
Colorado,Cheyenne Wells,989,92,226,188,126,11,643
Colorado,Empire,297,17,58,86,55,6,222
Colorado,Tall Timber,179,0,15,83,53,22,173
Colorado,Towner,18,0,3,10,2,0,15
Colorado,Trail Side,148,0,17,21,59,0,97
Colorado,Twin Lakes CDP (Adams County),7586,1862,1264,1313,613,400,5452
Colorado,Twin Lakes CDP (Lake County),185,0,33,68,35,15,151
Colorado,Upper Bear Creek,1013,0,101,183,265,216,765
Colorado,Vineland,273,17,33,93,26,31,200
Colorado,Valdez,14,0,8,0,0,0,8
Colorado,Downieville-Lawson-Dumont,513,23,158,81,122,10,394
Colorado,Valmont,48,0,7,18,0,14,39
Colorado,Weldona,146,19,52,34,13,0,118
Colorado,Poncha Springs,778,82,96,222,116,74,590
Colorado,Platteville,2707,211,698,667,144,55,1775
Colorado,Milliken,6773,508,1349,1796,537,139,4329
Colorado,Hudson,1722,110,385,369,165,21,1050
Colorado,Gilcrest,951,158,238,128,87,8,619
Colorado,Frederick,12138,321,1738,2871,2148,888,7966
Colorado,Aristocrat Ranchettes,1100,255,230,220,19,47,771
Colorado,Vernon,0,0,0,0,0,0,0
Colorado,East Pleasant View,184,25,51,2,22,15,115
Colorado,Peetz,203,12,52,78,9,2,153
Colorado,Monument,7065,346,285,1044,1580,1080,4335
Colorado,Jansen,249,4,11,63,0,0,78
Colorado,Jackson Lake,175,3,40,41,25,0,109
Colorado,Idledale,292,0,25,89,85,20,219
Colorado,Idalia,37,0,5,5,4,3,17
Colorado,Howard,829,24,128,218,144,143,657
Colorado,Inverness,1465,0,43,273,567,296,1179
Colorado,Holly Hills,2909,47,206,389,902,590,2134
Colorado,Hoehne,96,1,27,34,0,12,74
Colorado,Joes,63,5,15,29,0,2,51
Colorado,Hidden Lake,0,0,0,0,0,0,0
Colorado,Hasty,118,3,19,44,19,6,91
Colorado,Guffey,9,0,0,9,0,0,9
Colorado,Goldfield,39,0,5,12,10,0,27
Colorado,Glendale,138,0,0,47,68,0,115
Colorado,Gerrard,118,11,68,31,0,8,118
Colorado,Garfield,6,0,0,6,0,0,6
Colorado,Fulford,0,0,0,0,0,0,0
Colorado,Floyd Hill,1131,0,59,193,412,218,882
Colorado,Heeney,463,82,158,126,72,25,463
Colorado,Florissant,148,0,44,92,12,0,148
Colorado,Johnson Village,564,0,113,149,15,0,277
Colorado,Laird,52,0,0,39,0,0,39
Colorado,Paragon Estates,876,11,83,89,241,251,675
Colorado,Orchard,115,5,35,32,16,0,88
Colorado,North La Junta,313,20,78,112,2,9,221
Colorado,Norrie,0,0,0,0,0,0,0
Colorado,No Name,53,0,9,28,8,8,53
Colorado,Mulford,407,0,56,50,133,42,281
Colorado,Mountain Meadows,98,0,0,0,32,57,89
Colorado,Morgan Heights,267,5,31,62,107,26,231
Colorado,Kirk,88,7,15,21,28,1,72
Colorado,Midland,404,0,13,153,22,48,236
Colorado,Maybell,34,0,12,22,0,0,34
Colorado,McCoy,41,0,12,29,0,0,41
Colorado,Lynn,57,0,0,23,5,0,28
Colorado,Loma,1161,83,182,276,203,44,788
Colorado,Leyner,0,0,0,0,0,0,0
Colorado,Lewis,121,28,22,44,0,27,121
Colorado,Lazy Acres,868,0,67,144,200,330,741
Colorado,La Junta Gardens,90,5,0,46,1,8,60
Colorado,Maysville,157,0,0,94,45,18,157
Colorado,Lyons,2114,49,192,386,461,378,1466
Colorado,Fairmount,8710,259,1290,1557,1757,1285,6148
Colorado,Parshall,51,0,0,51,0,0,51
Colorado,Brandon,25,11,0,12,2,0,25
Colorado,Bonanza Mountain Estates,214,15,15,0,43,115,188
Colorado,Blue Sky,15,0,0,10,0,0,10
Colorado,Blende,821,85,197,233,24,30,569
Colorado,Bark Ranch,138,0,0,0,66,43,109
Colorado,Amherst,195,0,34,34,10,8,86
Colorado,Altona,442,20,8,90,100,183,401
Colorado,Alpine,390,14,23,138,54,46,275
Colorado,Indian Hills,1408,0,192,429,288,201,1110
Colorado,Aetna Estates,1475,66,453,242,18,14,793
Colorado,Centennial,109505,1903,10532,20084,27029,16894,76442
Colorado,Lone Tree,14209,236,852,1890,4187,2815,9980
Colorado,Cimarron Hills,18285,737,3016,4893,2056,729,11431
Colorado,Meridian,3615,21,270,809,962,601,2663
Colorado,Padroni,97,14,21,36,0,4,75
Colorado,Woodmoor,9117,50,598,1400,2379,1736,6163
Colorado,Evergreen,8602,80,663,1501,2296,1909,6449
Colorado,Palmer Lake,2684,28,502,690,431,243,1894
Colorado,Cañon City,16428,994,3737,4313,1601,951,11596
Colorado,El Moro,275,16,55,93,42,24,230
Colorado,Brick Center,142,0,26,41,9,19,95
Colorado,Cathedral,19,0,10,7,2,0,19
Colorado,Ellicott,839,109,168,197,9,18,501
Colorado,Elbert,193,14,53,50,8,0,125
Colorado,Dove Valley,5597,118,503,1110,1067,553,3351
Colorado,Dotsero,949,188,127,144,16,7,482
Colorado,Divide,87,0,0,32,26,0,58
Colorado,Dakota Ridge,34250,716,4446,7933,7311,3575,23981
Colorado,Crisman,128,0,0,41,57,30,128
Colorado,Cotopaxi,0,0,0,0,0,0,0
Colorado,Capulin,227,8,128,53,4,0,193
Colorado,Copper Mountain,371,10,12,101,160,65,348
Colorado,Comanche Creek,295,0,86,61,33,0,180
Colorado,Colona,54,0,35,19,0,0,54
Colorado,Coaldale,418,26,109,97,18,0,250
Colorado,City of Creede,344,15,77,104,63,29,288
Colorado,Cherry Creek,12601,258,599,1669,3010,2653,8189
Colorado,Chacra,541,9,15,186,50,59,319
Colorado,Cattle Creek,1094,154,169,108,28,49,508
Colorado,Catherine,264,21,38,49,46,39,193
Colorado,Conejos,47,0,18,9,0,0,27
Colorado,Frisco,3074,52,517,740,911,396,2616
Colorado,Alamosa East,1439,16,248,294,152,112,822
Colorado,Lamar,7606,858,1211,1930,536,299,4834
Colorado,Blanca,446,110,58,59,23,14,264
Colorado,Orchard City,3069,284,828,884,284,125,2405
Colorado,Ignacio,1282,120,342,208,125,39,834
Colorado,Berkley,11822,1718,1910,2260,1116,439,7443
Colorado,Nucla,518,47,186,88,36,28,385
Colorado,New Castle,4767,138,731,873,748,339,2829
Colorado,Sherrelwood,19243,3573,3634,3919,1208,392,12726
Colorado,Aurora,363550,30573,63321,74588,47117,21984,237583
Colorado,De Beque,459,39,127,89,32,15,302
Colorado,Ken Caryl,33804,590,4232,8134,7165,3593,23714
Colorado,Eldorado Springs,704,27,27,26,269,178,527
Colorado,Rangely,2289,56,444,672,231,114,1517
Colorado,Stonegate,9511,175,600,1508,2639,945,5867
Colorado,Federal Heights,12645,2202,2505,1857,730,176,7470
Colorado,Commerce City,54795,6005,9518,9569,4832,2336,32260
Colorado,Bennett,2202,113,584,496,224,48,1465
Colorado,Paonia,1374,68,301,332,189,127,1017
Colorado,Atwood,83,5,18,47,9,0,79
Colorado,Cascade-Chipita Park,1260,7,277,305,223,164,976
Colorado,Superior,13014,216,358,1346,3585,2938,8443
Colorado,Strasburg,2705,100,619,639,299,108,1765
Colorado,Starkville,83,15,10,25,6,0,56
Colorado,Cedaredge,2307,103,571,532,258,164,1628
Colorado,Perry Park,1917,25,193,391,614,407,1630
Colorado,Acres Green,2899,24,348,775,592,254,1993
Colorado,North Washington,553,169,156,35,8,0,368
Colorado,Walden,579,74,135,151,53,9,422
Colorado,Woodland Park,7421,106,766,2169,1251,994,5286
Colorado,Ophir,170,0,1,40,60,17,118
Colorado,Mountain Village,1767,43,181,255,497,197,1173
Colorado,Glenwood Springs,9894,776,1609,2015,1606,951,6957
Colorado,Sterling,13775,1157,3116,2851,1284,587,8995
Colorado,Lakeside,8,2,2,3,0,1,8
Colorado,Applewood,8308,182,1058,1420,1872,1455,5987
Colorado,Roxborough Park,9452,114,998,2077,2097,1359,6645
Colorado,Highlands Ranch,105147,1028,6975,16391,28191,15928,68513
Colorado,Battlement Mesa,4735,350,1141,769,474,269,3003
Colorado,Clifton,20572,1895,4940,5168,1235,287,13525
Colorado,Westcreek,179,0,46,75,5,10,136
Colorado,The Pinery,11754,148,1061,2355,2979,1502,8045
Colorado,Colorado City,2300,89,395,606,180,147,1417
Colorado,Delta,8768,948,2215,1873,780,329,6145
Colorado,Mountain View,614,51,123,147,123,58,502
Colorado,Manitou Springs,5280,106,584,1266,1151,908,4015
Colorado,Rico,174,7,17,62,47,17,150
Colorado,Wheat Ridge,31323,2019,6072,6995,5341,3191,23618
Colorado,Ramah,156,7,45,40,15,3,110
Colorado,Westminster,112747,6952,17410,24465,18317,10722,77866
Colorado,Lafayette,28002,773,2745,5105,6998,4131,19752
Colorado,Granby,1805,195,349,361,371,100,1376
Colorado,Genoa,108,5,29,37,1,5,77
Colorado,El Jebel,4167,217,696,880,959,292,3044
Colorado,Leadville North,2031,152,329,475,415,144,1515
Colorado,Mancos,1742,85,270,411,237,153,1156
Colorado,Kremmling,1684,83,454,353,162,46,1098
Colorado,Rockvale,516,37,152,133,52,31,405
Colorado,Edwards,10071,1321,871,1136,2112,1365,6805
Colorado,Bayfield,2612,122,512,544,357,161,1696
Colorado,Sheridan Lake,95,2,5,16,10,7,40
Colorado,Dove Creek,673,59,202,136,50,39,486
Colorado,Avon,6529,389,790,1226,1602,405,4412
Colorado,Morrison,388,20,91,120,88,40,359
Colorado,Mount Crested Butte,967,4,66,157,436,195,858
Colorado,Coal Creek,2157,43,342,403,820,310,1918
Colorado,Lake City,454,27,108,67,116,34,352
Colorado,Wellington,8571,279,1152,2095,1340,620,5486
Colorado,Hot Sulphur Springs,809,22,214,178,82,31,527
Colorado,Florence,3890,224,953,1117,347,91,2732
Colorado,Minturn,1090,98,110,265,391,93,957
Colorado,Eagle,6816,286,666,1139,1651,485,4227
Colorado,Ordway,1472,220,255,330,84,35,924
Colorado,Akron,2083,142,505,560,109,55,1371
Colorado,Westcliffe,378,30,71,89,61,35,286
Colorado,Blue River,666,0,64,113,186,118,481
Colorado,Timnath,2922,87,334,371,716,261,1769
Colorado,Oak Creek,894,45,197,171,145,71,629
Colorado,Parker,52563,702,4683,9970,10960,5754,32069
Colorado,Louviers,307,19,62,105,13,23,222
Colorado,Larkspur,257,25,64,71,19,22,201
Colorado,Carbondale,6712,948,832,989,1306,610,4685
Colorado,Redlands,9036,298,1304,2229,1998,977,6806
Colorado,Grand Junction,61479,4239,9437,13194,8836,4796,40502
Colorado,Kim,85,10,33,8,6,7,64
Colorado,Flagler,467,24,140,97,40,20,321
Colorado,Monte Vista,4169,509,1022,599,247,186,2563
Colorado,Hotchkiss,932,29,238,168,85,43,563
Colorado,Littleton,47035,2023,5746,9909,10613,5804,34095
Colorado,Seibert,119,14,56,24,8,0,102
Colorado,Black Hawk,138,19,65,33,2,0,119
Colorado,Red Cliff,366,21,146,60,66,5,298
Colorado,Meeker,2591,168,696,534,161,67,1626
Colorado,Cripple Creek,1136,73,486,254,32,52,897
Colorado,Norwood,619,55,140,140,79,35,449
Colorado,Antonito,645,56,173,163,31,11,434
Colorado,Green Mountain Falls,592,32,68,171,140,74,485
Colorado,Burlington,3626,335,1130,757,323,170,2715
Colorado,Arboles,313,12,63,115,32,22,244
Colorado,Salida,5642,570,1095,1236,998,503,4402
Colorado,Mead,4523,208,680,1009,673,352,2922
Colorado,Longmont,93244,6071,12733,18388,15702,9434,62328
Colorado,Grover,180,15,34,53,22,4,128
Colorado,Windsor,25232,463,3305,5478,4635,2900,16781
Colorado,Fort Lupton,8022,1120,1804,1425,399,221,4969
Colorado,Brighton,39054,3248,8217,8075,3717,1501,24758
Colorado,Ault,2178,312,370,465,153,85,1385
Colorado,Limon,1269,49,293,393,126,39,900
Colorado,Laporte,2411,186,444,496,517,231,1874
Colorado,Fruita,13145,939,2302,3757,1156,759,8913
Colorado,Dolores,877,73,105,165,140,71,554
Colorado,Two Buttes,41,7,13,19,0,0,39
Colorado,Fraser,1717,128,360,297,446,60,1291
Colorado,Elizabeth,1127,63,230,288,125,86,792
Colorado,Center,2188,669,317,166,62,21,1235
Colorado,Georgetown,1168,21,192,316,210,136,875
Colorado,Kit Carson,272,12,49,47,27,14,149
Colorado,Greenwood Village,15677,107,729,1878,4525,3957,11196
Colorado,Nunn,577,39,156,172,53,5,425
Colorado,Grand Lake,250,0,31,67,63,63,224
Colorado,Lochbuie,6036,891,1249,1223,377,35,3775
Colorado,Firestone,13109,350,1869,3237,2213,825,8494
Colorado,Las Animas,2065,254,601,460,139,72,1526
Colorado,Rye,185,4,37,59,28,11,139
Colorado,Pueblo,109985,9557,21995,28670,9479,4809,74510
Colorado,Hooper,53,6,13,18,6,2,45
Colorado,Genesee,3766,19,109,485,1140,1170,2923
Colorado,Colorado Springs,457502,20170,59409,104024,70656,46683,300942
Colorado,Olathe,1882,460,397,232,63,52,1204
Colorado,Johnstown,14278,414,2631,3633,2463,820,9961
Colorado,Gypsum,7079,797,1049,1354,1213,487,4900
Colorado,Columbine Valley,1221,10,75,150,404,274,913
Colorado,Olney Springs,539,43,126,107,52,7,335
Colorado,Bonanza,2,0,0,2,0,0,2
Colorado,Hayden,1791,54,453,486,150,101,1244
Colorado,Pueblo West,31860,996,5305,8821,4114,1966,21202
Colorado,Holly,970,164,148,192,72,13,589
Colorado,Loghill Village,604,12,38,201,169,134,554
Colorado,Rocky Ford,3824,423,776,965,301,110,2575
Colorado,Sheridan,6056,502,1528,1212,618,272,4132
Colorado,Alma,387,3,84,109,75,4,275
Colorado,Silverton,490,33,104,138,105,30,410
Colorado,La Jara,835,70,184,153,92,37,536
Colorado,Aguilar,485,80,118,102,46,16,362
Colorado,Vona,103,0,25,27,12,5,69
Colorado,Stratton,650,20,124,122,78,34,378
Colorado,Orchard Mesa,6601,365,1299,2069,713,292,4738
Colorado,Durango,18321,349,1777,3707,3970,2544,12347
Colorado,Palisade,2686,268,435,694,330,154,1881
Colorado,Cokedale,102,0,13,51,16,1,81
Colorado,San Luis,741,130,124,198,53,33,538
Colorado,Trinidad,8043,750,1473,2399,653,302,5577
Colorado,Silver Cliff,614,19,141,140,44,36,380
Colorado,Boone,235,12,64,69,28,4,177
Colorado,Pritchett,104,9,27,25,12,1,74
Colorado,Wray,2430,319,495,435,234,47,1530
Colorado,Breckenridge,4936,118,643,1143,1484,637,4025
Colorado,Saguache,526,103,137,99,75,18,432
Colorado,Moffat,135,18,46,28,13,10,115
Colorado,St. Mary's,516,0,130,147,51,68,396
Colorado,Wiley,309,3,88,90,47,7,235
Colorado,Wiggins,1102,129,181,272,54,43,679
Colorado,Northglenn,38918,3235,7532,9238,3348,1817,25170
Colorado,Kersey,1760,190,374,409,111,36,1120
Colorado,Silver Plume,163,3,24,40,33,34,134
Colorado,Cherry Hills Village,6600,0,234,490,1806,1794,4324
Colorado,Berthoud,6518,213,1316,1680,975,541,4725
Colorado,Castle Rock,59680,918,5315,12907,12650,5762,37552
Colorado,Silt,3091,141,606,764,263,65,1839
Colorado,Parachute,1242,163,233,296,23,29,744
Colorado,Welby,16352,2683,3432,3006,698,293,10112
Colorado,Todd Creek,4286,133,630,1173,773,368,3077
Colorado,Derby,9084,2301,1831,819,190,38,5179
Colorado,Broomfield,66120,1460,6667,12122,15880,9329,45458
Connecticut,Willimantic,17184,2007,2968,2290,967,746,8978
Connecticut,East Haven,28860,1858,8478,5586,3148,1739,20809
Connecticut,Woodmont borough,1698,35,250,289,427,276,1277
Connecticut,East Hartford,50453,5842,11798,9902,4495,2091,34128
Connecticut,Groton Long Point borough,499,3,26,90,115,208,442
Connecticut,West Simsbury,2523,39,261,324,462,753,1839
Connecticut,Litchfield borough,1244,39,233,344,243,167,1026
Connecticut,Northwest Harwinton,3244,144,675,749,542,266,2376
Connecticut,Crystal Lake,2231,45,386,360,429,347,1567
Connecticut,Salmon Brook,2438,110,340,518,551,289,1808
Connecticut,Westbrook Center,2075,224,599,443,404,254,1924
Connecticut,Mansfield Center,913,17,116,105,117,185,540
Connecticut,Essex Village,2595,116,220,422,814,506,2078
Connecticut,Georgetown,1824,18,229,386,382,311,1326
Connecticut,Bridgeport,146417,22072,31045,23609,10937,6254,93917
Connecticut,Pawcatuck,5249,239,1305,867,839,458,3708
Connecticut,Niantic,2872,82,559,625,568,588,2422
Connecticut,New London,27032,2795,5105,4235,2391,1528,16054
Connecticut,Weatogue,2788,21,227,274,847,556,1925
Connecticut,Southwood Acres,7715,329,1971,1698,1074,434,5506
Connecticut,Sherwood Manor,5438,188,1464,1165,723,443,3983
Connecticut,Long Hill,4191,208,997,817,666,453,3141
Connecticut,Fenwick borough,69,6,5,21,22,13,67
Connecticut,Rockville,7332,618,2044,1301,621,290,4874
Connecticut,North Granby,1657,35,115,228,489,285,1152
Connecticut,Danbury,84479,9877,16595,12572,10766,7831,57641
Connecticut,Waterbury,108672,14065,26374,18742,6745,4345,70271
Connecticut,Madison Center,2519,73,398,372,597,459,1899
Connecticut,Wauregan,1321,85,331,239,88,36,779
Connecticut,Quinebaug,1327,107,255,377,130,135,1004
Connecticut,Moosup,3943,476,1128,725,268,77,2674
Connecticut,East Brooklyn,1350,105,436,366,82,0,989
Connecticut,Norwalk,88436,7897,13968,14841,15473,10916,63095
Connecticut,East Hampton,2760,147,426,554,470,279,1876
Connecticut,Clinton,3453,200,698,800,647,300,2645
Connecticut,Darien,21759,345,873,1239,6250,4425,13132
Connecticut,Woodbury Center,1449,0,242,277,240,302,1061
Connecticut,North Haven,23786,743,5343,3870,3854,3557,17367
Connecticut,Hazardville,4896,207,1031,1079,608,407,3332
Connecticut,Naugatuck borough,31481,1948,7555,6586,3341,3007,22437
Connecticut,Kensington,8190,511,2110,1406,1624,727,6378
Connecticut,Storrs,16516,114,258,270,194,504,1340
Connecticut,Coventry Lake,2749,66,636,635,389,262,1988
Connecticut,Oxoboxo River,2906,230,849,707,169,217,2172
Connecticut,Tariffville,1391,81,242,296,298,116,1033
Connecticut,Hartford,123628,19432,25344,17990,7632,5061,75459
Connecticut,Collinsville,3514,45,274,793,794,748,2654
Connecticut,West Haven,54918,4704,13827,8835,5536,3368,36270
Connecticut,Cheshire Village,6484,159,771,979,1455,1206,4570
Connecticut,North Grosvenor Dale,1271,158,273,287,42,51,811
Connecticut,Heritage Village,4143,273,1013,978,923,788,3975
Connecticut,New Britain,72839,8956,17884,11128,5944,3407,47319
Connecticut,Ansonia,18860,1583,5166,3877,1508,1097,13231
Connecticut,Broad Brook,4766,196,812,966,729,415,3118
Connecticut,Terramuggus,1136,14,89,198,317,261,879
Connecticut,Bethlehem Village,1798,40,473,350,318,293,1474
Connecticut,Gales Ferry,862,0,249,209,176,45,679
Connecticut,Falls Village,478,14,87,112,79,85,377
Connecticut,Cos Cob,6959,206,601,616,1623,1477,4523
Connecticut,Conning Towers Nautilus Park,9749,139,1323,1987,744,245,4438
Connecticut,Cannondale,29,0,0,14,0,13,27
Connecticut,Byram,4216,342,847,730,655,483,3057
Connecticut,Brooklyn,965,205,206,298,49,98,856
Connecticut,Baltic,1182,60,426,287,37,29,839
Connecticut,Wilton Center,824,8,53,93,241,164,559
Connecticut,Stafford Springs,4947,320,1101,1123,428,216,3188
Connecticut,Colchester,5048,274,975,1169,706,359,3483
Connecticut,Deep River Center,2448,82,433,438,441,273,1667
Connecticut,West Hartford,63127,2405,5830,7715,13047,14763,43760
Connecticut,Canaan,1227,89,507,204,75,68,943
Connecticut,Portland,5572,291,1372,1263,747,428,4101
Connecticut,Ridgefield,7963,172,528,674,2133,2013,5520
Connecticut,Bantam borough,735,60,218,177,83,48,586
Connecticut,Thompsonville,8439,555,2515,1551,654,584,5859
Connecticut,Guilford Center,2618,107,371,325,648,575,2026
Connecticut,Meriden,59864,5692,17342,11419,6883,3099,44435
Connecticut,Shelton,41155,1932,8239,7794,6968,5141,30074
Connecticut,Danielson borough,3983,626,1068,802,267,165,2928
Connecticut,Wethersfield,26267,1277,4931,4684,4692,3481,19065
Connecticut,Wallingford Center,18322,1279,4980,3293,2414,1520,13486
Connecticut,Jewett City borough,3411,436,562,780,85,80,1943
Connecticut,New Preston,908,8,175,255,213,143,794
Connecticut,Milford city (balance),52349,1982,10531,10600,9735,6915,39763
Connecticut,Bristol,60308,4549,14672,11918,7778,3677,42594
Connecticut,Stratford,52279,3187,11710,10333,7440,5062,37732
Connecticut,Higganum,1496,12,264,205,282,363,1126
Connecticut,Norfolk,496,35,98,98,85,86,402
Connecticut,Manchester,29899,1743,6085,7226,3830,2128,21012
Connecticut,Lakeville,1154,45,149,253,188,163,798
Connecticut,Greenwich,13303,585,1985,1604,2836,2685,9695
Connecticut,Glenville,2499,83,267,376,661,412,1799
Connecticut,Suffield Depot,1334,56,310,189,178,212,945
Connecticut,Glastonbury Center,7742,234,1149,1472,1414,1441,5710
Connecticut,Blue Hills,2753,341,901,558,240,58,2098
Connecticut,South Windham,1533,85,365,369,117,81,1017
Connecticut,Simsbury Center,6091,243,505,884,1697,1133,4462
Connecticut,Plainfield Village,2113,416,670,416,126,51,1679
Connecticut,Westport,27840,322,1708,2025,6924,7425,18404
Connecticut,Old Greenwich,6819,70,294,486,1451,1982,4283
Connecticut,Stamford,129026,9894,18575,17450,25140,20250,91309
Connecticut,South Coventry,1117,44,255,155,313,181,948
Connecticut,Old Mystic,3513,129,617,823,531,493,2593
Connecticut,Mystic,4221,237,535,631,935,1143,3481
Connecticut,Groton,9109,353,1936,1890,820,845,5844
Connecticut,Winsted,7367,771,1982,1464,452,385,5054
Connecticut,Noank,1487,39,142,341,319,306,1147
Connecticut,South Woodstock,1181,49,171,348,181,158,907
Connecticut,Newtown borough,1949,48,174,226,454,377,1279
Connecticut,Orange,13937,348,1852,2046,2681,2996,9923
Connecticut,New Haven,130529,11936,25319,14871,12868,15664,80658
Connecticut,Poquonock Bridge,2450,318,524,234,190,6,1272
Connecticut,Saybrook Manor,1103,36,151,221,179,267,854
Connecticut,Bethel,9659,535,1620,1906,1783,1091,6935
Connecticut,Pemberwick,4114,83,748,583,968,608,2990
Connecticut,Middletown,46473,2412,8753,8473,6268,5584,31490
Connecticut,Riverside,8414,207,453,957,1861,1849,5327
Connecticut,Durham,2631,30,534,487,412,487,1950
Connecticut,Putnam,6772,364,1719,1872,665,302,4922
Connecticut,Chester Center,1653,37,244,288,399,226,1194
Connecticut,Moodus,1610,128,478,357,144,67,1174
Connecticut,Terryville,4900,314,1403,971,404,380,3472
Connecticut,Oakville,8929,724,2413,1845,826,651,6459
Connecticut,Newington,30323,1850,5766,5730,5482,3408,22236
Connecticut,Canton Valley,1525,68,252,343,251,179,1093
Connecticut,Derby,12596,1366,2918,2826,1322,641,9073
Connecticut,Branford Center,6413,310,1448,1400,1120,745,5023
Connecticut,Trumbull,36174,1043,4703,5587,7335,5999,24667
Connecticut,Old Saybrook Center,1881,53,301,495,401,242,1492
Connecticut,Lake Pocotopaug,3413,128,755,528,569,579,2559
Connecticut,New Hartford Center,1061,92,291,237,108,108,836
Connecticut,Norwich,39567,3765,10077,8123,3457,2321,27743
Connecticut,Somers,1887,67,326,389,303,248,1333
Connecticut,Stonington borough,906,33,80,176,221,256,766
Connecticut,Southport,1664,33,138,153,474,469,1267
Connecticut,Thomaston,1793,114,598,267,242,90,1311
Connecticut,Sharon,724,40,150,136,135,94,555
Connecticut,Watertown,3324,95,380,839,793,409,2516
Connecticut,Waterford,2796,253,879,567,343,149,2191
Connecticut,Mashantucket,216,9,24,66,23,12,134
Connecticut,Plantsville,1726,79,490,409,357,91,1426
Connecticut,Windsor Locks,12613,748,3556,2591,1426,754,9075
Connecticut,New Milford,6737,488,1478,1489,903,483,4841
Connecticut,Torrington,34737,3075,9418,7348,3586,2231,25658
Delaware,Greenwood,1017,79,296,232,39,23,669
Delaware,Blades,1366,254,286,233,78,29,880
Delaware,Riverview,2684,136,541,455,371,140,1643
Delaware,Claymont,8676,519,2249,1870,992,726,6356
Delaware,Highland Acres,3645,153,630,955,600,379,2717
Delaware,Bear,21362,1817,4168,3825,3195,1376,14381
Delaware,Dagsboro,856,36,240,156,86,78,596
Delaware,Millsboro,4238,455,812,799,386,334,2786
Delaware,South Bethany,426,4,56,98,134,107,399
Delaware,Slaughter Beach,231,10,42,53,41,53,199
Delaware,Selbyville,2252,366,400,533,177,178,1654
Delaware,Pike Creek,8312,63,891,1051,1897,2114,6016
Delaware,Newport,1335,212,289,287,79,29,896
Delaware,Rehoboth Beach,1281,36,144,251,437,333,1201
Delaware,Woodside,164,33,82,36,7,0,158
Delaware,Camden,3469,166,581,769,722,244,2482
Delaware,North Star,7441,133,832,930,2059,1648,5602
Delaware,Houston,409,13,146,94,32,4,289
Delaware,Millville,1877,59,365,347,369,217,1357
Delaware,Middletown,21250,843,3812,4079,2632,2183,13549
Delaware,Edgemoor,6471,311,1266,1439,826,531,4373
Delaware,Harrington,3667,223,746,754,225,81,2029
Delaware,Townsend,2332,77,398,356,309,205,1345
Delaware,Rising Sun-Lebanon,4263,258,807,1003,356,297,2721
Delaware,Ardencroft,207,10,33,54,38,39,174
Delaware,Newark,33352,504,3083,4123,4371,4378,16459
Delaware,Greenville,2333,54,164,225,649,740,1832
Delaware,Bridgeville,2696,324,596,495,345,241,2001
Delaware,Delaware City,1719,145,559,306,128,31,1169
Delaware,Little Creek,169,15,65,25,5,6,116
Delaware,Kent Acres,2429,240,419,515,196,154,1524
Delaware,Hartly,59,10,6,7,11,3,37
Delaware,Frederica,995,118,258,150,80,27,633
Delaware,Farmington,100,10,43,11,1,0,65
Delaware,Long Neck,2556,170,1030,574,223,173,2170
Delaware,Ardentown,259,10,33,52,59,51,205
Delaware,Cheswold,1313,119,340,260,86,39,844
Delaware,Laurel,4211,433,759,553,117,101,1963
Delaware,Clayton,3237,293,755,488,319,149,2004
Delaware,Pike Creek Valley,10664,268,1468,2287,1972,1494,7489
Delaware,Felton,1478,106,315,252,167,133,973
Delaware,Ocean View,2198,90,477,541,414,368,1890
Delaware,Milford,10835,1071,2239,2264,1173,645,7392
Delaware,Delmar,1790,173,539,324,96,53,1185
Delaware,Bethel,191,3,52,55,26,10,146
Delaware,Odessa,565,27,145,116,103,51,442
Delaware,New Castle,5359,341,1639,1146,698,625,4449
Delaware,Glasgow,14342,406,2566,3512,2004,1537,10025
Delaware,Dover,37331,2617,5994,7286,3409,2633,21939
Delaware,Lewes,3118,172,545,685,711,663,2776
Delaware,Georgetown,7123,1138,1601,1121,300,357,4517
Delaware,Fenwick Island,461,16,78,107,121,104,426
Delaware,Leipsic,144,16,54,33,9,1,113
Delaware,Frankford,984,108,286,104,50,12,560
Delaware,Bowers,345,31,102,64,31,26,254
Delaware,Dover Base Housing,3467,33,219,1000,216,149,1617
Delaware,Rodney Village,1370,65,511,188,58,32,854
Delaware,Wilmington,70904,6333,18113,10184,7768,5883,48281
Delaware,Smyrna,11333,663,3150,1929,1249,463,7454
Delaware,Hockessin,13472,379,1359,1765,3139,3252,9894
Delaware,Arden,388,4,65,78,79,91,317
Delaware,Viola,165,12,35,47,18,11,123
Delaware,Kenton,208,38,45,45,6,5,139
Delaware,Seaford,7572,979,1829,1657,533,236,5234
Delaware,Milton,2840,161,486,705,323,396,2071
Delaware,Henlopen Acres,204,0,12,21,70,55,158
Delaware,Ellendale,436,72,126,87,10,6,301
Delaware,Dewey Beach,306,16,30,60,80,89,275
Delaware,Bethany Beach,1006,7,153,222,280,219,881
Delaware,Wilmington Manor,7902,941,1981,1554,534,300,5310
Delaware,Elsmere,6049,834,1559,1043,578,297,4311
Delaware,Brookside,13191,764,3892,2301,1656,515,9128
Delaware,Wyoming,1437,40,228,364,165,149,946
Delaware,Magnolia,346,17,60,82,34,26,219
Delaware,St. Georges,795,20,343,114,58,38,573
Delaware,Bellefonte,1140,54,256,186,230,113,839
Delaware,Woodside East,2555,469,612,334,187,27,1629
District of Columbia,Washington,684498,45805,83572,77255,118817,161532,486981
Florida,Winter Beach,2340,145,383,511,474,303,1816
Florida,Duck Key,696,16,125,227,152,103,623
Florida,Big Coppitt Key,2951,211,513,816,317,163,2020
Florida,Westwood Lakes,12121,2021,2840,1633,1769,674,8937
Florida,Westview,11068,2005,2558,2099,731,156,7549
Florida,University Park,26317,3254,5696,3865,3181,1979,17975
Florida,Tamiami,57514,8983,12721,9487,9083,3052,43326
Florida,Clewiston,7663,1576,1629,1011,372,114,4702
Florida,Raiford,224,25,54,36,4,8,127
Florida,Sharpes,3049,324,785,838,273,245,2465
Florida,Rockledge,26906,1268,5533,7153,3630,2473,20057
Florida,Port St. John,11729,754,2982,3288,1029,677,8730
Florida,Lake Kathryn,1034,50,453,150,21,0,674
Florida,South Miami,12202,725,1595,1505,2401,2106,8332
Florida,Fort Pierce North,7070,990,1994,1256,397,157,4794
Florida,Largo,83243,5924,21676,22403,10012,4399,64414
Florida,Gainesville,130790,5391,14317,18671,15775,15167,69321
Florida,Pompano Beach,108855,13747,25062,21893,12433,6859,79994
Florida,Keystone Heights,1653,82,297,387,215,64,1045
Florida,Mount Plymouth,5610,128,1647,1345,389,248,3757
Florida,Graceville,2542,311,522,515,178,137,1663
Florida,Zolfo Springs,1872,424,364,147,14,8,957
Florida,Pembroke Pines,168260,7976,32163,39290,24488,14178,118095
Florida,Nokomis,3332,183,1067,745,308,296,2599
Florida,Tavernier,2260,167,433,559,301,159,1619
Florida,Fruitville,13780,915,3058,2828,2196,1208,10205
Florida,Kensington Park,4593,489,1053,1083,326,254,3205
Florida,Harbour Heights,3578,260,678,929,335,198,2400
Florida,Cleveland,3280,221,949,1089,134,155,2548
Florida,Charlotte Harbor,4077,342,1055,1059,646,308,3410
Florida,Weston,70220,1414,5583,10023,15310,12069,44399
Florida,Homosassa,1987,130,681,636,272,114,1833
Florida,Citrus Springs,8421,539,2493,2192,648,154,6026
Florida,Solana,904,78,133,129,118,88,546
Florida,Homosassa Springs,13477,1688,4495,3448,664,159,10454
Florida,Montverde,1622,58,251,394,217,163,1083
Florida,Groveland,12465,999,2600,2543,1682,650,8474
Florida,Paisley,1338,274,313,259,0,0,846
Florida,Titusville,45483,3177,11040,12159,5296,2309,33981
Florida,Crystal River,3092,212,910,839,326,237,2524
Florida,Washington Park,1799,328,454,293,77,10,1162
Florida,Combee Settlement,6323,1125,1675,977,87,19,3883
Florida,Auburndale,15343,1635,3649,3213,1461,750,10708
Florida,Lake Butler,1770,181,442,315,41,30,1009
Florida,The Meadows,4346,71,815,974,1107,934,3901
Florida,Sarasota,56102,4982,11801,11398,8892,6368,43441
Florida,Osprey,7028,187,1130,1324,1509,1485,5635
Florida,North Sarasota,8997,1154,2274,1568,622,313,5931
Florida,North Port,64425,4519,17053,15810,6579,2991,46952
Florida,Satellite Beach,10721,182,1530,2546,2083,1455,7796
Florida,Brooker,337,31,109,94,5,10,249
Florida,Springfield,9475,1240,2766,1784,421,167,6378
Florida,Villas,12036,1095,2685,3152,1889,1279,10100
Florida,Gulf Stream,740,11,34,96,231,195,567
Florida,Winter Park,30189,903,2820,4487,7357,6238,21805
Florida,East Palatka,1797,277,569,368,167,72,1453
Florida,Manalapan,280,9,26,64,88,78,265
Florida,Bristol,1025,170,306,137,43,27,683
Florida,Spring Lake,589,10,144,174,152,26,506
Florida,Plantation Island,295,25,42,36,0,0,103
Florida,Chokoloskee,268,0,96,101,56,15,268
Florida,Pretty Bayou,3674,204,884,883,514,340,2825
Florida,Panama City,36880,2645,8433,8816,3816,2237,25947
Florida,Wesley Chapel,55046,2193,7385,11666,9470,5306,36020
Florida,Dade City North,3030,854,477,210,96,10,1647
Florida,Punta Rassa,1908,29,347,323,554,611,1864
Florida,Cape Coral,178593,11137,48101,43155,21102,9981,133476
Florida,Buckingham,4047,212,1181,850,495,270,3008
Florida,Bonita Springs,53812,6068,10391,11431,9191,6124,43205
Florida,Lake City,11977,708,2863,2764,1009,658,8002
Florida,Okahumpka,146,44,102,0,0,0,146
Florida,Mascotte,5552,819,1426,1160,148,86,3639
Florida,Lisbon,345,0,172,173,0,0,345
Florida,Malabar,2990,62,692,804,573,293,2424
Florida,Pace,23749,1062,3959,5422,3046,1608,15097
Florida,Gulf Breeze,6383,155,618,1157,1478,1356,4764
Florida,Pinellas Park,52291,4653,14037,12396,5466,2701,39253
Florida,Port Charlotte,61204,4990,17029,16464,5733,3253,47469
Florida,Tildenville,1199,0,419,0,160,0,579
Florida,Ojus,17462,1125,2897,3918,2984,1765,12689
Florida,Watertown,3507,366,1106,558,74,114,2218
Florida,Astor,1418,194,362,318,204,20,1098
Florida,Webster,671,133,167,150,34,6,490
Florida,Esto,360,57,116,77,9,4,263
Florida,Lakeside,30890,1596,7452,7861,3234,1146,21289
Florida,Welaka,677,92,209,116,39,18,474
Florida,South Gate Ridge,6328,214,1619,1367,1041,490,4731
Florida,North Bay Village,8198,508,1362,1708,1572,1150,6300
Florida,Fort White,667,43,179,155,35,26,438
Florida,Valrico,38169,2173,6797,8672,5927,3141,26710
Florida,Ebro,263,18,115,44,12,1,190
Florida,Davenport,4140,470,829,685,264,255,2503
Florida,Poinciana,67169,7859,14456,12868,5338,2818,43339
Florida,Branford,796,147,199,172,26,38,582
Florida,Brandon,113279,6372,21974,26945,16566,7358,79215
Florida,Lake Hamilton,1551,104,609,270,115,14,1112
Florida,Mangonia Park,2615,325,587,414,112,23,1461
Florida,Vero Beach South,24082,1697,5770,6359,2781,1374,17981
Florida,Laurel Hill,643,62,202,136,33,14,447
Florida,Palm Bay,110271,8323,26646,26992,9980,4301,76242
Florida,Wabasso Beach,1839,16,104,452,499,590,1661
Florida,Palm Coast,83940,4917,21876,21672,8713,5240,62418
Florida,St. Augustine,14223,765,2220,2824,2531,1399,9739
Florida,Upper Grand Lagoon,17045,749,3352,3715,2440,1214,11470
Florida,Punta Gorda,19123,938,3991,5554,4043,2643,17169
Florida,Bowling Green,2890,553,677,143,70,45,1488
Florida,McIntosh,376,9,112,72,64,44,301
Florida,Carrollwood,35095,1149,5584,8479,6807,4050,26069
Florida,Cabana Colony,2443,81,436,884,387,35,1823
Florida,Brownsdale,384,6,100,136,45,0,287
Florida,Bradley Junction,587,132,184,96,0,0,412
Florida,Black Hammock,1327,53,201,249,280,153,936
Florida,Berrydale,326,52,99,48,28,7,234
Florida,Bear Creek,1720,130,367,423,296,175,1391
Florida,Bardmoor,9514,692,2079,2182,1296,999,7248
Florida,Balm,3745,371,667,804,363,124,2329
Florida,Avalon,469,56,68,163,36,12,335
Florida,Cedar Grove,3357,369,1007,661,141,117,2295
Florida,Aucilla,175,0,132,29,4,0,165
Florida,Alturas,3673,377,1458,561,222,82,2700
Florida,Allentown,1002,7,248,363,87,10,715
Florida,Alafaya,88542,4361,9673,18569,15688,8544,56835
Florida,Acacia Villas,459,0,124,58,6,0,188
Florida,St. Lucie Village,713,56,127,192,113,39,527
Florida,Manatee Road,2845,340,754,607,174,23,1898
Florida,Lake Butler,18917,516,1221,2663,4829,2958,12187
Florida,Grant-Valkaria,4099,135,887,1258,447,300,3027
Florida,Fountainebleau,59833,6851,12260,11614,9598,4421,44744
Florida,DeBary,20387,1020,5327,4586,3059,1171,15163
Florida,Aripeka,142,0,90,23,6,6,125
Florida,Chumuckla,801,92,283,224,79,28,706
Florida,Clarcona,2615,256,808,560,265,94,1983
Florida,Cobbtown,7,0,7,0,0,0,7
Florida,Heritage Pines,2030,65,673,700,328,249,2015
Florida,Harold,1162,46,227,464,97,11,845
Florida,Grenelefe,2341,57,559,586,359,120,1681
Florida,Greenbriar,2914,235,415,819,484,144,2097
Florida,Gardner,298,0,145,93,28,12,278
Florida,Garden Grove,706,48,246,149,53,75,571
Florida,Garcon Point,482,0,0,84,106,143,333
Florida,Fuller Heights,10327,744,2689,2223,1090,414,7160
Florida,Fort Green Springs,164,10,85,29,4,0,128
Florida,Fort Green,190,4,95,11,28,0,138
Florida,Fort Denaud,1984,341,801,335,54,74,1605
Florida,Floridatown,231,8,23,85,11,0,127
Florida,Fleming Island,28531,564,4001,6239,5733,2864,19401
Florida,Flagler Estates,3484,404,697,843,108,76,2128
Florida,Fidelis,167,17,26,56,20,0,119
Florida,East Milton,13054,2593,3598,3038,775,215,10219
Florida,Dixonville,133,9,59,54,0,11,133
Florida,DeLand Southwest,1004,108,235,141,98,47,629
Florida,DeLand,31289,2353,6113,6774,3754,2129,21123
Florida,Day,112,49,20,5,0,0,74
Florida,Dickerson City,123,12,58,44,0,9,123
Florida,Crawfordville,4467,139,1121,1146,525,199,3130
Florida,Connerton,4462,779,1012,881,380,239,3291
Florida,Loxahatchee Groves,3475,461,729,908,303,145,2546
Florida,Cutler Bay,44801,3043,8001,9314,6850,2839,30047
Florida,West Park,14924,2116,3036,3463,888,350,9853
Florida,Buenaventura Lakes,34085,3374,7935,7549,2685,1049,22592
Florida,Gonzalez,13962,500,2356,3406,2805,1010,10077
Florida,Jupiter Island,856,33,135,159,198,199,724
Florida,Jacksonville,878907,64116,169129,195848,111355,53716,594164
Florida,Orange City,11448,786,3030,2994,1161,717,8688
Florida,Glencoe,1814,100,590,425,180,95,1390
Florida,Flagler Beach,4946,255,971,1500,991,605,4322
Florida,Palmetto,13490,1685,3327,2546,1239,842,9639
Florida,Warm Mineral Springs,5149,414,2007,1615,558,375,4969
Florida,Lake Sarasota,4641,238,1123,1039,557,276,3233
Florida,Stock Island,4404,844,898,744,362,207,3055
Florida,Anna Maria,869,38,153,241,186,170,788
Florida,Wauchula,4857,824,1606,530,306,81,3347
Florida,Inverness Highlands North,2954,388,729,719,110,57,2003
Florida,Hernando,8727,978,3226,1867,648,319,7038
Florida,Oakland Park,44339,5280,9926,9471,5643,2848,33168
Florida,Miramar,138168,8230,23944,32838,15735,10997,91744
Florida,Lighthouse Point,11109,295,1955,2335,2998,1334,8917
Florida,Lauderhill,71328,7733,16592,12809,5408,3184,45726
Florida,Campbell,2095,174,701,636,285,149,1945
Florida,Mims,6171,615,1649,1647,540,261,4712
Florida,Merritt Island,36797,1679,7009,9253,5919,3570,27430
Florida,Bagdad,3474,189,832,771,493,105,2390
Florida,Belleview,4844,378,1741,1003,359,117,3598
Florida,Micco,8956,836,3471,2730,774,391,8202
Florida,Beverly Hills,9381,978,3225,2321,300,129,6953
Florida,La Crosse,435,55,125,113,29,3,325
Florida,Cudjoe Key,2030,61,517,484,429,312,1803
Florida,Sweetwater,21027,5066,4545,2726,2431,758,15526
Florida,Sunny Isles Beach,22171,1057,2709,6030,4470,3525,17791
Florida,Palmetto Bay,24564,815,2229,4090,5030,4028,16192
Florida,Ormond-by-the-Sea,7322,528,1595,2255,1104,850,6332
Florida,Miami Gardens,112913,15138,27741,20554,7385,3535,74353
Florida,Marco Island,17692,1265,3083,4286,4427,2739,15800
Florida,LaBelle,5075,1004,1049,752,154,213,3172
Florida,Doral,58265,1917,6235,10071,12001,7422,37646
Florida,Dania Beach,31810,2449,7578,7044,4105,2133,23309
Florida,Crystal Lake,6671,881,1379,988,346,194,3788
Florida,Southwest Ranches,7880,580,1179,1492,1294,1011,5556
Florida,Miami Lakes,31050,2232,4566,7131,4980,3106,22015
Florida,Four Corners,38983,1840,8037,8855,5951,1681,26364
Florida,Lee,385,26,143,59,16,5,249
Florida,Avon Park,10386,1750,2428,1821,420,250,6669
Florida,Venice,22601,818,5694,5771,4851,3312,20446
Florida,Bee Ridge,10012,651,2083,2130,1691,1422,7977
Florida,North Key Largo,990,19,128,257,298,160,862
Florida,Marathon,8737,676,2211,1984,1176,524,6571
Florida,Key Colony Beach,569,30,176,125,150,88,569
Florida,West Miami,7373,806,1650,1487,1135,522,5600
Florida,Palmetto Estates,15970,1553,4180,2843,1522,565,10663
Florida,Opa-locka,16420,3110,3933,1750,740,113,9646
Florida,Bellview,21269,1064,4335,7043,2775,945,16162
Florida,Wildwood,6557,612,1748,1594,417,270,4641
Florida,Hilliard,3157,328,1032,596,149,28,2133
Florida,Florida Ridge,21371,2591,3922,5991,2042,984,15530
Florida,Arcadia,7943,1113,2430,905,362,187,4997
Florida,Lake Placid,1932,259,574,204,164,122,1323
Florida,High Springs,5881,300,1216,1572,574,416,4078
Florida,Tamarac,64748,5445,15279,15313,8635,4550,49222
Florida,Sneads,1898,150,597,544,59,17,1367
Florida,Geneva,2759,26,531,912,503,151,2123
Florida,Winter Springs,35694,1066,5230,8587,7535,3680,26098
Florida,Hollywood,151056,14385,32725,33019,18069,11181,109379
Florida,Plantation,92775,4653,13530,19828,17342,11558,66911
Florida,Sea Ranch Lakes,546,13,33,43,145,127,361
Florida,Marineland,9,0,1,0,0,1,2
Florida,Wilton Manors,12534,863,2394,2794,3331,1777,11159
Florida,Inverness,7216,815,2122,1836,461,317,5551
Florida,Inverness Highlands South,6288,671,2038,1368,441,313,4831
Florida,Lecanto,6264,690,1902,1538,372,256,4758
Florida,Sugarmill Woods,8851,588,2526,2260,1443,663,7480
Florida,Jay,396,30,126,86,27,16,285
Florida,Fort Pierce,44833,6551,10472,7820,2821,1559,29223
Florida,Milton,9771,502,2062,2620,1019,389,6592
Florida,Newberry,5789,234,1033,1460,621,396,3744
Florida,Brent,22056,1552,4811,4307,1263,842,12775
Florida,Sewall's Point,2102,129,148,414,541,434,1666
Florida,Rotonda,8921,486,2964,2648,1307,631,8036
Florida,Samoset,4309,1040,1265,547,139,8,2999
Florida,Richmond Heights,11410,1145,3336,2127,938,492,8038
Florida,Princeton,30852,3723,5436,5099,3354,1319,18931
Florida,Malone,2006,573,582,327,87,13,1582
Florida,Campbellton,201,52,55,27,0,10,144
Florida,Fern Park,8340,454,1441,2207,1724,678,6504
Florida,Molino,1163,30,324,383,75,129,941
Florida,Haverhill,2249,244,409,574,178,101,1506
Florida,Jupiter,63617,2936,9410,13349,13546,8354,47595
Florida,Lake Belvedere Estates,4237,568,899,636,318,182,2603
Florida,Clearwater,114015,8757,24088,27413,16019,8422,84699
Florida,Harbor Bluffs,2793,187,379,701,646,322,2235
Florida,Indian Shores,1292,21,234,377,398,176,1206
Florida,Palm Harbor,61995,2376,12544,16816,11231,5038,48005
Florida,Tierra Verde,3557,83,493,614,939,934,3063
Florida,Miramar Beach,8758,167,906,2567,2053,1238,6931
Florida,Paxton,733,112,154,173,23,27,489
Florida,Sky Lake,6119,908,1799,1114,309,137,4267
Florida,Taft,1472,267,518,196,90,37,1108
Florida,New Port Richey East,10161,846,2919,2669,942,255,7631
Florida,Port Richey,2788,293,795,735,298,159,2280
Florida,Laguna Beach,4117,237,1167,1152,660,320,3536
Florida,Panama City Beach,12683,703,2545,3564,2074,784,9670
Florida,Coral Terrace,25234,3628,6165,5138,3155,1758,19844
Florida,Country Walk,17114,764,2922,4119,2505,1186,11496
Florida,North Miami,61435,9563,12406,11117,5922,2480,41488
Florida,Starke,5375,900,1636,1112,312,109,4069
Florida,Stuart,16100,958,3396,4733,1832,1221,12140
Florida,Lynn Haven,20768,629,3890,5205,2840,1378,13942
Florida,Hampton,534,129,151,91,17,6,394
Florida,Franklin Park,1031,165,119,130,39,27,480
Florida,Hillsboro Pines,533,6,93,46,110,18,273
Florida,South Patrick Shores,6802,186,1299,1453,1708,741,5387
Florida,Astatula,1637,214,425,354,84,12,1089
Florida,Clermont,33520,1619,5821,8825,4840,2962,24067
Florida,Lady Lake,15118,1212,4707,4097,1651,1172,12839
Florida,Cooper City,35376,1256,4917,6858,6190,4107,23328
Florida,Coral Springs,131151,6284,19334,27068,21428,11682,85796
Florida,East Williston,615,123,240,142,0,0,505
Florida,South Brooksville,3944,432,1112,937,536,237,3254
Florida,Weeki Wachee,2,0,0,2,0,0,2
Florida,Crescent City,1514,281,349,276,102,87,1095
Florida,Williston,2683,333,610,561,147,76,1727
Florida,Belleair Beach,1545,44,216,282,431,335,1308
Florida,North Redington Beach,1359,40,326,369,293,190,1218
Florida,Ridgecrest,3401,475,514,889,170,82,2130
Florida,Lake Panasoffkee,3306,590,1135,588,208,86,2607
Florida,Margate,57427,5665,16202,13312,6074,2539,43792
Florida,Fellsmere,5629,1529,480,461,448,49,2967
Florida,Indian River Shores,4142,281,229,853,1270,1269,3902
Florida,Sebastian,24536,1823,7098,6236,2739,1458,19354
Florida,Wabasso,585,53,119,135,59,104,470
Florida,West Vero Corridor,8661,839,2720,2287,1083,657,7586
Florida,Davie,103132,5986,17464,19754,17234,9772,70210
Florida,Lake Lorraine,7095,353,1070,1554,1204,925,5106
Florida,Broadview Park,8068,1558,1966,961,366,86,4937
Florida,Cocoa West,6152,675,1724,1243,301,79,4022
Florida,Altha,598,61,158,156,7,2,384
Florida,Holmes Beach,4198,58,577,1371,881,936,3823
Florida,Butler Beach,4904,220,1036,1150,954,898,4258
Florida,Crescent Beach,982,19,186,204,249,177,835
Florida,Sawgrass,4894,35,492,1078,1297,1001,3903
Florida,Aventura,37780,1454,3959,8808,9582,6816,30619
Florida,Brownsville,17155,3062,4034,2443,841,408,10788
Florida,Florida City,12096,3015,1645,1519,285,99,6563
Florida,Hialeah Gardens,23959,4441,5845,3891,2501,1063,17741
Florida,Ives Estates,22682,1754,4115,5093,2978,1952,15892
Florida,Kendall,74631,4490,10703,15250,14561,10098,55102
Florida,Miami Beach,91826,7602,13993,16842,19189,15647,73273
Florida,Pinecrest,19446,478,1596,2521,3980,4346,12921
Florida,Pinewood,17027,2864,4004,3091,946,365,11270
Florida,The Crossings,23558,1099,3286,6642,3921,1999,16947
Florida,Bushnell,3047,500,977,707,192,48,2424
Florida,South Beach,3538,89,149,582,1293,1041,3154
Florida,Vero Beach,16558,1027,3905,3775,2652,1717,13076
Florida,Fernandina Beach,12062,648,2484,2647,2283,1848,9910
Florida,Dunnellon,2188,167,654,543,252,84,1700
Florida,Ocala,58598,4734,13344,12253,5857,3667,39855
Florida,Reddick,590,137,105,109,30,19,400
Florida,Cocoa Beach,11539,366,2044,3019,2525,1590,9544
Florida,June Park,4281,305,930,1268,456,311,3270
Florida,Lake Mary,16360,440,2270,3456,4157,1938,12261
Florida,Longwood,14591,884,3148,3881,2108,880,10901
Florida,North Lauderdale,43829,4592,11181,7363,2925,1707,27768
Florida,Williamsburg,7967,563,1402,2207,1425,727,6324
Florida,Perry,6925,1032,1549,1234,369,191,4375
Florida,Miami Springs,14375,1495,2839,2856,2347,1299,10836
Florida,Madison,2825,381,673,331,134,203,1722
Florida,Leesburg,22243,2043,5722,4704,1570,859,14898
Florida,Melbourne Village,852,24,122,260,172,107,685
Florida,Fisher Island,106,0,0,0,40,66,106
Florida,Laurel,9477,404,2456,2566,1442,911,7779
Florida,Palm Springs North,5515,500,1379,1326,525,287,4017
Florida,South Daytona,12734,1067,3451,3319,1170,413,9420
Florida,South Palm Beach,1347,77,204,241,410,337,1269
Florida,Pine Lakes,537,77,209,132,15,6,439
Florida,Lazy Lake,22,0,0,13,8,1,22
Florida,Yulee,12616,921,3140,2822,1150,557,8590
Florida,Ruskin,23477,2614,4423,5360,1589,1089,15075
Florida,Tarpon Springs,24974,1881,5725,6064,3178,2110,18958
Florida,Chiefland,2514,279,744,339,47,95,1504
Florida,Greenacres,40224,4998,7475,8426,4210,1832,26941
Florida,St. James City,3437,147,967,942,620,432,3108
Florida,Wedgefield,7701,605,1373,1654,907,905,5444
Florida,Redington Beach,1397,50,264,436,331,165,1246
Florida,Okeechobee,5638,900,1433,1073,324,162,3892
Florida,Bayport,63,0,0,0,14,17,31
Florida,Mulberry,4047,371,1493,863,167,175,3069
Florida,Cottondale,794,91,208,144,31,18,492
Florida,Tallahassee,190180,6735,17237,29630,27136,22132,102870
Florida,Ocoee,44829,3808,6247,8952,7257,3303,29567
Florida,Westville,300,56,95,24,27,0,202
Florida,Noma,218,41,68,47,1,2,159
Florida,Bonifay,2693,360,685,521,159,95,1820
Florida,Fort Meade,6013,744,1704,1047,333,205,4033
Florida,Bartow,19063,1361,4889,3568,2008,702,12528
Florida,Harlem,2442,340,665,429,68,0,1502
Florida,Kissimmee,69833,7240,15474,15545,5611,2216,46086
Florida,Lake Mack-Forest Hills,802,104,318,211,0,18,651
Florida,Howey-in-the-Hills,1462,87,420,345,162,100,1114
Florida,Celebration,9329,64,1156,1581,2169,1613,6583
Florida,Altoona,100,0,13,20,24,17,74
Florida,Melbourne Beach,3224,41,571,690,618,586,2506
Florida,Melbourne,80664,5110,17751,19691,9746,6336,58634
Florida,Cocoa,18053,2080,3406,4060,1547,777,11870
Florida,West Melbourne,21471,923,4077,4847,2744,2137,14728
Florida,North Miami Beach,45069,5615,8448,10107,4444,2168,30782
Florida,Leisure City,26080,5687,5111,3241,1675,279,15993
Florida,Golden Beach,613,23,22,52,149,162,408
Florida,Hastings,892,157,342,155,41,46,741
Florida,West Samoset,7708,1531,2090,708,129,26,4484
Florida,Manasota Key,1141,58,403,363,198,102,1124
Florida,Umatilla,3693,339,647,1107,286,272,2651
Florida,Cape Canaveral,10274,495,2321,3202,1659,1197,8874
Florida,Belleair Bluffs,2273,95,486,689,437,286,1993
Florida,Century,1632,241,638,334,66,9,1288
Florida,Valparaiso,5035,206,656,1274,410,300,2846
Florida,Roosevelt Gardens,2585,497,666,472,148,16,1799
Florida,Bay Pines,3202,216,790,963,435,221,2625
Florida,Treasure Island,6875,233,1308,1876,1459,1239,6115
Florida,Glenvar Heights,17802,783,2265,4084,4185,2470,13787
Florida,Bay Harbor Islands,5938,89,465,1246,1283,984,4067
Florida,Freeport,2803,248,466,790,371,175,2050
Florida,Key West,25085,1353,4892,5905,4157,2788,19095
Florida,Key Largo,9954,839,2189,2592,1318,1171,8109
Florida,Bayshore Gardens,20293,2441,5575,3449,1598,879,13942
Florida,Coleman,541,77,215,124,18,2,436
Florida,Center Hill,890,216,207,105,18,22,568
Florida,Callahan,1414,129,382,284,102,35,932
Florida,Orchid,438,0,35,68,199,130,432
Florida,Shalimar,892,26,122,191,129,166,634
Florida,Goulding,4297,765,1174,699,79,39,2756
Florida,Ferry Pass,34416,1283,5088,7523,4301,2325,20520
Florida,Ensley,22844,1836,4771,6323,2656,839,16425
Florida,Crestview,23663,1405,4119,5753,2517,1029,14823
Florida,Heathrow,6364,151,313,1433,1369,1361,4627
Florida,Ocean City,5949,552,1085,1597,616,375,4225
Florida,Niceville,15050,504,2026,3855,2135,1687,10207
Florida,Greenwood,702,52,181,92,62,43,430
Florida,Bunnell,2675,303,733,549,234,66,1885
Florida,Alachua,9794,462,1582,2037,1443,997,6521
Florida,Belle Glade,19358,4586,3705,2430,763,269,11753
Florida,Deerfield Beach,79854,8312,19633,15902,9761,4737,58345
Florida,Delray Beach,67353,7022,11752,13614,11889,7206,51483
Florida,Lantana,11405,1367,2930,2353,1046,840,8536
Florida,Eagle Lake,2517,311,755,543,98,83,1790
Florida,West Bradenton,4324,218,898,926,614,434,3090
Florida,St. Marks,224,12,56,55,34,7,164
Florida,Miami Shores,10676,509,743,1811,2072,1678,6813
Florida,Key Biscayne,13054,129,663,1458,3260,2992,8502
Florida,Kendall West,39491,5556,7132,6404,6729,1765,27586
Florida,Country Club,49684,4947,10408,10033,5258,2593,33239
Florida,Coral Gables,50931,1314,3815,6523,10519,11624,33795
Florida,Biscayne Park,3175,271,316,622,478,371,2058
Florida,Safety Harbor,17663,595,3338,3818,3597,1926,13274
Florida,Redington Shores,2262,49,364,614,590,388,2005
Florida,Dunedin,36244,2369,8028,8909,6589,3625,29520
Florida,Zephyrhills South,5163,599,1761,1391,199,134,4084
Florida,Zephyrhills,14851,1757,4255,3821,1029,463,11325
Florida,Feather Sound,3646,20,336,791,975,816,2938
Florida,Hudson,12528,1101,4004,3174,1283,788,10350
Florida,Elfers,12637,1170,4249,3030,569,222,9240
Florida,Whiskey Creek,5030,177,677,1417,996,767,4034
Florida,Bokeelia,1420,94,410,427,237,127,1295
Florida,Pomona Park,1046,154,259,184,46,23,666
Florida,Timber Pines,5303,201,1735,1725,875,620,5156
Florida,North Brooksville,3161,385,925,631,284,189,2414
Florida,Brooksville,8027,849,2107,1625,693,435,5709
Florida,Lake Harbor,24,0,0,0,0,12,12
Florida,Hallandale Beach,39472,4491,7859,8287,5355,3644,29636
Florida,Ocean Ridge,1648,11,184,333,584,370,1482
Florida,Ormond Beach,41907,1787,8708,11261,6617,3702,32075
Florida,Eustis,20264,2070,5535,3845,1843,910,14203
Florida,Canal Point,483,108,117,97,34,0,356
Florida,Minneola,11058,492,1736,3029,1169,370,6796
Florida,Lauderdale-by-the-Sea,6594,291,1328,1531,1756,1252,6158
Florida,Hillsboro Beach,1631,29,295,351,443,426,1544
Florida,Coconut Creek,59997,3111,12088,12969,9712,4399,42279
Florida,Oviedo,39599,1062,4139,8485,7235,4406,25327
Florida,Chuluota,2582,46,542,812,277,200,1877
Florida,Altamonte Springs,43426,1741,6244,11796,8379,3810,31970
Florida,Fort Walton Beach,21845,1490,4029,6149,2453,1614,15735
Florida,Rio,831,9,247,265,92,88,701
Florida,Boulevard Gardens,1567,197,447,288,31,0,963
Florida,Marianna,7266,1017,1671,1378,328,372,4766
Florida,Alford,662,201,166,107,15,0,489
Florida,Orange Park,8680,420,1689,2579,1251,470,6409
Florida,Casselberry,27573,1403,5251,7738,3967,1381,19740
Florida,Hawthorne,1670,186,415,260,134,59,1054
Florida,Fort Lauderdale,178783,17173,32308,36373,30260,19036,135150
Florida,Roseland,1269,149,619,195,59,109,1131
Florida,Gifford,9679,1286,2289,1632,1018,820,7045
Florida,Ponce de Leon,497,58,112,111,41,13,335
Florida,Woodville,2461,181,614,634,221,104,1754
Florida,Oak Ridge,23712,4500,4756,4415,1755,254,15680
Florida,Orlovista,6574,803,1520,1557,325,195,4400
Florida,Pine Hills,75575,9992,15329,13891,4518,1443,45173
Florida,Azalea Park,14817,1849,3965,3035,1082,400,10331
Florida,Windermere,3346,5,172,497,983,674,2331
Florida,Apopka,50529,4551,8971,11054,6008,3284,33868
Florida,Havana,1526,168,438,338,215,132,1291
Florida,Chattahoochee,3103,714,722,586,154,70,2246
Florida,Waldo,840,82,231,147,38,10,508
Florida,South Pasadena,5071,317,1419,1622,930,444,4732
Florida,Fussels Corner,4026,545,1378,1017,392,168,3500
Florida,Waverly,922,193,134,167,0,0,494
Florida,Lely Resort,6340,787,1120,1331,993,779,5010
Florida,Immokalee,26773,9126,3268,1404,637,226,14661
Florida,Mexico Beach,1544,83,333,486,268,204,1374
Florida,Istachatta,194,61,22,52,0,0,135
Florida,Callaway,15182,833,3565,4589,737,501,10225
Florida,Zephyrhills North,2599,248,886,711,201,78,2124
Florida,Trinity,10646,259,2040,2780,1889,1030,7998
Florida,Jasmine Estates,21772,2486,5817,5114,1173,551,15141
Florida,Three Oaks,4314,142,566,904,762,316,2690
Florida,San Carlos Park,17778,1971,3170,4048,2025,572,11786
Florida,Pine Manor,5248,1007,853,287,60,54,2261
Florida,Matlacha,620,9,177,166,117,131,600
Florida,Harlem Heights,1930,395,283,285,93,39,1095
Florida,Fort Myers Beach,6966,391,1667,1980,1440,1113,6591
Florida,Lake Wales,15735,1997,3342,3312,1363,619,10633
Florida,Southchase,15096,1290,2542,3730,1948,702,10212
Florida,Belle Isle,6865,266,1310,1405,1576,725,5282
Florida,St. Pete Beach,9572,375,1390,2672,2488,1487,8412
Florida,Jupiter Farms,12032,486,2084,3150,2161,1084,8965
Florida,Island Walk,3356,54,817,875,459,772,2977
Florida,Hosford,804,117,263,178,92,10,660
Florida,Horizon West,32530,610,2623,5521,8379,3292,20425
Florida,Homeland,289,12,40,33,16,0,101
Florida,Holley,1523,111,286,414,215,96,1122
Florida,High Point,3704,504,1248,1164,184,130,3230
Florida,Cypress Quarters,1455,275,300,106,130,66,877
Florida,Egypt Lake-Leto,37039,5212,8262,6578,3741,1669,25462
Florida,Cheval,10603,316,1449,1992,2301,1273,7331
Florida,Vernon,685,67,216,114,47,16,460
Florida,Chipley,3511,472,1020,349,238,72,2151
Florida,Paradise Heights,539,87,111,164,48,0,410
Florida,Masaryktown,951,138,280,126,19,67,630
Florida,St. Petersburg,259041,17320,49940,58207,42513,23490,191470
Florida,Kenneth City,5017,418,1422,1235,318,240,3633
Florida,Golf,214,1,15,31,87,73,207
Florida,Cloud Lake,206,10,41,65,25,14,155
Florida,Moore Haven,2551,508,752,361,104,26,1751
Florida,Sanford,58862,3749,12611,13779,6885,2104,39128
Florida,Wright,22991,1768,4453,6037,2964,1354,16576
Florida,Eglin AFB,2083,8,108,498,213,52,879
Florida,Grand Ridge,770,41,159,197,49,31,477
Florida,Bascom,56,2,22,22,0,3,49
Florida,Warrington,14487,1062,3056,4176,1166,861,10321
Florida,Jacob City,228,31,89,52,7,1,180
Florida,Indian Harbour Beach,8401,181,1338,1805,1653,1435,6412
Florida,The Villages,77609,2602,18940,23072,18550,13836,77000
Florida,Nassau Village-Ratliff,4769,375,1444,1093,351,181,3444
Florida,Glen St. Mary,618,76,166,83,27,22,374
Florida,Worthington Springs,435,57,98,67,0,4,226
Florida,Silver Springs Shores,8966,1058,2211,1358,430,331,5388
Florida,Briny Breezes,876,50,231,221,173,166,841
Florida,Boynton Beach,75720,7273,15175,17428,11305,4681,55862
Florida,Westchase,23636,596,2395,3778,5871,3579,16219
Florida,Riverview,91190,4691,15879,21228,11593,6264,59655
Florida,Plant City,38119,3856,8597,6741,3786,1471,24451
Florida,Palm River-Clair Mel,23627,3279,5499,4178,1736,866,15558
Florida,Lutz,21456,587,3440,4734,3774,2831,15366
Florida,Keystone,24632,549,2726,4481,5429,3573,16758
Florida,East Lake-Orient Park,28602,3072,7245,4926,2143,838,18224
Florida,Caryville,177,61,50,17,2,0,130
Florida,Loughman,4984,410,775,1491,480,140,3296
Florida,Kathleen,6546,784,1735,1341,304,60,4224
Florida,Jan Phyl Village,6467,1089,1735,903,382,101,4210
Florida,Wahneta,5484,1629,969,341,57,6,3002
Florida,Wekiwa Springs,23329,428,2711,5376,5477,2680,16672
Florida,Oldsmar,14444,678,3015,3281,2013,973,9960
Florida,Green Cove Springs,7639,672,1661,1691,856,473,5353
Florida,Highland Park,197,1,39,39,36,37,152
Florida,Gulfport,12280,832,2759,3020,2502,1432,10545
Florida,Cedar Key,773,28,162,149,113,131,583
Florida,Jennings,831,234,90,60,6,13,403
Florida,Lake Worth,37728,8304,6779,6524,3138,1622,26367
Florida,Shady Hills,12435,1484,3852,2542,792,401,9071
Florida,Macclenny,6482,580,1535,1541,387,245,4288
Florida,Pine Ridge CDP (Citrus County),10279,707,2298,3232,1456,1023,8716
Florida,Bronson,913,95,291,137,59,26,608
Florida,Sebring,10636,1487,3252,2075,898,470,8182
Florida,Southeast Arcadia,7813,2390,1943,417,196,42,4988
Florida,Cortez,4436,240,1185,1219,694,643,3981
Florida,Bradenton Beach,929,39,229,243,199,115,825
Florida,Sopchoppy,407,27,145,71,44,29,316
Florida,Weeki Wachee Gardens,1539,129,509,475,163,15,1291
Florida,Penney Farms,678,57,128,90,179,180,634
Florida,Westchester,30210,4360,6969,5164,4405,1940,22838
Florida,Surfside,5817,171,651,812,1470,915,4019
Florida,Miami,451214,77642,99060,66533,57276,36902,337413
Florida,Kendale Lakes,58395,5711,12872,12801,7491,3633,42508
Florida,Homestead Base,929,84,104,112,0,0,300
Florida,Homestead,68424,10780,10398,11263,5203,3071,40715
Florida,Hialeah,237285,52100,62531,37127,19305,6640,177703
Florida,Golden Glades,34836,5740,7304,6192,2529,1307,23072
Florida,Villano Beach,2890,120,563,764,605,338,2390
Florida,St. Augustine Shores,9418,291,2147,2816,1493,676,7423
Florida,South Bradenton,25646,3567,7134,5154,1668,1037,18560
Florida,Memphis,8788,823,2352,1556,863,303,5897
Florida,St. Augustine Beach,6883,125,687,1361,1517,1217,4907
Florida,Medulla,9679,445,2600,1993,1049,465,6552
Florida,Lake Alfred,5565,653,1413,947,290,365,3668
Florida,Virginia Gardens,2504,259,521,494,373,158,1805
Florida,North Weeki Wachee,7853,797,2260,2017,916,493,6483
Florida,East Lake,32315,985,4905,6926,7462,4259,24537
Florida,Indian Rocks Beach,4223,168,677,1101,1114,693,3753
Florida,White Springs,755,98,225,147,66,26,562
Florida,Jasper,4104,991,1319,585,140,94,3129
Florida,Lake Park,8505,1177,1590,1514,1171,374,5826
Florida,Lake Clarke Shores,3584,46,696,931,929,269,2871
Florida,Highland Beach,3858,86,437,725,1354,893,3495
Florida,Gun Club Estates,1105,245,282,113,83,42,765
Florida,Wewahitchka,2342,278,649,505,155,50,1637
Florida,Port St. Joe,3465,169,926,1133,262,121,2611
Florida,Taylor Creek,4189,563,1314,1067,240,85,3269
Florida,Seffner,8786,673,1631,2194,945,354,5797
Florida,Hillcrest Heights,237,12,36,55,34,25,162
Florida,Cypress Gardens,10358,536,2311,3003,1426,726,8002
Florida,Yankeetown,585,51,164,130,71,30,446
Florida,South Apopka,6081,914,1591,769,349,40,3663
Florida,Andrews,720,95,239,195,0,0,529
Florida,Pine Castle,11643,1634,2743,2075,873,294,7619
Florida,Lockhart,14775,990,3495,3560,1674,516,10235
Florida,Fairview Shores,11254,1420,2198,2242,1603,541,8004
Florida,Midway,3301,365,621,566,307,192,2051
Florida,Progress Village,10136,668,1832,2029,1381,333,6243
Florida,Mango,11228,1094,2597,2313,949,334,7287
Florida,Lake Magdalene,29794,1531,5163,6607,5215,3147,21663
Florida,Gibsonton,17873,2193,3440,3233,1330,620,10816
Florida,Fish Hawk,20054,227,1121,2719,4283,3210,11560
Florida,Dover,3001,1142,347,243,60,49,1841
Florida,Bloomingdale,23758,728,3443,5107,4666,2167,16111
Florida,Polk City,2203,279,633,463,150,106,1631
Florida,Lakeland,105958,8302,25283,20796,12567,6860,73808
Florida,Inwood,7651,1489,2018,1036,112,46,4701
Florida,Frostproof,3176,624,729,542,158,143,2196
Florida,Orlando,275690,18732,45718,57087,46808,23763,192108
Florida,Captiva,178,78,33,31,12,12,166
Florida,East Bronson,1878,261,627,320,107,51,1366
Florida,Quincy,7512,1257,1689,1188,670,268,5072
Florida,Plantation Mobile Home Park,1522,309,350,235,100,24,1018
Florida,Vamo,4862,330,1143,1113,867,584,4037
Florida,Pebble Creek,8284,236,1037,1637,1481,1007,5398
Florida,Live Oak,6888,1010,1541,1327,697,365,4940
Florida,Monticello,2256,178,491,514,187,250,1620
Florida,Winter Haven,39615,3968,9746,8825,3515,1770,27824
Florida,Highland City,10641,611,2271,2214,1365,684,7145
Florida,Dundee,4313,715,1032,669,139,101,2656
Florida,Grove City,1909,173,573,542,190,79,1557
Florida,Ridge Manor,4606,401,1481,1016,369,197,3464
Florida,Hernando Beach,2640,142,566,791,444,193,2136
Florida,Orangetree,4271,139,448,965,525,649,2726
Florida,Naples Manor,6735,1541,1046,479,330,29,3425
Florida,Goodland,437,0,44,116,130,0,290
Florida,Gretna,1174,188,303,175,40,31,737
Florida,Lacoochee,1628,223,385,181,53,55,897
Florida,Olga,2324,239,714,456,154,151,1714
Florida,Iona,14385,797,3703,3572,3142,1872,13086
Florida,Beacon Square,6873,640,2208,1503,545,228,5124
Florida,Thonotosassa,13966,1470,3555,2573,1256,588,9442
Florida,Tampa,376345,32223,64625,61895,57511,36934,253188
Florida,Yalaha,1200,0,451,369,91,132,1043
Florida,Tavares,16199,1429,4505,4068,1603,789,12394
Florida,Mount Dora,13620,1044,3139,3300,1816,1404,10703
Florida,Ferndale,622,51,125,144,78,34,432
Florida,Trenton,2211,272,526,305,66,40,1209
Florida,Pittman,246,0,93,36,22,4,155
Florida,Bell,634,55,107,136,20,25,343
Florida,Palm Shores,1181,22,171,443,150,77,863
Florida,Fruitland Park,6598,337,1548,1495,807,580,4767
Florida,Suncoast Estates,4314,623,1628,736,162,17,3166
Florida,Pahokee,6167,1528,1112,1016,238,101,3995
Florida,Limestone Creek,1123,294,184,151,194,16,839
Florida,Boca Raton,95745,2774,12392,17649,22314,16479,71608
Florida,Charleston Park,229,100,19,83,0,0,202
Florida,Spring Hill,107855,9370,27393,27832,8861,3999,77455
Florida,Pine Island,13,0,0,0,13,0,13
Florida,Lake Lindsey,17,0,11,0,0,6,17
Florida,Brookridge,4549,531,1697,1321,250,152,3951
Florida,Vineyards,3929,87,618,664,1213,781,3363
Florida,South Highpoint,5335,814,1050,964,240,112,3180
Florida,Belleair Shore,87,2,8,17,30,15,72
Florida,Belleair,4097,130,232,925,1256,648,3191
Florida,Meadow Woods,36190,2715,5821,8344,4932,1965,23777
Florida,Maitland,17622,234,1732,3323,4488,2680,12457
Florida,Fanning Springs,1045,115,344,225,87,37,808
Florida,Zellwood,3079,257,931,907,418,98,2611
Florida,Lake Hart,430,18,45,134,0,108,305
Florida,Cypress Lake,13120,1018,3082,3753,2224,1407,11484
Florida,Hunters Creek,22770,979,2825,4079,4694,2739,15316
Florida,Williston Highlands,1842,156,636,500,151,48,1491
Florida,St. Leo,1164,0,9,48,8,19,84
Florida,Odessa,8517,528,1372,1621,1412,825,5758
Florida,Land O' Lakes,37007,1475,5832,9155,6230,3316,26008
Florida,North Fort Myers,41690,4525,13512,10606,4362,2629,35634
Florida,Matlacha Isles-Matlacha Shores,316,9,91,69,40,0,209
Florida,Alva,2724,146,724,748,277,212,2107
Florida,Lawtey,862,80,224,196,35,8,543
Florida,Lake Buena Vista,4,0,0,0,0,4,4
Florida,Holden Heights,3494,253,887,1005,568,163,2876
Florida,Mayo,988,182,272,122,27,11,614
Florida,Greensboro,726,125,160,122,33,10,450
Florida,Seminole,18542,1091,4479,5025,2875,1599,15069
Florida,Madeira Beach,4284,188,879,1284,915,568,3834
Florida,Bay Lake,71,0,2,28,22,0,52
Florida,Fort Myers Shores,7010,954,2038,1421,419,218,5050
Florida,McGregor,8032,427,1422,1772,1767,1089,6477
Florida,Page Park,387,26,74,118,58,0,276
Florida,Tangerine,2403,372,533,405,330,167,1807
Florida,Tangelo Park,2755,307,609,760,160,44,1880
Florida,Gotha,2313,25,173,350,514,215,1277
Florida,Edgewood,2833,131,483,652,401,347,2014
Florida,Doctor Phillips,11347,409,1132,2501,2636,1712,8390
Florida,Christmas,1921,275,551,453,207,150,1636
Florida,Bithlo,9457,720,1926,1769,1205,575,6195
Florida,Wimauma,7621,1782,1332,691,146,90,4041
Florida,Town 'n' Country,85620,7336,19726,16421,11515,5606,60604
Florida,Temple Terrace,26062,1370,2943,5289,4322,3095,17019
Florida,Citrus Park,26473,1361,5221,6022,4363,2107,19074
Florida,Apollo Beach,19457,793,3156,4970,3506,2087,14512
Florida,Wausau,422,49,118,90,7,7,271
Florida,Otter Creek,53,14,19,9,0,0,42
Florida,Inglis,1437,270,474,374,95,26,1239
Florida,Horseshoe Beach,95,15,33,17,16,7,88
Florida,Cross City,2123,290,609,285,108,17,1309
Florida,Palmona Park,1234,152,406,133,50,16,757
Florida,Pineland,309,6,89,112,78,24,309
Florida,Sanibel,7224,147,907,1513,1998,1960,6525
Florida,Bayonet Point,26740,2414,8205,6515,1989,744,19867
Florida,Holiday,21481,2022,7203,4472,1637,443,15777
Florida,New Port Richey,15953,1755,4618,4167,1207,647,12394
Florida,Wellington,63681,2381,8272,12874,11606,7558,42691
Florida,Fort Myers,76591,9629,15082,14750,9463,5892,54816
Florida,Indian Creek,35,0,7,4,6,8,25
Florida,The Hammocks,60473,3826,10048,14221,9650,4089,41834
Florida,Desoto Lakes,3353,122,737,752,476,316,2403
Florida,Ridge Wood Heights,4140,216,1155,988,661,302,3322
Florida,Siesta Key,5667,164,590,1287,1530,1365,4936
Florida,Palm Beach,8667,159,541,2048,2831,2498,8077
Florida,El Portal,2143,248,333,476,403,284,1744
Florida,Port Orange,61601,4149,13807,16038,7527,4145,45666
Florida,Three Lakes,16043,813,1939,3693,2923,1267,10635
Florida,Sumatra,266,36,86,40,34,0,196
Florida,Mulat,261,0,57,54,23,12,146
Florida,Mount Carmel,203,0,51,54,58,0,163
Florida,Morriston,101,45,33,0,0,0,78
Florida,Moon Lake,4341,699,1175,884,87,7,2852
Florida,Montura,3821,1207,962,375,49,14,2607
Florida,Midway CDP (Seminole County),1597,225,372,445,51,10,1103
Florida,Midway CDP (Santa Rosa County),17704,577,2934,4566,2583,1639,12299
Florida,Meadow Oaks,2513,197,819,522,223,111,1872
Florida,Lloyd,141,62,38,31,0,0,131
Florida,Limestone,187,54,85,33,0,0,172
Florida,Lemon Grove,615,41,209,58,27,35,370
Florida,Lealman,21281,3348,5482,4794,1455,483,15562
Florida,Lamont,87,8,0,44,0,8,60
Florida,Lake Mystic,461,55,113,45,16,22,251
Florida,Lake Mary Jane,2063,87,202,539,574,246,1648
Florida,Key Vista,1617,10,309,566,229,159,1273
Florida,Kenwood Estates,1340,423,176,92,35,12,738
Florida,Pierson,1423,307,291,265,64,31,958
Florida,Holly Hill,12042,1303,3423,2685,905,404,8720
Florida,Royal Palm Estates,3485,529,901,394,222,29,2075
Florida,Riviera Beach,34352,3233,7639,6408,3442,2208,22930
Florida,Carrabelle,2650,538,725,487,118,52,1920
Florida,Apalachicola,2477,387,601,500,222,153,1863
Florida,Munson,171,6,91,8,12,0,117
Florida,Lakewood Park,12635,1485,3458,3035,1012,527,9517
Florida,Navarre,35540,1182,5717,9684,4670,2346,23599
Florida,Nocatee,13266,43,1078,2385,2989,2121,8616
Florida,Springhill,93,17,23,47,0,0,87
Florida,Seville,612,129,192,69,53,9,452
Florida,San Castle,3917,691,975,662,162,100,2590
Florida,Roeville,638,50,180,140,102,9,481
Florida,River Ridge,5191,441,1609,1352,446,254,4102
Florida,River Park,6818,936,1671,1693,549,243,5092
Florida,Rio Pinar,5354,263,708,1495,900,688,4054
Florida,Raleigh,482,31,152,104,22,0,309
Florida,Quail Ridge,2031,161,154,563,327,190,1395
Florida,Port LaBelle,5000,882,965,993,92,74,3006
Florida,Point Baker,3460,310,640,948,171,88,2157
Florida,Pioneer,582,34,97,157,117,61,466
Florida,Pine Level,136,0,32,6,49,6,93
Florida,Pine Air,2691,313,658,724,109,10,1814
Florida,Pea Ridge,4540,192,956,1288,405,115,2956
Florida,Patrick AFB,1506,49,123,354,210,93,829
Florida,Pasadena Hills,10216,852,2069,2388,1065,685,7059
Florida,Panacea,1001,197,191,237,78,0,703
Florida,Oakleaf Plantation,27252,1040,3975,6454,3312,2128,16909
Florida,Oakland,2953,79,533,639,402,220,1873
Florida,North DeLand,1364,35,436,354,125,40,990
Florida,Oriole Beach,1880,68,188,528,208,220,1212
Florida,Northdale,22529,867,3747,5160,4336,1941,16051
Florida,Navarre Beach,1049,13,106,215,374,226,934
Florida,Palm City,25225,815,3555,6322,5214,3140,19046
Florida,St. Augustine South,5750,454,809,1692,1114,351,4420
Florida,Baldwin,1641,272,446,232,66,50,1066
Florida,Gateway,10513,330,1359,2048,2372,1309,7418
Florida,Royal Palm Beach,38344,2354,7207,8187,6333,2259,26340
Florida,Palm Springs,24675,3938,5390,4671,1760,882,16641
Florida,White City,4566,481,1310,1024,359,52,3226
Florida,Fort Pierce South,4389,769,1427,673,110,162,3141
Florida,Port Salerno,11317,919,2565,2870,1323,692,8369
Florida,Jensen Beach,13477,674,3288,3259,2085,1189,10495
Florida,Hobe Sound,13953,1237,3186,3248,2372,914,10957
Florida,Longboat Key,7233,252,682,1502,2228,2329,6993
Florida,Big Pine Key,4887,319,1109,1325,840,380,3973
Florida,West Perrine,10491,1230,2278,1476,952,334,6270
Florida,Neptune Beach,7080,142,824,1422,1505,1099,4992
Florida,New Smyrna Beach,25770,1585,5273,7265,4555,2731,21409
Florida,Deltona,89186,6923,21696,22590,7715,2268,61192
Florida,Jacksonville Beach,23203,605,2660,4841,6151,3891,18148
Florida,Atlantic Beach,13398,589,2276,2025,3360,2087,10337
Florida,Venice Gardens,8370,340,2173,2294,1419,610,6836
Florida,South Venice,14419,794,3958,3998,1963,988,11701
Florida,South Sarasota,5316,156,897,1141,1139,889,4222
Florida,Eastpoint,2106,238,642,379,113,33,1405
Florida,Plantation,5022,168,966,1298,1382,991,4805
Florida,Gulf Gate Estates,11017,856,2613,3074,1326,981,8850
Florida,Englewood,15252,915,5566,3857,2056,1249,13643
Florida,Lehigh Acres,119205,15115,27509,21761,7124,2986,74495
Florida,Lochmoor Waterway Estates,4420,265,1085,1159,554,359,3422
Florida,Pine Island Center,2002,187,493,515,168,152,1515
Florida,Tice,5142,1517,923,565,197,158,3360
Florida,Oak Hill,1775,144,568,562,163,66,1503
Florida,Lake Helen,2746,262,753,718,306,84,2123
Florida,De Leon Springs,2642,494,717,260,170,143,1784
Florida,Daytona Beach Shores,4413,156,896,1262,1022,714,4050
Florida,Seminole Manor,2889,591,613,430,188,58,1880
Florida,Schall Circle,1446,266,266,157,92,0,781
Florida,Indian River Estates,6902,583,2173,1927,740,387,5810
Florida,Daytona Beach,66520,5659,14640,15363,7038,3768,46468
Florida,Sarasota Springs,15781,980,4570,3204,2199,901,11854
Florida,West Little River,33396,6804,8875,4908,1514,1264,23365
Florida,Sunset,15770,1390,2017,3275,2825,1757,11264
Florida,Spring Ridge,423,20,120,84,64,13,301
Florida,Richmond West,37965,3699,7254,7637,5205,2023,25818
Florida,Parker,4584,374,1203,1258,437,96,3368
Florida,Lower Grand Lagoon,4217,214,873,1352,689,268,3396
Florida,Palatka,10320,1220,2844,2036,496,188,6784
Florida,Nobleton,138,0,75,8,0,0,83
Florida,Hill 'n Dale,2634,614,760,291,58,169,1892
Florida,Pine Ridge CDP (Collier County),1809,4,294,496,358,296,1448
Florida,Naples Park,6181,423,1747,1079,952,547,4748
Florida,San Antonio,1336,54,251,304,134,133,876
Florida,Dade City,6966,845,1714,1265,533,192,4549
Florida,Crystal Springs,703,245,170,115,41,18,589
Florida,Everglades,191,6,52,42,41,22,163
Florida,Tyndall AFB,3374,35,148,505,455,267,1410
Florida,Steinhatchee,737,150,332,235,0,0,717
Florida,South Miami Heights,37861,6234,9367,5933,3441,928,25903
Florida,Sun City Center,23480,1079,6038,7592,4297,3131,22137
Florida,Sunrise,93199,7760,17942,21404,12504,5393,65003
Florida,Winter Garden,42263,2741,6441,7254,7274,4606,28316
Florida,Union Park,13254,710,2198,2796,1683,674,8061
Florida,Babson Park,1167,63,277,162,83,45,630
Florida,Asbury Lake,9510,478,1601,2680,990,393,6142
Florida,Yeehaw Junction,320,30,148,104,17,0,299
Florida,St. Cloud,49108,3863,10532,12215,4357,1355,32322
Florida,Silver Lake,1719,45,358,489,229,239,1360
Florida,Bay Hill,5066,198,398,889,1691,651,3827
Florida,Bellair-Meadowbrook Terrace,15117,1155,3259,3826,1250,411,9901
Florida,Goldenrod,13162,823,2371,3275,1993,685,9147
Florida,Forest City,14357,851,2357,3318,2665,1024,10215
Florida,Mary Esther,4251,303,842,1089,577,312,3123
Florida,Destin,13469,405,2280,3221,2568,1475,9949
Florida,Cinco Bayou,446,29,53,137,66,70,355
Florida,Beverly Beach,481,35,132,173,78,41,459
Florida,West Pensacola,21243,2217,5246,5361,1210,453,14487
Florida,Pensacola,52562,2614,7596,12225,7380,4930,34745
Florida,Myrtle Grove,16886,1238,3126,4382,1457,685,10888
Florida,Micanopy,553,55,107,152,66,57,437
Florida,Archer,1336,127,263,223,114,74,801
Florida,Ponce Inlet,3192,121,774,681,653,600,2829
Florida,Burnt Store Marina,1972,88,294,463,657,426,1928
Florida,Parkland,30471,530,2550,4353,6589,5098,19120
Florida,Pembroke Park,6625,816,1349,1205,596,309,4275
Florida,Black Diamond,753,0,163,202,161,160,686
Florida,Sorrento,343,237,60,46,0,0,343
Florida,Palm Beach Gardens,54528,2058,7354,12439,13412,8778,44041
Florida,Port St. Lucie,183762,16089,42428,44118,17690,9091,129416
Florida,Hutchinson Island South,5214,227,1774,1484,867,728,5080
Florida,North River Shores,3663,117,552,796,707,450,2622
Florida,Southgate,7338,380,1357,1574,1544,707,5562
Florida,Eatonville,2341,362,607,524,60,34,1587
Florida,Conway,13548,622,2548,3140,2453,1381,10144
Florida,North Palm Beach,12899,511,2312,2858,3097,1744,10522
Florida,Jupiter Inlet Colony,440,11,52,76,108,96,343
Florida,Juno Ridge,809,138,155,144,102,37,576
Florida,Juno Beach,3533,49,410,878,1211,750,3298
Florida,Five Points,1303,313,382,66,88,4,853
Florida,Hypoluxo,2742,129,477,828,619,370,2423
Florida,Buckhead Ridge,1851,267,610,695,94,8,1674
Florida,Indialantic,2861,62,365,800,468,514,2209
Florida,Floral City,5308,676,1766,1267,232,224,4165
Florida,Citrus Hills,7492,286,1876,1902,1608,1099,6771
Florida,Glen Ridge,244,20,88,48,26,3,185
Florida,Charlotte Park,2174,175,631,688,302,143,1939
Florida,Lauderdale Lakes,35254,5699,8618,5963,2292,1056,23628
Florida,Willow Oak,6930,667,1468,1245,492,140,4012
Florida,Lakeland Highlands,12376,293,1837,2868,2220,1664,8882
Florida,Crooked Lake Park,1912,168,468,381,99,30,1146
Florida,Middleburg,13431,1063,4229,2795,801,407,9295
Florida,Atlantis,2079,55,303,369,689,332,1748
Florida,Layton,132,4,44,51,15,8,122
Florida,Olympia Heights,14536,1555,3639,2880,1936,1132,11142
Florida,Medley,1118,272,210,206,147,50,885
Florida,Indiantown,6938,1680,1112,874,235,107,4008
Florida,Westlake,2,0,0,0,0,2,2
Florida,World Golf Village,16538,159,2158,3811,3378,2048,11554
Florida,Woodlawn Beach,2844,79,428,763,563,304,2137
Florida,Wiscon,699,135,129,221,52,9,546
Florida,Windsor,200,0,0,56,98,46,200
Florida,Whitfield CDP (Santa Rosa County),202,21,81,78,0,17,197
Florida,Whitfield CDP (Manatee County),3504,233,462,879,615,455,2644
Florida,West Lealman,15076,1725,4303,3749,1443,599,11819
Florida,Westgate,10026,2292,1441,1160,351,76,5320
Florida,West DeLand,4310,259,793,1035,628,93,2808
Florida,Waukeenah,179,27,39,39,32,4,141
Florida,Watergate,2810,237,587,628,308,142,1902
Florida,Wallace,2005,114,279,610,362,165,1530
Florida,Wacissa,349,59,105,77,5,0,246
Florida,Viera West,11116,125,1348,2542,2476,1472,7963
Florida,Viera East,11183,325,2141,2778,1927,1224,8395
Florida,Verona Walk,2334,140,513,792,571,249,2265
Florida,University CDP (Orange County),36086,1487,2663,3014,2525,1532,11221
Florida,University CDP (Hillsborough County),46359,5343,7701,7009,3895,2396,26344
Florida,Trilby,354,41,106,16,64,7,234
Florida,Tiger Point,3122,33,400,708,743,406,2290
Florida,The Acreage,39656,3250,8582,9540,4155,1754,27281
Florida,Ocean Breeze,171,64,47,36,18,6,171
Florida,DeFuniak Springs,6227,520,1329,1477,521,245,4092
Florida,Ona,739,109,331,116,0,0,556
Florida,St. George Island,730,10,85,189,219,176,679
Florida,Goulds,11453,1521,2871,1568,731,191,6882
Florida,Palm Valley,21562,362,2116,3986,5858,3647,15969
Florida,Fruit Cove,32994,470,3959,6111,7149,4025,21714
Florida,Ellenton,3820,129,856,1165,502,216,2868
Florida,Bradenton,55059,5030,13828,11935,5861,3004,39658
Florida,Gladeview,13296,2317,3069,1833,617,134,7970
Florida,Bal Harbour,3000,183,199,773,530,654,2339
Florida,Blountstown,2843,404,869,487,175,107,2042
Florida,Interlachen,1583,238,433,280,67,35,1053
Florida,Pelican Bay,5844,68,716,994,1981,2037,5796
Florida,Naples,21564,1027,2972,4456,6105,4521,19081
Florida,Naranja,10702,1269,2066,1651,662,317,5965
Florida,Lely,3508,151,812,1085,664,406,3118
Florida,Greenville,916,144,226,197,27,22,616
Florida,Zephyrhills West,5281,683,2061,1420,451,180,4795
Florida,South Bay,5116,1722,1476,618,161,80,4057
Florida,West Palm Beach,108365,11061,19492,20563,16565,10233,77914
Florida,Haines City,23400,3138,5018,4501,1285,685,14627
Florida,Samsula-Spruce Creek,5272,387,963,1201,1217,470,4238
Florida,Palm Beach Shores,1128,70,124,305,234,230,963
Florida,Edgewater,21892,1692,6570,6021,1328,1004,16615
Florida,Tequesta,6011,137,978,1283,1267,915,4580
Florida,Stacey Street,798,175,49,35,14,20,293
Florida,Estero,32220,1310,5337,7517,7404,5440,27008
Florida,Golden Gate,30104,6156,7244,3801,1758,617,19576
Georgia,Forest Park,19483,3538,4264,3123,883,153,11961
Georgia,Robins AFB,1464,28,113,203,140,110,594
Georgia,Trion,2322,484,376,340,102,58,1360
Georgia,Cornelia,4290,570,837,620,120,222,2369
Georgia,Demorest,2027,224,279,341,110,123,1077
Georgia,Andersonville,240,48,73,46,8,5,180
Georgia,Butler,1989,293,559,336,35,37,1260
Georgia,White,788,138,188,121,37,0,484
Georgia,Crawfordville,564,136,177,71,21,12,417
Georgia,Tyrone,7221,202,905,1182,1420,943,4652
Georgia,Omega,1256,271,263,164,8,5,711
Georgia,Avondale Estates,3135,23,185,397,817,976,2398
Georgia,Decatur,23054,699,1449,1716,4829,5381,14074
Georgia,Edison,1163,158,296,264,62,16,796
Georgia,Leary,628,93,144,158,44,19,458
Georgia,Twin City,1860,294,669,295,37,21,1316
Georgia,Ellijay,2918,644,676,365,254,77,2016
Georgia,Country Club Estates,8160,764,1556,1931,717,272,5240
Georgia,Panthersville,10581,1017,2538,2503,671,358,7087
Georgia,Nashville,4813,927,1351,750,174,57,3259
Georgia,Quitman,3771,618,909,614,264,159,2564
Georgia,Kings Bay Base,3348,93,312,301,130,52,888
Georgia,Bloomingdale,2726,277,823,675,186,51,2012
Georgia,Garden City,8936,999,2028,2016,536,195,5774
Georgia,Thunderbolt,2643,246,472,575,472,214,1979
Georgia,Tybee Island,3093,142,375,665,712,571,2465
Georgia,Clarkesville,1706,114,304,394,187,221,1220
Georgia,Kingston,490,83,156,80,13,2,334
Georgia,Americus,15659,1666,2771,2624,809,907,8777
Georgia,Palmetto,5089,710,1108,681,187,281,2967
Georgia,Byromville,529,128,185,70,22,16,421
Georgia,Vinings,13086,71,1046,2158,3920,2687,9882
Georgia,Social Circle,4419,735,977,915,168,213,3008
Georgia,Raoul,2937,689,883,654,112,45,2383
Georgia,Cedartown,9930,2087,2184,1147,489,170,6077
Georgia,Camak,117,18,42,30,0,2,92
Georgia,St. Marys,17921,561,3121,4479,2096,1202,11459
Georgia,Between,328,13,79,79,38,15,224
Georgia,Bethlehem,930,103,180,134,66,24,507
Georgia,Rayle,235,39,52,17,5,24,137
Georgia,Talbotton,875,140,289,146,9,15,599
Georgia,Argyle,217,44,70,47,3,3,167
Georgia,Woodland,297,77,111,46,12,5,251
Georgia,Poulan,729,161,168,158,17,13,517
Georgia,Hazlehurst,4164,593,1177,612,120,86,2588
Georgia,Wadley,1841,431,501,196,54,41,1223
Georgia,Wrightsville,3666,764,987,596,123,60,2530
Georgia,Montezuma,3117,413,754,790,55,151,2163
Georgia,Camilla,5000,881,1183,778,317,73,3232
Georgia,Pitts,383,40,101,63,3,17,224
Georgia,Attapulgus,571,130,152,62,17,3,364
Georgia,Blue Ridge,1242,224,299,286,102,50,961
Georgia,McCaysville,1353,183,338,325,90,26,962
Georgia,Ranger,137,33,37,12,0,5,87
Georgia,Tignall,457,81,170,75,30,15,371
Georgia,East Newnan,1134,240,262,213,75,15,805
Georgia,Trenton,2335,235,601,539,142,62,1579
Georgia,Blakely,4690,579,1072,703,232,89,2675
Georgia,Franklin,1001,292,243,130,37,43,745
Georgia,Stapleton,393,51,78,46,28,11,214
Georgia,East Point,34977,2543,7061,7313,3982,2618,23517
Georgia,Centralhatchee,455,73,142,59,20,16,310
Georgia,Millen,2838,527,639,535,166,75,1942
Georgia,Avera,269,15,80,61,15,2,173
Georgia,Lindale,4466,505,1340,864,228,103,3040
Georgia,Cumming,6027,805,1346,1138,644,395,4328
Georgia,Arcade,1554,268,400,250,73,94,1085
Georgia,Uvalda,527,37,148,108,18,14,325
Georgia,Talmo,295,35,81,49,28,17,210
Georgia,Warm Springs,510,85,127,102,20,24,358
Georgia,Higgston,474,94,73,46,12,23,248
Georgia,Eton,1094,162,226,176,39,42,645
Georgia,Bishop,358,11,33,54,62,48,208
Georgia,Perry,16031,1012,2865,4021,1240,821,9959
Georgia,Warner Robins,74762,4583,13195,17576,8076,5042,48472
Georgia,Dallas,13014,1049,2490,2968,829,322,7658
Georgia,Hilltop,200,85,54,20,0,0,159
Georgia,Maxeys,284,18,47,73,25,29,192
Georgia,Dillard,372,37,105,71,69,27,309
Georgia,Hiram,3897,498,753,902,449,210,2812
Georgia,Rocky Ford,209,32,53,41,9,12,147
Georgia,Thomaston,8802,1282,1492,1736,538,347,5395
Georgia,Santa Claus,195,25,44,38,13,6,126
Georgia,Sky Valley,328,16,48,92,83,57,296
Georgia,Clayton,1838,349,545,280,162,116,1452
Georgia,Evans,34379,1079,4252,6119,6371,4219,22040
Georgia,Ball Ground,1993,99,411,567,223,93,1393
Georgia,Woodstock,30362,935,3533,7150,6290,2410,20318
Georgia,Kennesaw,33700,1744,4371,6460,6057,2934,21566
Georgia,Arabi,645,133,181,135,17,0,466
Georgia,Cordele,10793,1253,2556,1637,462,291,6199
Georgia,Lake Park,855,83,192,188,84,35,582
Georgia,Lincolnton,1823,175,465,402,95,74,1211
Georgia,Walthourville,4095,163,1040,844,161,68,2276
Georgia,Hahira,2923,178,461,604,238,77,1558
Georgia,Alston,185,19,69,29,6,11,134
Georgia,Unadilla,3615,741,938,726,117,83,2605
Georgia,Hull,189,26,45,41,14,7,133
Georgia,Ailey,563,6,67,94,58,45,270
Georgia,Lexington,205,9,53,43,23,20,148
Georgia,Mountain City,1103,261,270,220,84,14,849
Georgia,Sylvania,2805,330,853,442,235,86,1946
Georgia,Shannon,1931,273,380,471,119,69,1312
Georgia,Moody AFB,1191,3,38,225,34,11,311
Georgia,Carlton,429,73,137,36,25,30,301
Georgia,Ila,405,75,103,76,19,8,281
Georgia,Mount Vernon,2519,319,620,524,106,64,1633
Georgia,Oxford,2109,245,355,256,88,100,1044
Georgia,Chickamauga,3145,124,749,673,118,192,1856
Georgia,Woodbury,1203,231,339,187,26,30,813
Georgia,Morrow,7238,1051,1623,1019,518,176,4387
Georgia,Newton,840,131,202,139,63,3,538
Georgia,Graham,301,44,115,33,8,4,204
Georgia,Sumner,491,82,144,70,12,5,313
Georgia,Rossville,3994,643,941,749,227,75,2635
Georgia,Manassas,70,2,17,18,3,9,49
Georgia,Newborn,734,181,206,103,12,42,544
Georgia,Chatsworth,4271,842,1088,721,403,149,3203
Georgia,Pine Mountain,1440,128,316,312,107,110,973
Georgia,Greenville,1093,165,278,237,27,16,723
Georgia,Gay,87,6,20,15,10,9,60
Georgia,Dexter,643,43,193,104,24,33,397
Georgia,Mansfield,445,60,116,77,13,9,275
Georgia,Brinson,226,24,58,46,23,12,163
Georgia,Bainbridge,12152,1344,2845,2150,737,517,7593
Georgia,Lovejoy,6484,416,1052,1443,751,210,3872
Georgia,Lookout Mountain,1766,9,51,163,612,348,1183
Georgia,Young Harris,1033,22,28,85,43,28,206
Georgia,Lyons,4318,476,994,777,176,95,2518
Georgia,Cleveland,3834,218,757,939,315,90,2319
Georgia,Reidsville,2642,228,862,439,101,114,1744
Georgia,Deepstep,125,4,20,31,30,12,97
Georgia,Sunnyside,1121,63,190,359,159,53,824
Georgia,Sunset Village,747,159,202,147,94,11,613
Georgia,Phillipsburg,922,81,236,227,0,0,544
Georgia,Calhoun,16708,2892,2874,2833,1263,732,10594
Georgia,Abbeville,2792,579,1124,494,83,18,2298
Georgia,Pineview,525,62,158,75,6,12,313
Georgia,Lakeview Estates,2697,729,349,112,8,0,1198
Georgia,Fairburn,14708,917,2857,2524,1363,521,8182
Georgia,Lyerly,541,130,182,81,6,7,406
Georgia,Gillsville,227,19,53,41,25,15,153
Georgia,Fort Gaines,1010,132,255,184,24,26,621
Georgia,Jasper,3796,526,893,818,349,109,2695
Georgia,Ideal,364,115,93,88,12,4,312
Georgia,Dearing,680,87,106,146,29,25,393
Georgia,Norcross,16369,2913,2310,2245,1605,931,10004
Georgia,Taylorsville,238,26,70,41,24,3,164
Georgia,Emerson,1685,237,296,295,196,112,1136
Georgia,Nicholls,3870,1137,1486,624,42,47,3336
Georgia,Cartersville,20467,2096,3973,4089,2451,1042,13651
Georgia,Gainesville,38624,6098,5976,5245,3540,2281,23140
Georgia,Sunny Side,160,13,21,15,12,0,61
Georgia,Oakwood,4124,497,734,1022,156,164,2573
Georgia,Conley,6002,1228,1236,1046,458,82,4050
Georgia,Sycamore,868,149,246,126,40,0,561
Georgia,Soperton,3073,559,992,350,174,104,2179
Georgia,Avalon,185,33,35,38,27,5,138
Georgia,Moreland,408,31,138,83,22,18,292
Georgia,Manchester,3977,397,1205,786,120,96,2604
Georgia,Plains,658,122,159,154,35,39,509
Georgia,Ellaville,1788,234,395,348,73,26,1076
Georgia,Waverly Hall,908,121,281,202,60,38,702
Georgia,Hamilton,1549,111,255,341,168,64,939
Georgia,Waco,440,61,142,79,15,10,307
Georgia,Broxton,1254,218,273,187,59,18,755
Georgia,College Park,14819,1276,2959,3043,1606,788,9672
Georgia,Adairsville,4792,500,1040,890,312,164,2906
Georgia,Arlington,1656,228,346,287,67,60,988
Georgia,Jefferson,10693,1283,1757,2424,1132,652,7248
Georgia,Ludowici,2605,211,543,513,190,198,1655
Georgia,Midway,2077,156,334,535,151,111,1287
Georgia,Fort Valley,8740,1091,1191,1415,446,295,4438
Georgia,Cobbtown,366,50,120,86,17,8,281
Georgia,Sylvester,5926,681,1307,985,167,234,3374
Georgia,Collins,573,75,100,81,37,34,327
Georgia,Baconton,1001,88,167,203,28,9,495
Georgia,Dublin,15869,1716,4374,2702,834,773,10399
Georgia,Colquitt,2194,343,624,494,38,37,1536
Georgia,North High Shoals,707,72,97,103,94,92,458
Georgia,Zebulon,1196,136,331,231,47,35,780
Georgia,Tallulah Falls,100,7,8,35,3,3,56
Georgia,Clermont,902,91,209,233,76,46,655
Georgia,Richland,1637,296,611,195,94,42,1238
Georgia,Euharlee,4264,352,1044,897,478,146,2917
Georgia,Bonanza,3421,180,531,784,404,187,2086
Georgia,Aragon,1382,234,375,242,29,17,897
Georgia,Georgetown,13469,731,2180,2927,1915,1079,8832
Georgia,Gordon,2068,216,572,274,116,50,1228
Georgia,White Plains,219,35,73,25,37,5,175
Georgia,Summerville,4339,826,1278,642,169,32,2947
Georgia,Montgomery,4533,562,870,1043,574,196,3245
Georgia,East Ellijay,669,120,134,104,32,22,412
Georgia,Daisy,150,26,26,27,0,18,97
Georgia,Lilly,194,47,47,31,4,0,129
Georgia,Toccoa,8274,832,1885,1479,700,471,5367
Georgia,Thomasville,18546,2158,3672,3326,1851,1348,12355
Georgia,Tifton,16603,1844,3161,3083,840,629,9557
Georgia,Whigham,509,98,160,66,38,25,387
Georgia,Aldora,123,9,26,24,0,3,62
Georgia,Cadwell,489,48,137,74,7,16,282
Georgia,Marshallville,1470,222,382,272,86,54,1016
Georgia,Buena Vista,2104,425,586,266,57,114,1448
Georgia,Madison,4041,463,878,711,378,341,2771
Georgia,Lake City,2749,390,517,349,101,32,1389
Georgia,Fairmount,994,124,269,180,38,13,624
Georgia,Experiment,2853,467,840,192,34,77,1610
Georgia,Plainville,403,51,100,89,9,9,258
Georgia,Shiloh,422,57,127,78,32,7,301
Georgia,Bowersville,465,49,145,70,14,7,285
Georgia,Conyers,15882,1541,3550,2192,1622,703,9608
Georgia,Lumpkin,1142,203,337,116,84,20,760
Georgia,De Soto,175,22,24,36,6,0,88
Georgia,Leslie,589,57,116,113,38,11,335
Georgia,Portal,606,113,171,101,67,13,465
Georgia,Sandersville,5616,690,1614,861,466,179,3810
Georgia,Braselton,10509,570,1396,1697,1925,1252,6840
Georgia,Bremen,6311,286,1067,1415,696,528,3992
Georgia,Metter,3978,699,815,585,238,133,2470
Georgia,Union City,20960,1521,4102,4655,1605,787,12670
Georgia,Mount Airy,1281,186,256,239,93,40,814
Georgia,Jesup,9814,1029,3024,1817,575,282,6727
Georgia,Ocilla,3487,411,993,591,201,108,2304
Georgia,Rest Haven,179,27,36,14,17,16,110
Georgia,Willacoochee,1461,448,301,160,8,33,950
Georgia,Statham,2633,479,741,620,86,23,1949
Georgia,Hoboken,762,78,159,101,35,77,450
Georgia,Pembroke,2447,186,493,477,122,89,1367
Georgia,Indian Springs,2650,84,417,583,263,152,1499
Georgia,Mount Zion,2377,269,527,409,116,55,1376
Georgia,Vernonburg,106,2,6,7,29,33,77
Georgia,Eastman,5209,531,1157,1065,339,132,3224
Georgia,Pavo,598,91,197,127,17,7,439
Georgia,Fort Oglethorpe,9852,868,2386,2707,661,381,7003
Georgia,Ringgold,3563,350,834,1032,329,113,2658
Georgia,Kingsland,16784,727,3479,3467,1833,644,10150
Georgia,Monticello,2630,266,678,451,179,152,1726
Georgia,Denton,149,28,58,24,0,5,115
Georgia,Leesburg,2982,177,504,640,181,126,1628
Georgia,East Dublin,2725,296,819,381,143,29,1668
Georgia,Pelham,3609,657,830,524,137,62,2210
Georgia,Culloden,227,59,54,32,14,14,173
Georgia,Flemington,666,59,92,195,53,34,433
Georgia,Forsyth,4054,615,880,619,282,265,2661
Georgia,Buckhead,155,16,27,41,13,8,105
Georgia,Stockbridge,28648,2127,4263,5679,4108,1915,18092
Georgia,Fort Stewart,9326,130,863,1629,394,175,3191
Georgia,Darien,2500,295,667,527,84,99,1672
Georgia,Sharon,140,54,58,15,3,0,130
Georgia,Covington,13844,1263,2980,2815,844,701,8603
Georgia,Buford,15185,2193,3103,2099,1584,626,9605
Georgia,Crawford,943,278,198,81,21,35,613
Georgia,Homerville,2442,456,644,355,42,14,1511
Georgia,Tunnel Hill,1317,162,322,246,99,28,857
Georgia,Nahunta,775,204,188,117,30,12,551
Georgia,Davisboro,1903,472,716,340,47,16,1591
Georgia,Flovilla,878,148,287,72,12,6,525
Georgia,Harrison,492,92,167,52,17,1,329
Georgia,Scotland,477,49,205,49,1,2,306
Georgia,Lakeview,5147,521,1623,825,372,71,3412
Georgia,Temple,4366,331,1108,762,416,146,2763
Georgia,Fargo,273,71,54,43,9,0,177
Georgia,Springfield,3526,301,992,563,203,237,2296
Georgia,Canton,27127,2824,4155,5478,3548,1176,17181
Georgia,Suwanee,19215,482,2207,3063,4444,2638,12834
Georgia,Hogansville,3085,486,858,496,79,87,2006
Georgia,Ashburn,3691,546,1135,652,140,126,2599
Georgia,Lilburn,12561,1953,2146,1776,1518,850,8243
Georgia,Mountain Park,13877,876,1445,3119,2333,1242,9015
Georgia,Pearson,2036,416,435,231,43,12,1137
Georgia,Auburn,7303,1109,1524,1536,562,117,4848
Georgia,Winder,15827,1794,3782,2987,972,588,10123
Georgia,Fitzgerald,8865,951,2470,1430,505,358,5714
Georgia,Bowdon,2134,474,366,422,94,82,1438
Georgia,Savannah,145342,12128,24822,30211,16022,10254,93437
Georgia,Haralson,165,24,39,42,5,14,124
Georgia,Ochlocknee,633,152,121,130,19,7,429
Georgia,Ty Ty,966,141,231,175,41,12,600
Georgia,Danville,200,39,70,13,11,5,138
Georgia,Oconee,370,40,173,45,11,5,274
Georgia,Dacula,5644,528,1318,1127,520,243,3736
Georgia,Warrenton,1976,442,646,217,47,99,1451
Georgia,Cairo,9528,1575,2477,1733,474,313,6572
Georgia,Shady Dale,437,134,49,29,7,4,223
Georgia,Louisville,2628,424,707,360,122,100,1713
Georgia,Reed Creek,2535,259,677,663,339,146,2084
Georgia,Rockmart,4244,314,1013,823,206,49,2405
Georgia,Iron City,254,34,57,67,18,15,191
Georgia,East Griffin,1316,196,451,216,28,5,896
Georgia,Griffin,22725,3048,5450,3651,1538,854,14541
Georgia,Glennville,5078,862,1174,819,346,251,3452
Georgia,Lumber City,1230,233,468,108,84,33,926
Georgia,Helen,390,18,86,124,80,41,349
Georgia,Parrott,139,37,47,18,18,5,125
Georgia,Vidalia,10473,1304,2611,1723,685,711,7034
Georgia,Screven,1065,189,329,169,28,13,728
Georgia,Warwick,424,94,89,98,3,2,286
Georgia,Irondale,8578,760,1625,1610,474,370,4839
Georgia,Chattanooga Valley,3727,703,811,738,257,185,2694
Georgia,Jonesboro,4737,742,1264,749,314,153,3222
Georgia,Bronwood,271,61,73,45,6,12,197
Georgia,Dawson,4222,648,800,831,148,155,2582
Georgia,Washington,3975,430,1286,738,193,151,2798
Georgia,Rome,36185,5379,6451,5983,3149,2542,23504
Georgia,Gray,3261,229,637,710,423,150,2149
Georgia,Hinesville,33258,1484,5936,8455,2589,1281,19745
Georgia,Dasher,859,100,157,177,70,41,545
Georgia,Valdosta,56074,5120,9433,8360,4832,3839,31584
Georgia,Comer,1320,128,275,249,184,77,913
Georgia,Danielsville,816,110,174,154,62,59,559
Georgia,Martin,546,74,153,87,90,10,414
Georgia,Adrian,558,128,112,74,9,12,335
Georgia,Buchanan,1435,277,358,255,34,4,928
Georgia,Douglasville,33210,2229,5117,7200,3895,2832,21273
Georgia,Climax,178,19,72,36,9,9,145
Georgia,Riverdale,16289,1305,3513,3533,1608,594,10553
Georgia,Wrens,2295,440,467,365,172,49,1493
Georgia,Milner,954,98,253,205,50,110,716
Georgia,Smithville,683,101,249,110,22,10,492
Georgia,Dudley,857,62,216,190,66,38,572
Georgia,Montrose,280,18,59,59,5,0,141
Georgia,Dahlonega,6556,380,179,1004,869,394,2826
Georgia,Morven,775,179,185,135,13,12,524
Georgia,Alma,3474,512,854,721,118,76,2281
Georgia,Enigma,925,176,282,115,16,8,597
Georgia,Ray City,1076,52,299,193,42,52,638
Georgia,Richmond Hill,12203,436,1600,2705,1489,1066,7296
Georgia,Folkston,4951,991,1280,638,82,148,3139
Georgia,Homeland,939,172,248,125,61,24,630
Georgia,Alapaha,814,151,258,162,44,4,619
Georgia,Carrollton,26397,2637,3200,4010,2402,1801,14050
Georgia,Port Wentworth,7946,215,1889,1689,913,531,5237
Georgia,Du Pont,173,43,66,19,2,0,130
Georgia,Sharpsburg,402,48,87,103,44,10,292
Georgia,Grantville,3219,368,811,519,154,100,1952
Georgia,Newnan,37818,3232,6238,7674,4841,2367,24352
Georgia,Senoia,4160,333,429,804,715,381,2662
Georgia,LaGrange,30412,3740,5986,5726,2457,1159,19068
Georgia,West Point,3554,507,516,980,238,128,2369
Georgia,Lincoln Park,389,179,116,72,22,0,389
Georgia,Deenwood,2588,137,904,488,117,103,1749
Georgia,Duluth,29239,1844,3708,5552,6185,2858,20147
Georgia,Loganville,11665,865,2182,2847,1119,508,7521
Georgia,Hapeville,6581,904,1275,1168,830,317,4494
Georgia,Isle of Hope,2539,51,157,438,780,432,1858
Georgia,Oak Park,717,190,119,96,5,6,416
Georgia,Candler-McAfee,24022,2761,5739,4751,2314,1229,16794
Georgia,Snellville,19631,845,3460,4817,3047,1425,13594
Georgia,Tallapoosa,3133,346,774,581,193,228,2122
Georgia,Hartwell,4411,895,1002,674,145,181,2897
Georgia,Talking Rock,139,11,28,41,13,1,94
Georgia,Meigs,989,177,233,187,15,18,630
Georgia,Orchard Hill,250,63,41,35,7,6,152
Georgia,Geneva,162,20,82,38,2,0,142
Georgia,Junction City,203,29,55,47,0,1,132
Georgia,Rochelle,961,87,347,143,87,34,698
Georgia,Turin,571,31,65,146,96,32,370
Georgia,Boston,1325,160,343,239,76,49,867
Georgia,Monroe,13370,1896,3453,1588,800,249,7986
Georgia,Irwinton,567,41,201,77,20,7,346
Georgia,Hannahs Mill,3372,482,1081,645,92,43,2343
Georgia,Norwood,242,72,45,30,26,9,182
Georgia,Riddleville,46,7,11,5,9,0,32
Georgia,Tennille,1722,267,454,302,63,36,1122
Georgia,Glenwood,713,71,199,92,12,7,381
Georgia,Berkeley Lake,1994,23,144,369,562,365,1463
Georgia,Grayson,3658,189,534,708,596,502,2529
Georgia,Lawrenceville,29401,2993,5354,6151,2510,1596,18604
Georgia,Varnell,2156,250,381,425,166,123,1345
Georgia,Milledgeville,18813,1670,3898,2266,1002,809,9645
Georgia,Carl,235,34,46,51,13,15,159
Georgia,Cochran,4869,464,832,667,260,247,2470
Georgia,Unionville,2183,535,408,195,12,80,1230
Georgia,Jeffersonville,1127,269,328,208,37,28,870
Georgia,McIntyre,678,103,304,85,16,8,516
Georgia,Roswell,94257,4208,9240,14471,23804,12574,64297
Georgia,Blairsville,625,125,177,142,23,15,482
Georgia,Alpharetta,64672,1549,4230,8689,17139,11688,43295
Georgia,Coolidge,416,77,55,112,9,4,257
Georgia,Register,116,17,13,18,24,3,75
Georgia,Statesboro,31001,2080,3127,3945,1884,1514,12550
Georgia,North Druid Hills,17287,391,1503,2013,4936,4278,13121
Georgia,Midville,329,34,96,73,9,8,220
Georgia,Pulaski,309,69,98,25,27,17,236
Georgia,Gresham Park,8694,992,2118,1633,1048,528,6319
Georgia,Pinehurst,423,68,138,91,22,6,325
Georgia,Jakin,197,12,69,41,13,1,136
Georgia,Elberton,4383,613,1147,913,233,115,3021
Georgia,Martinez,36068,1868,6306,8019,5230,3630,25053
Georgia,Fair Oaks,9173,2084,1360,1411,518,121,5494
Georgia,Powder Springs,14945,721,2310,3508,2521,927,9987
Georgia,Brooks,509,16,112,112,83,48,371
Georgia,Doerun,649,102,141,132,12,17,404
Georgia,Sparta,1854,338,524,261,82,50,1255
Georgia,Blackshear,3485,278,1161,753,204,163,2559
Georgia,Patterson,647,52,202,168,50,21,493
Georgia,Eatonton,6529,735,1836,855,299,203,3928
Georgia,Waynesboro,5558,475,1184,850,329,317,3155
Georgia,Doraville,10471,2312,1561,1036,1087,505,6501
Georgia,Pooler,23102,1355,3440,5154,3834,2045,15828
Georgia,Skidaway Island,8783,65,830,1636,2600,2492,7623
Georgia,Sparks,2261,391,569,339,70,36,1405
Georgia,Rhine,499,94,152,80,4,35,365
Georgia,Bowman,849,191,224,101,49,15,580
Georgia,Grovetown,13658,943,2265,3254,1626,542,8630
Georgia,Harlem,3054,261,572,788,162,99,1882
Georgia,Waleska,727,15,46,56,19,8,144
Georgia,Salem,407,102,154,61,18,0,335
Georgia,St. Simons,14302,351,1513,2865,4106,2771,11606
Georgia,Yatesville,424,57,103,117,12,18,307
Georgia,Remerton,1224,18,143,141,79,32,413
Georgia,Hoschton,1567,135,316,387,120,81,1039
Georgia,Gumbranch,209,12,90,32,2,0,136
Georgia,Riceboro,641,118,196,115,29,11,469
Georgia,Colbert,624,51,205,146,38,26,466
Georgia,Luthersville,805,181,229,147,16,16,589
Georgia,Byron,5108,356,914,1623,400,382,3675
Georgia,Cuthbert,3581,621,833,510,94,70,2128
Georgia,Shellman,1147,185,212,270,51,19,737
Georgia,Hephzibah,3973,525,1015,893,220,138,2791
Georgia,Oliver,382,51,150,37,5,1,244
Georgia,Meansville,99,10,18,32,7,10,77
Georgia,Tiger,512,65,152,119,28,24,388
Georgia,Sasser,338,44,49,92,5,16,206
Georgia,Fairview,6518,980,1808,1287,519,121,4715
Georgia,Albany,74631,8515,13314,15190,5431,3970,46420
Georgia,Bartow,268,55,66,53,23,0,197
Georgia,Barnesville,6608,516,1464,1027,279,211,3497
Georgia,Thomson,6603,995,1552,1212,196,210,4165
Georgia,Oglethorpe,1288,296,285,307,54,3,945
Georgia,Rutledge,928,180,203,164,51,44,642
Georgia,Locust Grove,6540,665,1537,1122,492,255,4071
Georgia,McDonough,24102,1524,4501,5042,2617,1534,15218
Georgia,Nicholson,1781,238,385,376,72,54,1125
Georgia,Sugar Hill,22314,1672,3492,3539,3441,1859,14003
Georgia,Lakeland,3271,621,800,259,152,116,1948
Georgia,Putney,2250,303,574,549,133,137,1696
Georgia,Hampton,7604,515,1802,1899,342,221,4779
Georgia,Newington,276,7,91,35,22,10,165
Georgia,Molena,468,47,85,130,20,25,307
Georgia,Arnoldsville,429,42,120,87,12,34,295
Georgia,Waycross,13836,1450,3577,2744,726,420,8917
Georgia,Dock Junction,8478,1370,2147,1868,462,229,6076
Georgia,Morgan,2055,564,853,314,30,28,1789
Georgia,Redan,32357,2072,5804,7694,4077,1744,21391
Georgia,Stone Mountain,6251,551,1283,1255,721,391,4201
Georgia,Mitchell,197,25,56,49,6,2,138
Georgia,Alto,1308,381,171,144,31,14,741
Georgia,Menlo,439,58,140,77,4,29,308
Georgia,Douglas,11556,1333,2573,1679,591,385,6561
Georgia,Royston,2997,495,749,459,184,63,1950
Georgia,Brunswick,16034,1895,3090,3504,1034,714,10237
Georgia,Woodville,355,87,123,46,21,16,293
Georgia,Baldwin,3482,651,587,314,122,93,1767
Georgia,Dalton,33458,7608,4360,4617,2729,1317,20631
Georgia,Maysville,2307,314,526,527,98,37,1502
Georgia,Hawkinsville,5310,907,1396,1052,337,235,3927
Georgia,Belvedere Park,15543,1918,3526,2966,2024,1051,11485
Georgia,Holly Springs,11469,475,1608,2092,2399,842,7416
Georgia,Druid Hills,8244,86,210,475,2170,3120,6061
Georgia,Guyton,2309,204,534,418,105,63,1324
Georgia,Bellville,145,1,37,34,21,26,119
Georgia,Dawsonville,2772,243,534,619,250,153,1799
Georgia,Cave Spring,1128,129,238,276,73,64,780
Georgia,Woolsey,198,8,35,39,26,18,126
Georgia,Carnesville,743,77,217,167,48,15,524
Georgia,Franklin Springs,900,64,69,181,61,79,454
Georgia,Commerce,6742,1082,1666,1239,443,291,4721
Georgia,Lone Oak,79,13,31,25,2,4,75
Georgia,Ellenton,156,52,29,31,5,10,127
Georgia,Fayetteville,17349,837,3134,3377,3254,1724,12326
Georgia,Donalsonville,2589,225,823,471,130,36,1685
Georgia,Gumlog,2236,292,490,547,183,150,1662
Georgia,Summertown,180,29,40,33,11,2,115
Georgia,Whitesburg,743,158,201,118,37,4,518
Georgia,Tarrytown,44,5,9,10,1,7,32
Georgia,Toomsboro,508,104,158,95,13,10,380
Georgia,Walnut Grove,1422,92,337,367,65,17,878
Georgia,Williamson,586,75,135,118,28,22,378
Georgia,Athens-Clarke County unified government (balance),123310,8898,14404,15980,14355,14868,68505
Georgia,Augusta-Richmond County consolidated government (balance),196807,21155,39127,40060,16705,10827,127874
Georgia,Johns Creek,83637,2002,6105,10022,22514,14868,55511
Georgia,Milton,38171,908,2134,4312,10528,6536,24418
Georgia,Russell,1229,154,335,184,21,0,694
Georgia,Cusseta-Chattahoochee County unified governm,10767,350,1263,1638,1209,418,4878
Georgia,Georgetown-Quitman County unified governm,2276,562,594,419,117,41,1733
Georgia,Boykin,52,15,4,33,0,0,52
Georgia,Calvary,110,5,0,43,8,16,72
Georgia,Stillmore,535,101,140,98,14,0,353
Georgia,Sardis,750,171,154,107,43,22,497
Georgia,Sandy Springs,105411,4170,9943,13700,29747,18223,75783
Georgia,Sale City,438,38,125,73,13,5,254
Georgia,Nunez,169,50,38,23,2,13,126
Georgia,Odum,506,91,142,82,32,15,362
Georgia,Pendergrass,487,72,109,129,54,11,375
Georgia,Allentown,123,13,41,4,3,13,74
Georgia,Porterdale,1742,362,393,259,42,46,1102
Georgia,Watkinsville,2871,135,400,540,444,341,1860
Georgia,Chattahoochee Hills,2867,374,697,503,358,260,2192
Georgia,Canoochee,125,0,61,30,5,0,96
Georgia,Webster County unified governm,2613,405,809,379,125,86,1804
Georgia,Allenhurst,915,73,191,125,107,47,543
Georgia,Barwick,296,34,74,51,19,14,192
Georgia,Rebecca,237,34,60,32,5,12,143
Georgia,Rentz,285,16,118,49,3,5,191
Georgia,Resaca,960,211,165,214,28,16,634
Georgia,Reynolds,1119,170,213,245,75,33,736
Georgia,Rincon,9863,649,1616,2275,1202,366,6108
Georgia,Alamo,3362,566,918,374,500,58,2416
Georgia,Morganton,277,46,81,55,18,6,206
Georgia,Cedar Springs,122,49,35,11,12,5,112
Georgia,Coleman,19,0,0,6,6,0,12
Georgia,Seville,116,53,14,13,26,0,106
Georgia,Talahi Island,1406,41,152,406,351,171,1121
Georgia,Tate City,0,0,0,0,0,0,0
Georgia,The Rock,203,6,14,43,46,16,125
Georgia,Yonah,586,91,69,194,107,0,461
Georgia,Echols County consolidated governm,3994,807,1081,694,166,84,2832
Georgia,Stonecrest,53772,2817,8346,12948,6708,3256,34075
Georgia,Tucker,35692,2447,4483,6913,7542,5727,27112
Georgia,South Fulton,94912,3992,15775,19314,13939,9410,62430
Georgia,Appling,1010,164,147,71,100,82,564
Georgia,Brookhaven,53140,4408,4278,4264,13722,10710,37382
Georgia,Peachtree Corners,42463,1991,4588,7052,9499,5517,28647
Georgia,Peachtree City,35165,738,3355,6156,8584,5033,23866
Georgia,Sautee-Nacoochee,178,19,28,36,41,33,157
Georgia,McRae-Helena,8538,2276,2630,949,211,187,6253
Georgia,Satilla,376,69,147,38,0,0,254
Georgia,Rockingham,102,12,45,23,0,0,80
Georgia,Perkins,225,0,43,54,0,0,97
Georgia,Norristown,84,10,29,0,0,0,39
Georgia,Crooked Creek,497,18,137,149,30,0,334
Georgia,Dewy Rose,129,94,10,6,19,0,129
Georgia,Dunwoody,49016,1186,3274,5030,13374,10924,33788
Georgia,Dutch Island,1013,10,47,156,261,313,787
Georgia,Eagle Grove,0,0,0,0,0,0,0
Georgia,Empire,387,78,213,37,10,0,338
Georgia,Epworth,182,18,57,55,26,26,182
Georgia,Cherry Log,47,0,25,8,0,0,33
Georgia,Hardwick,3431,682,1038,493,92,62,2367
Georgia,Heron Bay,3195,61,237,455,856,348,1957
Georgia,Howard,0,0,0,0,0,0,0
Georgia,Jenkinsburg,312,26,90,47,16,23,202
Georgia,Knoxville,64,24,24,16,0,0,64
Georgia,Matthews,194,50,69,0,0,0,119
Georgia,Mendes,59,0,22,22,0,0,44
Georgia,Mineral Bluff,335,0,83,67,11,28,189
Georgia,Henderson,1853,40,187,287,417,386,1317
Georgia,Milan,805,177,238,93,32,23,563
Georgia,Macon-Bibb,153490,14227,31489,28431,15062,10554,99763
Georgia,LaFayette,7191,1318,1882,1474,411,167,5252
Georgia,Adel,5290,527,1082,1149,313,305,3376
Georgia,Roberta,909,124,182,169,39,39,553
Georgia,Chester,2121,498,1025,275,35,17,1850
Georgia,Vienna,3737,691,1232,491,154,164,2732
Georgia,Claxton,2359,272,511,477,154,97,1511
Georgia,Hagan,1141,186,239,114,85,63,687
Georgia,Mountain Park,625,8,53,73,199,108,441
Georgia,Nelson,1573,167,283,366,159,42,1017
Georgia,Acworth,22336,992,3542,4845,3393,1723,14495
Georgia,Marietta,60410,5550,7943,10312,10127,5190,39122
Georgia,Smyrna,55976,2907,5745,9709,12725,8613,39699
Georgia,Dooling,169,36,18,16,13,6,89
Georgia,Austell,7276,746,1503,1424,820,357,4850
Georgia,Mableton,40464,3382,6596,6732,5960,3662,26332
Georgia,Canon,1002,239,237,121,8,3,608
Georgia,Wilmington Island,15391,461,2251,3684,2941,1650,10987
Georgia,Villa Rica,15124,934,2597,2642,1679,1029,8881
Georgia,Roopville,271,16,64,54,16,16,166
Georgia,Woodbine,1585,130,303,386,88,66,973
Georgia,Lithia Springs,17216,1564,3948,2765,1983,749,11009
Georgia,Union Point,1837,316,551,284,26,33,1210
Georgia,Baxley,4697,928,1170,787,147,92,3124
Georgia,Winterville,1123,47,205,217,217,174,860
Georgia,Edge Hill,14,0,8,6,0,0,14
Georgia,Lula,2880,366,524,648,142,104,1784
Georgia,Moultrie,14109,2309,3235,1648,746,688,8626
Georgia,Lavonia,2131,358,628,336,168,48,1538
Georgia,Norman Park,1024,169,248,165,39,34,655
Georgia,Chamblee,28748,4716,3452,3109,5309,3135,19721
Georgia,Clarkston,12762,2543,1504,1641,1196,483,7367
Georgia,Lithonia,2445,193,436,423,131,39,1222
Georgia,Pine Lake,747,9,159,144,213,104,629
Georgia,North Decatur,17298,948,1119,2052,4914,4263,13296
Georgia,Scottdale,10698,868,1640,1809,1529,1530,7376
Georgia,Whitemarsh Island,7058,125,740,1394,1552,994,4805
Georgia,Girard,188,27,38,38,2,1,106
Georgia,Siloam,399,73,99,53,7,5,237
Georgia,Centerville,7671,576,1250,2024,764,586,5200
Georgia,Greensboro,3356,549,977,454,113,60,2153
Georgia,Cohutta,539,56,105,125,67,25,378
Georgia,Concord,298,23,58,61,16,22,180
Georgia,Damascus,291,49,68,69,19,5,210
Georgia,Flowery Branch,7151,262,1114,1763,1409,542,5090
Georgia,Funston,618,70,198,59,24,7,358
Georgia,Garfield,142,16,53,30,5,1,105
Georgia,Good Hope,364,28,88,101,65,14,296
Georgia,Hiawassee,753,96,188,171,126,104,685
Georgia,Hiltonia,438,88,129,58,5,12,292
Georgia,Ivey,939,83,274,163,55,17,592
Georgia,Jacksonville,80,19,31,17,8,0,75
Georgia,Jersey,78,10,21,18,10,2,61
Georgia,Kite,290,43,71,33,0,1,148
Georgia,Keysville,169,27,53,35,4,2,121
Georgia,Swainsboro,7347,930,1799,881,228,325,4163
Georgia,Chauncey,369,30,148,32,3,15,228
Georgia,Cecil,343,53,85,84,27,4,253
Georgia,Ephesus,316,35,87,76,30,25,253
Georgia,Braswell,455,65,93,59,35,20,272
Georgia,Jackson,4999,702,1515,664,277,126,3284
Georgia,Surrency,293,73,68,53,8,0,202
Georgia,Brooklet,1751,89,344,378,173,164,1148
Georgia,Vidette,186,14,72,22,6,5,119
Georgia,Atlanta,479655,31325,62436,67722,89409,71636,322528
Georgia,Bogart,1390,58,326,244,172,130,930
Georgia,Bluffton,68,19,3,18,4,5,49
Georgia,Gibson,696,188,213,114,38,1,554
Georgia,Homer,1269,220,330,203,84,47,884
Georgia,Offerman,474,108,97,67,7,7,286
Georgia,Bostwick,294,40,63,43,31,20,197
Georgia,Blythe,700,86,181,140,44,20,471
Georgia,Columbus,196670,16128,34761,43169,20649,12703,127410
Georgia,Lenox,789,171,220,112,40,11,554
Georgia,Berlin,679,141,179,106,15,17,458
Georgia,Ambrose,354,97,87,32,4,4,224
Hawaii,Napili-Honokowai,7258,569,1729,1826,1064,344,5532
Hawaii,Laie,6111,58,524,981,715,408,2686
Hawaii,Kaneohe,33739,1234,7042,7308,6257,3110,24951
Hawaii,Kailua CDP (Honolulu County),36662,1042,5465,7197,7329,5727,26760
Hawaii,Kaaawa,1181,32,196,286,199,112,825
Hawaii,Makaha Valley,1636,58,351,372,107,100,988
Hawaii,Hauula,3549,157,727,553,401,254,2092
Hawaii,Koloa,2859,142,777,476,240,122,1757
Hawaii,Princeville,1952,21,256,395,537,199,1408
Hawaii,Kekaha,3394,284,810,905,265,138,2402
Hawaii,Wailua Homesteads,5900,310,1069,1644,1155,498,4676
Hawaii,Wailuku,17354,826,3189,4736,1971,1165,11887
Hawaii,Waihee-Waiehu,8802,520,2261,2035,640,425,5881
Hawaii,Mokuleia,1807,41,179,457,358,214,1249
Hawaii,Ewa Gentry,25752,876,4688,6750,3556,1160,17030
Hawaii,Waipio,11508,398,2262,3224,1815,783,8482
Hawaii,Wheeler AFB,2391,25,147,573,242,99,1086
Hawaii,Waimea CDP (Hawaii County),11687,520,2404,2454,1618,955,7951
Hawaii,Kawela Bay,249,4,25,63,56,60,208
Hawaii,Punaluu,1186,77,211,260,156,81,785
Hawaii,Fern Forest,819,45,209,227,62,26,569
Hawaii,Kahuku,2245,94,571,421,242,65,1393
Hawaii,Pepeekeo,1536,133,384,412,136,60,1125
Hawaii,Haleiwa,4040,367,994,1019,409,121,2910
Hawaii,Heeia,4669,93,938,1002,1026,697,3756
Hawaii,Makaha,8740,597,2432,1415,680,332,5456
Hawaii,Waimalu,13384,532,2697,3820,2167,932,10148
Hawaii,Anahola,2175,153,729,410,104,58,1454
Hawaii,Eden Roc,799,93,185,256,23,7,564
Hawaii,Hawaiian Paradise Park,11479,676,2376,2995,1671,453,8171
Hawaii,Hilo,46284,2159,9059,9577,7270,3378,31443
Hawaii,Kurtistown,1319,32,388,342,224,21,1007
Hawaii,Mountain View,3269,60,602,879,353,288,2182
Hawaii,Hana,956,25,269,151,91,64,600
Hawaii,Kaanapali,922,12,149,280,229,192,862
Hawaii,Kilauea,2579,141,374,664,293,267,1739
Hawaii,Pahala,1804,179,484,260,171,30,1124
Hawaii,Keaau,2493,147,635,618,276,78,1754
Hawaii,Kapaa,10544,452,2421,2315,1809,764,7761
Hawaii,Haiku-Pauwela,8061,462,1938,1300,1680,661,6041
Hawaii,Kahului,32312,3067,8158,6780,2814,899,21718
Hawaii,Mililani Town,27926,841,4641,7036,4954,2021,19493
Hawaii,Wahiawa,17422,1234,3848,4082,2000,683,11847
Hawaii,Honaunau-Napoopoo,2457,194,348,608,451,252,1853
Hawaii,Kaunakakai,3719,161,1157,747,311,183,2559
Hawaii,Kapaau,1770,89,555,379,160,68,1251
Hawaii,Nanawale Estates,1995,165,547,486,104,77,1379
Hawaii,Papaikou,1052,102,322,143,124,37,728
Hawaii,Paukaa,569,25,88,181,110,79,483
Hawaii,Ewa Villages,7118,869,1319,1531,599,103,4421
Hawaii,Kihei,21879,864,4630,5792,3171,1321,15778
Hawaii,Waikoloa Village,6412,222,869,1613,1159,368,4231
Hawaii,Halawa,14640,666,3351,3386,2186,879,10468
Hawaii,Ewa Beach,14717,1290,3717,3190,1312,304,9813
Hawaii,Aiea,9439,280,1600,2417,1389,906,6592
Hawaii,Ahuimanu,8239,162,1329,2116,1361,902,5870
Hawaii,Kukuihaele,349,4,97,95,21,17,234
Hawaii,Kealakekua,1889,149,413,434,377,69,1442
Hawaii,Holualoa,9136,373,1006,2695,1744,1068,6886
Hawaii,Hawaiian Ocean View,4891,271,1304,751,393,180,2899
Hawaii,Fern Acres,1601,128,472,349,142,73,1164
Hawaii,Ainaloa,3342,256,925,827,88,173,2269
Hawaii,Schofield Barracks,19796,152,1713,4056,1160,378,7459
Hawaii,Pahoa,896,31,290,166,104,55,646
Hawaii,Pearl City,46129,2147,9219,11125,6930,3197,32618
Hawaii,Wailua,2742,138,498,637,386,229,1888
Hawaii,Puhi,3911,319,933,915,276,168,2611
Hawaii,Kalaheo,5224,50,585,1213,1086,539,3473
Hawaii,Hanamaulu,5422,641,1434,1056,346,74,3551
Hawaii,Waikapu,3483,113,587,791,431,219,2141
Hawaii,Maunaloa,365,17,92,71,8,5,193
Hawaii,Pakala Village,294,25,90,59,11,5,190
Hawaii,Kahaluu,4339,190,1052,1035,513,423,3213
Hawaii,Paauilo,627,69,245,123,23,8,468
Hawaii,Lihue,7381,523,1920,1434,1018,436,5331
Hawaii,Kahaluu-Keauhou,4002,175,785,1013,938,457,3368
Hawaii,Pukalani,7769,355,1896,1997,1037,639,5924
Hawaii,Hanalei,267,11,52,59,37,27,186
Hawaii,Poipu,995,9,128,256,254,187,834
Hawaii,Waimea CDP (Kauai County),1952,211,442,508,341,67,1569
Hawaii,Hickam Housing,9258,51,556,1853,1102,903,4465
Hawaii,Iroquois Point,3550,51,421,945,528,194,2139
Hawaii,Kaneohe Station,11075,66,885,1616,929,396,3892
Hawaii,Maunawili,2023,23,167,386,518,442,1536
Hawaii,Waimanalo Beach,3826,176,1162,764,325,257,2684
Hawaii,Waipio Acres,5443,165,1129,1369,759,217,3639
Hawaii,Whitmore Village,4254,420,987,844,485,62,2798
Hawaii,Honomu,424,8,137,85,57,41,328
Hawaii,Kalaoa,11604,559,2426,2540,2215,726,8466
Hawaii,Naalehu,972,77,306,255,32,43,713
Hawaii,Orchidlands Estates,3197,256,773,714,262,102,2107
Hawaii,Paia,2412,90,483,485,372,149,1579
Hawaii,Volcano,3218,0,928,700,312,531,2471
Hawaii,Lanai City,2802,282,755,635,366,168,2206
Hawaii,Puako,884,3,68,247,249,172,739
Hawaii,Kualapuu,1771,74,466,375,113,129,1157
Hawaii,Maalaea,221,4,20,70,64,60,218
Hawaii,Nanakuli,11742,653,3653,2041,520,177,7044
Hawaii,Pupukea,4613,101,702,889,1170,516,3378
Hawaii,Waialua,3587,328,841,687,509,165,2530
Hawaii,Leilani Estates,1708,69,339,483,276,219,1386
Hawaii,Hawi,1312,72,396,301,148,45,962
Hawaii,Wainaku,1358,127,435,222,165,75,1024
Hawaii,Eleele,2970,207,597,675,365,98,1942
Hawaii,Waimanalo,6135,333,1536,1007,444,237,3557
Hawaii,Captain Cook,3987,130,811,900,414,335,2590
Hawaii,Halaula,626,53,160,141,28,32,414
Hawaii,Honalo,2162,89,608,445,184,170,1496
Hawaii,Honokaa,2301,212,654,436,166,114,1582
Hawaii,Kailua CDP (Hawaii County),15268,1316,3410,3218,1747,1004,10695
Hawaii,Haliimaile,977,149,245,185,73,18,670
Hawaii,Omao,1445,72,225,411,220,83,1011
Hawaii,Hanapepe,2870,199,688,690,391,125,2093
Hawaii,Kalihiwai,198,2,28,67,46,32,175
Hawaii,Olinda,920,10,185,234,182,138,749
Hawaii,Manele,24,0,0,8,13,3,24
Hawaii,Mililani Mauka,19955,447,1867,3925,4674,2256,13169
Hawaii,Ocean Pointe,14037,319,1513,3564,2507,916,8819
Hawaii,Olowalu,93,3,15,21,38,9,86
Hawaii,Royal Kunia,14449,810,2523,3568,2211,708,9820
Hawaii,Urban Honolulu,350003,29095,62462,73665,60366,34117,259705
Hawaii,Waikele,7062,66,815,1699,1756,668,5004
Hawaii,Wailea,5656,196,868,1450,1239,975,4728
Hawaii,Wainiha,171,5,31,36,39,5,116
Hawaii,Waiohinu,290,20,76,62,32,3,193
Hawaii,West Loch Estate,5177,208,998,1385,906,178,3675
Hawaii,Ualapue,368,4,89,103,27,30,253
Hawaii,Hawaiian Acres,2981,93,761,780,326,91,2051
Hawaii,Hawaiian Beaches,4736,216,631,1704,506,282,3339
Hawaii,Makena,168,0,29,18,54,27,128
Hawaii,Makakilo,20920,695,3653,4624,2908,1442,13322
Hawaii,Mahinahina,954,28,121,321,168,82,720
Hawaii,Launiupoko,536,9,57,148,145,77,436
Hawaii,Maili,10792,704,2696,2056,667,465,6588
Hawaii,Waianae,14054,1002,3977,2485,673,272,8409
Hawaii,Waikane,482,21,170,116,57,19,383
Hawaii,Waipahu,40427,4076,9914,8382,3951,733,27056
Hawaii,Kapalua,336,11,69,84,86,53,303
Hawaii,Lahaina,13103,950,3782,2593,1078,305,8708
Hawaii,Kaumakani,874,112,264,159,47,3,585
Hawaii,Laupahoehoe,508,24,120,118,81,41,384
Hawaii,Lawai,2211,27,388,588,364,200,1567
Hawaii,East Honolulu,47770,920,5652,8366,11964,8867,35769
Hawaii,Haena,157,0,29,50,31,27,137
Hawaii,Kalaeloa,14,1,0,0,3,5,9
Hawaii,Kapolei,21474,802,3704,4795,2866,945,13112
Hawaii,Keokea,2251,74,439,570,230,175,1488
Hawaii,Ko Olina,1625,19,181,445,391,236,1272
Hawaii,Kula,7541,57,1174,2253,1650,735,5869
Hawaii,Discovery Harbour,1140,19,196,331,142,81,769
Hawaii,Makawao,7570,256,1725,1993,1054,328,5356
Idaho,Teton,1163,177,161,211,42,32,623
Idaho,Parkline,50,2,10,25,8,0,45
Idaho,Grace,1118,109,352,212,51,18,742
Idaho,Bonners Ferry,2544,176,735,650,228,150,1939
Idaho,Grangeville,3166,159,804,803,282,142,2190
Idaho,Cottonwood,871,55,210,150,121,16,552
Idaho,St. Maries,2769,210,859,647,151,126,1993
Idaho,Payette,7394,812,1785,1881,456,118,5052
Idaho,Bliss,352,83,90,53,11,0,237
Idaho,Dubois,701,203,103,79,40,21,446
Idaho,Fairfield,442,8,100,83,28,22,241
Idaho,Castleford,205,48,42,34,4,1,129
Idaho,Middleton,7115,329,1256,1501,580,320,3986
Idaho,Greenleaf,1298,208,229,202,80,47,766
Idaho,Mountain Home,13998,817,2707,3717,994,370,8605
Idaho,Spencer,24,2,10,6,5,0,23
Idaho,Glenns Ferry,1319,182,251,317,76,4,830
Idaho,Declo,460,64,48,109,14,7,242
Idaho,Donnelly,58,5,21,26,1,1,54
Idaho,Rexburg,27957,277,1254,4845,2970,1332,10678
Idaho,Grand View,396,59,81,113,14,0,267
Idaho,Cambridge,220,30,58,67,22,3,180
Idaho,Kellogg,2442,130,560,625,116,58,1489
Idaho,Reubens,71,2,13,23,10,0,48
Idaho,Ashton,1029,157,180,165,107,14,623
Idaho,Idaho City,531,32,144,128,25,26,355
Idaho,Hazelton,739,141,144,123,26,3,437
Idaho,Elk River,135,18,56,26,11,2,113
Idaho,Lewiston,32604,1783,7694,8239,3765,1202,22683
Idaho,Carey,714,46,97,169,60,23,395
Idaho,Rupert,5782,805,1068,1099,218,100,3290
Idaho,Pocatello,55162,2764,9034,12455,6567,3283,34103
Idaho,Rockland,199,14,31,48,46,12,151
Idaho,New Plymouth,1506,144,317,412,75,42,990
Idaho,Clark Fork,455,66,164,99,25,8,362
Idaho,St. Charles,129,6,24,36,3,2,71
Idaho,Bancroft,288,20,55,93,22,6,196
Idaho,Wilder,1666,429,286,179,6,17,917
Idaho,Nampa,91663,7709,17721,19147,7048,3194,54819
Idaho,Inkom,868,26,176,221,90,29,542
Idaho,Arimo,344,6,52,106,40,8,212
Idaho,Minidoka,116,33,8,27,0,0,68
Idaho,Mackay,448,24,110,87,55,39,315
Idaho,Plummer,1230,118,273,232,45,29,697
Idaho,Salmon,3073,185,813,778,286,122,2184
Idaho,Notus,628,74,159,132,18,9,392
Idaho,Caldwell,53205,6087,10078,10333,3316,1115,30929
Idaho,Lewisville,433,28,88,118,45,6,285
Idaho,Kimberly,3759,388,760,830,273,112,2363
Idaho,Paul,1212,224,226,200,114,36,800
Idaho,Tensed,130,14,23,42,3,0,82
Idaho,Downey,767,48,191,171,46,20,476
Idaho,Emmett,6670,770,1724,1075,421,220,4210
Idaho,Fruitland,5192,665,1025,1218,206,146,3260
Idaho,Acequia,180,45,26,49,6,6,132
Idaho,Stites,227,37,65,67,11,5,185
Idaho,McCammon,731,21,153,210,82,27,493
Idaho,Hagerman,1103,74,335,223,70,7,709
Idaho,Gooding,3482,397,904,634,154,137,2226
Idaho,Soda Springs,2997,136,532,688,302,122,1780
Idaho,Filer,2736,231,430,650,209,75,1595
Idaho,Mountain Home AFB,3150,19,277,741,195,59,1291
Idaho,Moyie Springs,817,29,239,217,39,15,539
Idaho,Moscow,25174,293,1576,3482,4060,3008,12419
Idaho,Tyhee,1266,44,237,306,135,85,807
Idaho,Rathdrum,7904,548,1449,2221,572,301,5091
Idaho,Dover,611,32,64,165,132,63,456
Idaho,Kooskia,575,88,191,134,29,17,459
Idaho,Lava Hot Springs,222,32,54,45,42,9,182
Idaho,Roberts,534,116,114,61,22,8,321
Idaho,Clayton,0,0,0,0,0,0,0
Idaho,Malta,184,10,84,28,8,5,135
Idaho,Melba,739,58,153,114,44,16,385
Idaho,Victor,2435,228,257,555,443,74,1557
Idaho,Banks,7,0,0,7,0,0,7
Idaho,Bennington,265,0,27,107,39,0,173
Idaho,Blanchard,181,8,66,59,37,11,181
Idaho,Conkling Park,67,3,19,32,3,10,67
Idaho,De Smet,163,10,39,31,0,7,87
Idaho,Garden Valley,422,0,40,77,92,50,259
Idaho,Menan,740,77,139,148,71,11,446
Idaho,Groveland,865,13,166,191,101,40,511
Idaho,Lowman,25,0,5,4,9,7,25
Idaho,Moreland,1507,136,195,167,128,29,655
Idaho,Murphy,79,0,38,21,0,0,59
Idaho,Princeton,76,21,31,0,0,13,65
Idaho,Riverside,1156,100,224,243,86,30,683
Idaho,Robie Creek,1418,51,331,319,260,193,1154
Idaho,Rockford,215,35,35,32,19,8,129
Idaho,Rockford Bay,314,0,33,128,77,38,276
Idaho,Smiths Ferry,127,9,19,91,8,0,127
Idaho,Sweetwater,219,10,22,61,9,11,113
Idaho,Yellow Pine,0,0,0,0,0,0,0
Idaho,Hidden Springs,2764,0,36,440,605,383,1464
Idaho,Elk City,83,24,24,24,11,0,83
Idaho,Lincoln,3748,44,579,635,642,88,1988
Idaho,Wendell,2721,412,561,449,64,36,1522
Idaho,Eagle,25075,422,2969,6268,5024,2864,17547
Idaho,Orofino,3111,240,862,943,241,103,2389
Idaho,Paris,587,35,177,144,35,11,402
Idaho,Bovill,298,24,86,101,10,5,226
Idaho,Stanley,91,0,13,21,30,17,81
Idaho,Hansen,1451,215,226,271,59,21,792
Idaho,Marsing,1382,279,269,175,33,8,764
Idaho,Weston,513,18,129,107,27,11,292
Idaho,Arco,667,45,193,226,17,30,511
Idaho,Mullan,782,93,184,165,51,13,506
Idaho,Kamiah,1249,112,271,364,84,44,875
Idaho,Lapwai,1305,66,206,354,99,37,762
Idaho,Culdesac,409,35,129,80,17,1,262
Idaho,Firth,498,41,119,99,52,2,313
Idaho,Fort Hall,3402,320,783,775,137,70,2085
Idaho,Shelley,4370,298,636,793,363,84,2174
Idaho,Jerome,11503,1693,2194,1886,693,121,6587
Idaho,Crouch,96,10,23,41,11,6,91
Idaho,St. Anthony,3507,344,739,696,203,148,2130
Idaho,Smelterville,687,73,213,172,21,8,487
Idaho,Midvale,199,4,77,43,14,11,149
Idaho,Moore,155,5,38,66,17,6,132
Idaho,Dayton,577,20,104,118,30,16,288
Idaho,Burley,10373,1240,1846,1991,702,192,5971
Idaho,Placerville,34,0,9,13,6,2,30
Idaho,Riggins,270,8,77,89,70,10,254
Idaho,Bloomington,202,7,41,45,28,1,122
Idaho,Fernan Lake Village,149,0,15,63,21,25,124
Idaho,Shoshone,1305,198,358,242,65,22,885
Idaho,Irwin,217,10,55,76,25,6,172
Idaho,Cascade,664,79,104,113,64,55,415
Idaho,Dalton Gardens,2765,119,399,801,473,192,1984
Idaho,Parker,278,15,83,51,30,4,183
Idaho,Hayden Lake,814,8,81,252,189,69,599
Idaho,Idaho Falls,60147,3327,9622,13247,7245,3801,37242
Idaho,Swan Valley,126,0,21,43,30,5,99
Idaho,McCall,3226,147,494,835,462,596,2534
Idaho,Arbon Valley,835,86,245,195,31,17,574
Idaho,Parma,2109,398,420,346,179,63,1406
Idaho,Hollister,237,52,67,51,3,1,174
Idaho,Mud Lake,331,37,68,60,7,6,178
Idaho,Driggs,1938,194,152,412,281,162,1201
Idaho,New Meadows,501,13,154,106,24,0,297
Idaho,Georgetown,495,18,163,114,27,8,330
Idaho,Buhl,4345,741,1057,1050,184,120,3152
Idaho,Hope,66,0,13,20,11,16,60
Idaho,Juliaetta,586,40,135,167,40,8,390
Idaho,Kendrick,333,25,94,95,12,6,232
Idaho,Onaway,181,15,43,65,6,11,140
Idaho,Weippe,451,50,145,115,16,4,330
Idaho,Drummond,2,0,2,0,0,0,2
Idaho,Kuna,18445,350,3543,4734,1633,570,10830
Idaho,Albion,339,14,56,85,19,5,179
Idaho,Ferdinand,141,8,31,46,7,4,96
Idaho,White Bird,50,0,22,23,0,5,50
Idaho,Sandpoint,8144,905,1391,1916,1222,427,5861
Idaho,Tetonia,435,39,114,96,13,1,263
Idaho,American Falls,4349,651,914,813,340,88,2806
Idaho,Murtaugh,87,15,18,15,5,2,55
Idaho,Kootenai,960,37,288,209,45,20,599
Idaho,East Hope,124,8,26,39,27,15,115
Idaho,Montpelier,2507,151,584,504,243,69,1551
Idaho,Sugar City,1649,98,202,264,131,81,776
Idaho,Osburn,1490,198,414,389,51,31,1083
Idaho,Wallace,895,72,182,270,93,42,659
Idaho,Butte City,76,10,25,25,2,10,72
Idaho,Hayden,14380,785,2903,3797,1652,1015,10152
Idaho,Deary,308,18,127,77,4,3,229
Idaho,Troy,911,8,155,191,109,70,533
Idaho,Eden,379,57,92,64,14,0,227
Idaho,Horseshoe Bend,780,72,248,184,50,35,589
Idaho,Newdale,357,31,62,92,34,4,223
Idaho,Ketchum,2761,24,232,591,1069,372,2288
Idaho,Sun Valley,1445,0,219,224,400,315,1158
Idaho,Iona,2451,30,339,593,337,74,1373
Idaho,Nezperce,512,22,123,137,53,34,369
Idaho,Pinehurst,1402,189,438,392,74,38,1131
Idaho,Wardner,214,5,57,72,4,9,147
Idaho,Weiser,5326,662,1386,1108,288,157,3601
Idaho,Homedale,2605,640,483,316,108,57,1604
Idaho,Rigby,4051,290,539,915,370,81,2195
Idaho,Leadore,89,5,17,27,20,0,69
Idaho,Ammon,15403,388,2048,3313,2257,961,8967
Idaho,Oakley,920,74,183,158,62,25,502
Idaho,Winchester,290,30,65,86,26,8,215
Idaho,Warm River,0,0,0,0,0,0,0
Idaho,Malad City,2136,106,537,599,120,30,1392
Idaho,Clifton,314,10,42,64,23,10,149
Idaho,Preston,5311,349,1596,1047,387,96,3475
Idaho,Twin Falls,48225,3367,8423,12324,3894,2461,30469
Idaho,Chubbuck,14728,805,2032,3845,1736,691,9109
Idaho,Dietrich,304,11,63,115,14,5,208
Idaho,Richfield,473,58,108,118,24,5,313
Idaho,Oldtown,217,53,54,35,12,6,160
Idaho,Lost River,0,0,0,0,0,0,0
Idaho,Coeur d'Alene,49609,2728,8468,13376,6302,2659,33533
Idaho,Hauser,960,40,173,218,59,98,588
Idaho,Spirit Lake,2228,108,637,594,137,54,1530
Idaho,Genesee,951,53,132,232,117,57,591
Idaho,Hailey,8259,1033,1288,1438,877,606,5242
Idaho,Island Park,184,5,42,77,25,18,167
Idaho,Potlatch,750,34,166,212,32,20,464
Idaho,Heyburn,3271,390,591,605,175,67,1828
Idaho,Star,8495,214,1216,2474,1262,397,5563
Idaho,Garden City,11743,651,2114,3039,1813,1276,8893
Idaho,Craigmont,509,39,151,162,34,12,398
Idaho,Meridian,97008,2800,15580,22301,15562,6509,62752
Idaho,Council,872,130,240,198,33,22,623
Idaho,Ucon,1361,89,184,285,125,25,708
Idaho,Boise City,224300,7659,32205,48895,40572,21340,150671
Idaho,Franklin,631,69,147,139,32,21,408
Idaho,Hamer,77,8,9,10,5,1,33
Idaho,Ririe,628,59,120,117,43,0,339
Idaho,Basalt,395,37,99,93,15,5,249
Idaho,Blackfoot,11854,612,2080,2651,1229,556,7128
Idaho,Priest River,1888,156,501,406,127,41,1231
Idaho,Challis,797,52,184,169,148,17,570
Idaho,State Line,7,3,0,0,0,0,3
Idaho,Worley,285,19,65,88,14,6,192
Idaho,Oxford,56,0,11,1,10,0,22
Idaho,Ponderay,1179,137,202,289,102,35,765
Idaho,Atomic City,50,4,3,43,0,0,50
Idaho,Athol,1037,76,330,309,25,22,762
Idaho,Harrison,260,31,91,66,15,0,203
Idaho,Post Falls,31945,1732,6277,8700,2765,1103,20577
Idaho,Aberdeen,2169,334,436,203,58,48,1079
Idaho,Pierce,486,41,117,126,49,5,338
Idaho,Bellevue,2715,338,638,484,300,93,1853
Idaho,Peck,145,13,35,43,19,1,111
Idaho,Huetter,165,30,36,49,1,3,119
Illinois,Summit,11340,2261,2008,1690,619,110,6688
Illinois,Streator,12791,1464,3532,2546,892,400,8834
Illinois,Elsah,704,7,9,23,49,50,138
Illinois,St. Peter,444,19,146,97,33,11,306
Illinois,Campus,181,2,57,49,7,5,120
Illinois,Williamson,198,16,82,28,6,2,134
Illinois,Berlin,205,28,70,49,13,10,170
Illinois,Shabbona,996,55,334,285,70,45,789
Illinois,Pinckneyville,5463,1215,1364,1214,217,84,4094
Illinois,New Athens,2239,190,503,582,129,68,1472
Illinois,Peoria,114512,8288,17750,22447,15458,10304,74247
Illinois,Fairview Heights,16360,867,2869,4041,2145,1718,11640
Illinois,Albers,1184,70,165,233,166,108,742
Illinois,Aviston,2166,68,433,581,355,107,1544
Illinois,Beckemeyer,1024,100,284,307,50,29,770
Illinois,Riverside,8810,143,919,1195,1863,1932,6052
Illinois,South Chicago Heights,4105,566,1172,943,106,56,2843
Illinois,West Point,139,12,47,36,2,1,98
Illinois,Stickney,6732,716,1466,1792,329,194,4497
Illinois,Chillicothe,6135,471,1610,1415,552,290,4338
Illinois,Ellisville,96,16,30,12,1,0,59
Illinois,Hutsonville,503,51,101,116,51,11,330
Illinois,New Grand Chain,189,20,28,52,22,5,127
Illinois,Simpson,72,3,12,18,2,1,36
Illinois,Lebanon,4256,245,791,944,433,528,2941
Illinois,Northlake,12351,2037,2544,2266,826,202,7875
Illinois,Bridgeport,1957,134,476,590,47,24,1271
Illinois,Byron,3608,209,661,856,439,183,2348
Illinois,Berwyn,55949,7164,10251,10049,5467,2567,35498
Illinois,Gilberts,7742,121,908,1652,1386,792,4859
Illinois,Davis,548,53,144,119,42,27,385
Illinois,Stockton,2027,88,566,459,126,44,1283
Illinois,Heyworth,3164,125,604,700,491,124,2044
Illinois,Nebo,301,46,106,55,4,0,211
Illinois,Saunemin,376,19,133,74,12,5,243
Illinois,Country Club Hills,16801,931,2848,4315,1953,1496,11543
Illinois,Sparland,347,59,119,72,8,4,262
Illinois,Iroquois,177,4,69,50,16,5,144
Illinois,Joppa,313,45,92,57,7,4,205
Illinois,Wauconda,13754,1251,2119,2198,2345,1331,9244
Illinois,Stonington,906,23,269,196,98,31,617
Illinois,Capron,1483,223,344,196,68,41,872
Illinois,Alsey,145,15,59,24,9,1,108
Illinois,Knoxville,2988,114,733,718,318,141,2024
Illinois,Banner,223,25,76,54,14,4,173
Illinois,Burnt Prairie,58,5,19,15,0,0,39
Illinois,Lewistown,2349,164,715,555,175,33,1642
Illinois,Eagarville,154,16,24,44,10,5,99
Illinois,Owaneco,228,15,70,59,17,1,162
Illinois,Henning,246,8,102,57,2,0,169
Illinois,Allerton,312,11,106,78,27,4,226
Illinois,Parkersburg,198,20,53,44,7,3,127
Illinois,Belgium,392,48,120,92,25,6,291
Illinois,Rankin,563,60,153,98,15,9,335
Illinois,Toulon,1276,124,350,275,127,41,917
Illinois,Eddyville,77,10,21,24,1,0,56
Illinois,Bushnell,2776,154,803,634,178,146,1915
Illinois,Industry,392,5,107,114,40,17,283
Illinois,Cherry Valley,2895,229,809,680,365,180,2263
Illinois,Rock Island Arsenal,5,0,3,0,0,0,3
Illinois,Morrisonville,1167,56,355,234,91,22,758
Illinois,New Berlin,1553,60,249,325,233,89,956
Illinois,Millington,651,23,188,141,72,20,444
Illinois,Bunker Hill,1684,166,499,394,132,61,1252
Illinois,Prospect Heights,16250,1844,2526,2956,2386,1647,11359
Illinois,Kinmundy,904,98,215,232,16,15,576
Illinois,Carlinville,5610,430,1102,893,568,393,3386
Illinois,Williamsfield,461,30,140,115,35,25,345
Illinois,Mill Shoals,194,16,48,58,11,6,139
Illinois,Morton Grove,23256,1683,3743,4352,5148,2565,17491
Illinois,Liverpool,142,39,59,12,8,0,118
Illinois,Lawrenceville,4417,407,1105,1063,297,131,3003
Illinois,Hopewell,424,17,84,129,69,30,329
Illinois,Toluca,1344,88,446,326,113,30,1003
Illinois,Eldorado,4240,516,990,1013,330,141,2990
Illinois,Wenona,1026,86,245,220,81,39,671
Illinois,Oregon,3683,288,894,983,363,152,2680
Illinois,Rochelle,9196,917,2092,2256,561,311,6137
Illinois,Du Bois,150,20,49,55,9,0,133
Illinois,Bryant,230,33,55,76,9,9,182
Illinois,Crestwood,10901,802,2972,3055,1418,637,8884
Illinois,Hometown,4308,424,1062,1024,337,111,2958
Illinois,Palos Park,4907,127,771,1144,898,690,3630
Illinois,Alexis,885,34,228,292,41,10,605
Illinois,Virginia,1323,86,354,311,109,43,903
Illinois,Lyons,10566,947,2444,2251,793,532,6967
Illinois,Indian Head Park,3812,179,461,955,886,544,3025
Illinois,La Grange,15632,449,1459,1850,3178,3219,10155
Illinois,Lynwood,9316,293,1178,2834,1339,698,6342
Illinois,Midlothian,14718,1145,4161,3486,1075,297,10164
Illinois,Golf,565,20,24,35,142,114,335
Illinois,Norwood,430,29,134,116,17,10,306
Illinois,Clifton,1373,36,300,289,125,69,819
Illinois,Piper City,862,118,262,204,22,7,613
Illinois,Cornland,61,5,41,8,0,7,61
Illinois,Crab Orchard,232,9,40,94,22,5,170
Illinois,Darmstadt,0,0,0,0,0,0,0
Illinois,Dayton,531,15,153,179,24,26,397
Illinois,Floraville,33,17,0,0,16,0,33
Illinois,Georgetown,501,0,89,138,46,68,341
Illinois,Gilson,158,7,70,26,33,0,136
Illinois,Goofy Ridge,233,56,62,39,9,0,166
Illinois,Grand Detour,484,8,36,174,161,9,388
Illinois,Harrison,766,63,176,248,52,40,579
Illinois,Heritage Lake,1514,0,168,374,382,124,1048
Illinois,Holiday Shores,2613,97,486,733,408,230,1954
Illinois,Knollwood,1820,62,255,428,293,186,1224
Illinois,Lake Camelot,1834,8,284,464,280,148,1184
Illinois,Lake Holiday,4534,41,1158,1187,552,211,3149
Illinois,Lake Petersburg,553,0,144,140,188,81,553
Illinois,Langleyville,375,43,135,105,0,11,294
Illinois,LaPlace,142,19,64,29,9,0,121
Illinois,Lost Nation,651,18,219,259,100,29,625
Illinois,Como,607,38,154,203,78,0,473
Illinois,Chestnut,83,0,14,20,0,0,34
Illinois,Chemung,619,233,69,7,0,0,309
Illinois,Boody,237,0,71,61,22,15,169
Illinois,Millbrook,337,7,97,103,37,16,260
Illinois,Monroe Center,402,13,82,110,51,25,281
Illinois,Havana,3232,237,1084,634,232,145,2332
Illinois,New Milford,682,88,187,159,41,24,499
Illinois,Port Barrington,1514,32,211,293,341,157,1034
Illinois,Curran,252,13,76,39,8,40,176
Illinois,McClure,348,56,105,53,6,0,220
Illinois,Campton Hills,11348,99,659,1976,2555,1796,7085
Illinois,Kaneville,375,15,97,109,50,23,294
Illinois,Lovington,1117,35,399,216,54,10,714
Illinois,Limestone,1576,82,378,407,125,61,1053
Illinois,Sammons Point,267,22,60,67,17,6,172
Illinois,Alvan,312,39,86,66,7,8,206
Illinois,Gibson City,3328,238,737,721,367,166,2229
Illinois,Lake Ka-Ho,218,20,91,43,11,0,165
Illinois,Astoria,907,70,263,193,54,11,591
Illinois,Adair,201,19,114,38,0,17,188
Illinois,Annapolis,43,3,4,13,9,0,29
Illinois,Apple Canyon Lake,429,15,106,161,28,62,372
Illinois,Beason,202,10,103,10,0,0,123
Illinois,Plattville,279,14,46,84,17,12,173
Illinois,East St. Louis,26647,3091,6456,5897,1016,975,17435
Illinois,Sauget,182,20,54,61,5,3,143
Illinois,Watseka,5202,486,1499,1304,293,102,3684
Illinois,Ridge Farm,904,55,327,195,26,6,609
Illinois,Belle Rive,306,24,73,79,22,14,212
Illinois,Tilton,2621,237,1031,479,104,19,1870
Illinois,Kincaid,1596,193,465,317,51,21,1047
Illinois,Albion,2034,174,455,501,159,58,1347
Illinois,Nelson,137,9,44,36,3,2,94
Illinois,West Brooklyn,133,7,33,28,11,6,85
Illinois,Illiopolis,890,26,271,200,64,17,578
Illinois,Southern View,1635,99,375,568,146,55,1243
Illinois,Jerome,1883,61,340,479,442,136,1458
Illinois,Springfield,116459,7176,21190,23068,17391,11289,80114
Illinois,Lanark,1562,101,418,307,128,77,1031
Illinois,Milledgeville,1072,53,350,221,46,29,699
Illinois,Kenney,338,19,134,64,29,5,251
Illinois,Verona,255,25,76,39,13,1,154
Illinois,Charleston,20632,1018,2573,3322,2107,1695,10715
Illinois,Christopher,2725,156,536,814,218,56,1780
Illinois,Mendota,7035,814,1601,1594,411,219,4639
Illinois,Seneca,2596,124,584,627,140,154,1629
Illinois,Teutopolis,1837,40,422,369,249,107,1187
Illinois,Virden,3506,148,960,863,357,140,2468
Illinois,LaSalle,9305,906,2014,2193,709,360,6182
Illinois,Steward,318,48,56,65,18,14,201
Illinois,Panola,26,0,0,11,4,4,19
Illinois,Wellington,264,28,77,52,9,2,168
Illinois,Stonefort,346,31,82,64,8,5,190
Illinois,Bement,1502,115,481,356,108,43,1103
Illinois,Mansfield,942,39,299,291,68,46,743
Illinois,Malta,1080,47,173,322,112,74,728
Illinois,Sycamore,17725,554,2488,3995,2822,1736,11595
Illinois,White Hall,2321,246,887,510,89,26,1758
Illinois,Wilmington,113,17,32,17,18,1,85
Illinois,Media,104,5,36,26,5,1,73
Illinois,Mount Vernon,14804,1472,2941,3647,1132,910,10102
Illinois,Willisville,644,59,134,121,21,15,350
Illinois,Dallas City,944,46,318,258,103,32,757
Illinois,Argenta,1140,36,290,240,85,29,680
Illinois,Maroa,1674,54,356,408,126,122,1066
Illinois,Ellis Grove,292,22,80,82,13,2,199
Illinois,Willowbrook,2082,77,343,562,348,159,1489
Illinois,Hollowayville,61,0,19,20,0,0,39
Illinois,Cedarville,648,48,175,170,78,4,475
Illinois,Rock City,296,7,84,58,19,9,177
Illinois,Minonk,2208,91,612,507,197,73,1480
Illinois,Shumway,156,12,28,50,5,7,102
Illinois,Easton,297,27,93,63,16,8,207
Illinois,Homer Glen,24467,949,4377,5173,4183,2335,17017
Illinois,Stronghurst,932,49,270,241,48,16,624
Illinois,Coalton,334,22,117,66,20,2,227
Illinois,Wonder Lake,4219,75,1049,1048,420,356,2948
Illinois,Oakwood Hills,2245,54,374,575,378,138,1519
Illinois,Lakemoor,6171,293,1034,1265,952,414,3958
Illinois,St. Charles,32772,1408,3696,6406,6846,4272,22628
Illinois,Pingree Grove,7337,171,684,2186,1210,488,4739
Illinois,Algonquin,30709,957,3657,6851,6096,3093,20654
Illinois,Washington,16556,401,2283,3811,3060,1406,10961
Illinois,Marine,947,42,220,265,77,69,673
Illinois,Livingston,765,72,282,211,51,18,634
Illinois,Grantfork,343,6,76,97,39,14,232
Illinois,Zion,24047,2453,4744,4579,1674,723,14173
Illinois,Waukegan,87571,13276,17463,12132,6168,3253,52292
Illinois,Volo,4750,155,631,972,859,383,3000
Illinois,North Chicago,30011,3068,3971,4358,2131,937,14465
Illinois,Mettawa,545,0,38,85,152,115,390
Illinois,Third Lake,1133,5,97,182,304,217,805
Illinois,Libertyville,20480,355,1421,2328,4990,4622,13716
Illinois,Hawthorn Woods,8047,206,733,810,2244,1348,5341
Illinois,Farmersville,667,36,212,123,34,20,425
Illinois,Irving,326,58,92,73,12,3,238
Illinois,Waggoner,187,29,47,22,4,0,102
Illinois,Olmsted,489,82,92,105,20,4,303
Illinois,Leonore,69,8,20,21,1,1,51
Illinois,Paxton,4279,251,1046,1002,439,116,2854
Illinois,Sorento,467,76,176,94,10,3,359
Illinois,Pocahontas,733,74,206,190,64,11,545
Illinois,Oakford,354,24,96,120,7,7,254
Illinois,Rome,1664,109,401,626,71,21,1228
Illinois,Dunlap,1160,35,127,176,180,187,705
Illinois,Brimfield,965,49,178,223,96,45,591
Illinois,Kilbourne,322,42,136,72,12,0,262
Illinois,Lake Catherine,1439,90,428,346,105,98,1067
Illinois,Strawn,94,5,28,18,4,6,61
Illinois,Grafton,757,45,204,179,74,80,582
Illinois,Hillview,155,31,57,13,5,0,106
Illinois,Greenfield,1323,121,451,171,81,38,862
Illinois,Thawville,236,17,54,51,7,6,135
Illinois,Winchester,1898,83,634,335,158,101,1311
Illinois,Keyesport,399,64,113,69,18,5,269
Illinois,Bay View Gardens,408,34,137,84,19,2,276
Illinois,Lena,2873,107,755,817,268,135,2082
Illinois,German Valley,564,25,150,142,37,22,376
Illinois,Flanagan,1013,67,327,208,67,39,708
Illinois,Grandwood Park,5261,116,437,965,1212,625,3355
Illinois,Buffalo Grove,41329,749,3133,6008,11062,8580,29532
Illinois,Bannockburn,1325,3,24,75,242,227,571
Illinois,East Cape Girardeau,517,58,125,99,31,2,315
Illinois,Sparta,4384,320,1513,955,288,204,3280
Illinois,Reynolds,506,23,136,102,73,18,352
Illinois,Oak Grove,589,55,186,101,23,7,372
Illinois,South Roxana,2172,208,498,562,63,4,1335
Illinois,Vernon Hills,26259,908,2037,3545,6871,4362,17723
Illinois,Round Lake Park,8057,1163,2407,1100,369,238,5277
Illinois,Round Lake Beach,27692,3622,5451,4851,1780,1027,16731
Illinois,Moline,42364,3274,7328,10931,4682,2905,29120
Illinois,Brownstown,933,129,262,155,56,7,609
Illinois,Cordova,705,59,131,241,59,50,540
Illinois,Hartford,1688,142,517,364,56,19,1098
Illinois,Granite City,29001,2189,8278,7630,1694,1048,20839
Illinois,Worden,1106,21,315,273,100,51,760
Illinois,Sibley,300,16,111,78,18,2,225
Illinois,Louisville,1096,87,315,306,86,11,805
Illinois,Anna,4232,537,1011,821,436,305,3110
Illinois,Steeleville,2284,98,620,592,166,74,1550
Illinois,Red Bud,3557,287,808,1009,217,159,2480
Illinois,Manito,1513,87,375,404,129,63,1058
Illinois,Troy,10356,317,1837,2841,1458,645,7098
Illinois,Big Rock,1318,42,290,379,148,86,945
Illinois,Ramsey,1063,166,331,175,31,0,703
Illinois,Cissna Park,778,42,218,187,77,35,559
Illinois,Cooksville,169,7,61,47,10,11,136
Illinois,Bellflower,386,17,121,93,32,11,274
Illinois,Chebanse,1138,45,197,356,72,49,719
Illinois,Colp,318,10,69,107,9,7,202
Illinois,Coyne Center,922,27,322,286,72,26,733
Illinois,Andalusia,1113,75,295,311,117,45,843
Illinois,Maryville,7955,180,1256,2098,1660,798,5992
Illinois,Carbon Hill,311,18,100,65,8,19,210
Illinois,Browning,130,0,44,32,7,2,85
Illinois,Buckley,539,48,194,121,35,23,421
Illinois,New Douglas,344,28,92,72,9,17,218
Illinois,Metropolis,6184,730,1551,1499,412,134,4326
Illinois,Pontiac,11804,1320,3376,2479,822,417,8414
Illinois,Long Point,237,16,58,56,13,8,151
Illinois,Dwight,4130,319,1239,823,303,279,2963
Illinois,Otterville,126,0,54,22,0,0,76
Illinois,Rockbridge,173,23,57,12,14,2,108
Illinois,Kane,285,26,96,64,12,7,205
Illinois,Monticello,5809,196,1127,1133,966,647,4069
Illinois,Cambria,1248,114,248,311,96,46,815
Illinois,Cutler,384,34,130,86,8,3,261
Illinois,Burnham,4189,385,902,1101,279,183,2850
Illinois,Melvin,516,43,141,91,18,22,315
Illinois,Iola,138,11,42,27,0,0,80
Illinois,Metcalf,180,21,60,31,5,0,117
Illinois,Vermilion,245,33,94,30,16,0,173
Illinois,Taylorville,10964,956,3181,2329,994,488,7948
Illinois,Bone Gap,187,4,41,70,5,4,124
Illinois,Browns,129,25,32,42,4,1,104
Illinois,Bentley,20,0,6,5,2,3,16
Illinois,Schaumburg,74569,3078,10743,14305,16816,9113,54055
Illinois,Addison,37089,5055,7432,6309,4021,1780,24597
Illinois,Elmhurst,46331,1159,4079,6621,9916,7991,29766
Illinois,Bradley,15428,995,3380,3562,1206,754,9897
Illinois,Willowbrook,8576,167,1321,1781,1931,1584,6784
Illinois,Kankakee,25884,4174,5469,4741,1397,972,16753
Illinois,Chrisman,1306,90,359,362,97,74,982
Illinois,Momence,3146,257,818,799,118,65,2057
Illinois,Ellsworth,243,11,68,54,15,4,152
Illinois,Concord,183,19,66,32,12,3,132
Illinois,South Jacksonville,3194,150,924,705,405,151,2335
Illinois,Granville,1232,91,358,315,102,53,919
Illinois,Maunie,175,27,41,49,3,0,120
Illinois,Norris City,1216,66,293,349,60,16,784
Illinois,Tampico,735,43,249,162,27,11,492
Illinois,Crescent City,634,18,190,124,62,26,420
Illinois,Martinton,356,20,82,100,13,6,221
Illinois,Pittsburg,571,61,184,137,38,4,424
Illinois,St. Elmo,1297,137,374,317,48,29,905
Illinois,Bishop Hill,114,4,35,37,18,7,101
Illinois,Union Hill,58,0,10,18,0,0,28
Illinois,Brookfield,18858,668,2822,3734,3412,2236,12872
Illinois,Spillertown,272,25,32,79,31,15,182
Illinois,Gilman,1824,240,497,346,99,87,1269
Illinois,Vernon,101,18,37,19,2,0,76
Illinois,New Boston,519,58,204,118,15,2,397
Illinois,Seaton,217,10,67,67,5,11,160
Illinois,Griggsville,1465,119,416,278,92,30,935
Illinois,New Salem,265,15,40,102,4,2,163
Illinois,Windsor,1256,76,307,327,60,16,786
Illinois,Channahon,12718,242,2137,3278,1533,721,7911
Illinois,Albany,979,45,348,217,70,38,718
Illinois,Countryside,5997,445,1347,1194,892,259,4137
Illinois,Carthage,2466,107,514,603,382,152,1758
Illinois,La Harpe,1411,87,433,295,120,23,958
Illinois,Nauvoo,1146,48,237,272,160,78,795
Illinois,Energy,1138,60,331,437,91,51,970
Illinois,Pontoosuc,94,9,38,24,8,0,79
Illinois,Wapella,600,56,217,97,39,8,417
Illinois,Mazon,1002,33,256,264,78,25,656
Illinois,Huey,211,36,62,54,13,7,172
Illinois,Naples,78,7,28,21,0,2,58
Illinois,Beaverville,340,28,127,78,14,2,249
Illinois,Newman,774,63,246,199,55,11,574
Illinois,Macedonia,46,4,17,8,7,0,36
Illinois,Good Hope,420,12,121,105,35,18,291
Illinois,Chapin,458,33,113,109,29,21,305
Illinois,Carterville,5848,182,768,1082,846,775,3653
Illinois,Danforth,632,36,209,140,60,15,460
Illinois,Donovan,239,18,70,54,15,1,158
Illinois,Shannon,761,44,200,176,42,39,501
Illinois,Calumet City,36856,3171,6988,9399,2844,1294,23696
Illinois,Hickory Hills,14018,1223,2958,3019,1687,722,9609
Illinois,Melrose Park,25311,4643,5439,3994,1317,701,16094
Illinois,Silvis,7553,457,1573,2253,491,334,5108
Illinois,East Peoria,22876,1356,5611,5941,2634,1274,16816
Illinois,Keensburg,74,3,21,37,1,2,64
Illinois,Lake Barrington,5069,32,504,965,1494,1140,4135
Illinois,Magnolia,336,26,99,63,6,5,199
Illinois,Hinsdale,17654,236,659,1288,4066,4811,11060
Illinois,Warrenville,13311,882,1414,2619,2686,1223,8824
Illinois,Rosiclare,836,74,180,252,46,18,570
Illinois,Cabery,259,12,85,60,15,8,180
Illinois,Essex,899,43,209,225,51,25,553
Illinois,Grant Park,1313,78,366,360,110,37,951
Illinois,Colfax,1135,46,289,247,105,25,712
Illinois,Rock Island,38354,2983,7150,8893,3920,1924,24870
Illinois,Stanford,712,50,204,147,33,15,449
Illinois,Hopedale,911,75,255,260,106,29,725
Illinois,Marquette Heights,2553,159,576,722,175,60,1692
Illinois,Carpentersville,38138,6196,5727,5966,2915,1264,22068
Illinois,North Aurora,17653,1047,2542,3911,2851,1770,12121
Illinois,Fox River Grove,4899,59,466,1031,1116,564,3236
Illinois,Hebron,1384,126,326,320,75,25,872
Illinois,Johnsburg,6333,157,1483,1224,985,469,4318
Illinois,Union,509,21,102,130,45,16,314
Illinois,Harvel,235,18,68,45,7,2,140
Illinois,Ullin,444,44,72,144,64,5,329
Illinois,Sun River Terrace,422,24,86,106,14,9,239
Illinois,Chenoa,2037,73,623,398,194,85,1373
Illinois,Murrayville,526,48,188,133,24,10,403
Illinois,Mount Carmel,7040,428,1542,2128,668,310,5076
Illinois,Kampsville,372,54,124,57,8,6,249
Illinois,Grand Tower,482,65,153,152,18,4,392
Illinois,Palos Hills,17443,945,4334,3844,1943,1220,12286
Illinois,Richton Park,13629,578,2191,3542,1418,971,8700
Illinois,Merrionette Park,2163,178,457,487,158,145,1425
Illinois,Niles,29640,2796,6513,5838,5110,2529,22786
Illinois,Oak Lawn,56420,4203,11345,13160,7235,4174,40117
Illinois,Phoenix,2020,263,451,398,150,18,1280
Illinois,Schiller Park,11704,1476,2828,2479,1146,385,8314
Illinois,Stone Park,4923,1253,764,597,112,74,2800
Illinois,Thornton,2478,158,847,618,177,53,1853
Illinois,Worth,10728,862,2604,2701,808,420,7395
Illinois,Arcola,2680,324,582,447,236,46,1635
Illinois,Broughton,144,22,36,17,8,0,83
Illinois,Plymouth,442,58,167,87,24,2,338
Illinois,Durand,1379,72,348,354,142,57,973
Illinois,Machesney Park,22906,1767,5874,5699,1783,557,15680
Illinois,Plainville,333,46,82,87,17,6,238
Illinois,Oak Park,52225,1304,3390,6423,11279,14241,36637
Illinois,Hennepin,792,14,229,248,37,49,577
Illinois,Inverness,7747,177,652,1331,2056,1619,5835
Illinois,Markham,12600,1143,2718,2848,709,467,7885
Illinois,Robbins,5003,617,930,1435,207,184,3373
Illinois,Westchester,16573,594,2878,3872,3324,1895,12563
Illinois,Beardstown,5902,963,1663,780,251,124,3781
Illinois,Chandlerville,452,26,136,120,17,7,306
Illinois,De Land,369,22,119,96,14,3,254
Illinois,Batchtown,199,12,59,67,16,7,161
Illinois,Zeigler,1836,157,454,435,101,8,1155
Illinois,Roberts,446,31,140,88,13,9,281
Illinois,Germantown,1180,71,261,295,127,46,800
Illinois,Carlyle,3285,256,989,665,420,146,2476
Illinois,Summerfield,405,35,114,85,12,5,251
Illinois,McLean,793,70,243,170,64,17,564
Illinois,Saybrook,775,33,224,148,79,14,498
Illinois,Jacksonville,18914,1249,5053,4085,1488,786,12661
Illinois,Bartlett,41316,1900,6092,7750,8607,3644,27993
Illinois,Elgin,113023,15315,17514,21247,11784,6270,72130
Illinois,Lexington,1890,69,458,371,316,109,1323
Illinois,West Chicago,27328,4547,4492,3594,2839,1585,17057
Illinois,Irwin,53,1,13,12,5,3,34
Illinois,Bloomington,78331,2239,12128,12344,15577,9068,51356
Illinois,Assumption,1142,71,375,194,83,22,745
Illinois,Clinton,7126,554,1834,1686,633,189,4896
Illinois,Lyndon,638,57,198,119,30,7,411
Illinois,Collinsville,24756,1344,5393,6260,2744,1718,17459
Illinois,Redmon,145,6,45,58,13,1,123
Illinois,Nason,236,37,76,59,4,0,176
Illinois,Pana,5478,487,1895,936,312,119,3749
Illinois,Ashmore,814,92,180,180,61,54,567
Illinois,Bonnie,323,39,83,77,23,8,230
Illinois,Grandview,1453,158,401,383,70,16,1028
Illinois,Riverton,3443,146,880,785,266,92,2169
Illinois,Spaulding,950,12,204,244,130,59,649
Illinois,Williamsville,1423,11,217,355,214,107,904
Illinois,New Bedford,67,17,27,12,1,0,57
Illinois,Ohio,513,43,143,130,24,18,358
Illinois,Frankfort,18850,317,2020,2794,4175,2890,12196
Illinois,Lockport,25226,763,4182,5648,3579,2096,16268
Illinois,Jeisyville,72,8,34,14,0,0,56
Illinois,Bethany,1204,54,366,344,92,53,909
Illinois,Sandwich,7617,456,1859,1803,579,245,4942
Illinois,Newark,1219,54,294,267,90,58,763
Illinois,Carbon Cliff,1893,180,430,442,75,65,1192
Illinois,Coal Valley,3635,175,846,864,624,199,2708
Illinois,Wheeling,38424,3956,6576,6239,6912,3808,27491
Illinois,Godfrey,17685,444,3601,5336,2262,1510,13153
Illinois,Hampton,2002,91,411,467,281,110,1360
Illinois,Milan,5084,375,1572,1238,399,239,3823
Illinois,Le Roy,3576,130,1031,711,506,107,2485
Illinois,Clarendon Hills,8711,200,372,735,2480,1703,5490
Illinois,Glen Ellyn,27958,695,1848,3466,7017,5363,18389
Illinois,Itasca,9042,394,1723,2071,1670,749,6607
Illinois,Normal,54808,886,5574,7390,8156,4995,27001
Illinois,Franklin,626,23,182,139,70,28,442
Illinois,Buda,641,51,216,134,12,17,430
Illinois,Ladd,1185,68,282,353,109,73,885
Illinois,Seatonville,341,23,83,90,12,8,216
Illinois,Sheffield,826,73,248,228,52,31,632
Illinois,Loraine,331,27,82,79,16,17,221
Illinois,DeKalb,42839,1610,4577,7150,4614,3331,21282
Illinois,Kirkland,1816,130,348,454,110,51,1093
Illinois,Cornell,444,38,129,89,15,5,276
Illinois,Roodhouse,1792,142,579,330,96,24,1171
Illinois,Odell,1042,34,278,261,66,26,665
Illinois,Camden,89,3,37,14,5,1,60
Illinois,Martinsville,1289,89,301,243,73,51,757
Illinois,Watson,835,78,257,176,18,11,540
Illinois,Gladstone,218,31,81,37,13,0,162
Illinois,Raritan,60,4,18,23,6,3,54
Illinois,Peotone,4294,139,1003,1021,497,119,2779
Illinois,Downs,886,12,201,150,176,54,593
Illinois,Liberty,412,34,96,113,24,15,282
Illinois,Homer,1266,47,331,269,112,28,787
Illinois,Middletown,317,16,95,101,9,3,224
Illinois,Aurora,200660,26928,26656,30706,23873,13924,122087
Illinois,Windsor,802,57,251,191,41,12,552
Illinois,Baylis,131,31,27,23,5,0,86
Illinois,Detroit,76,0,21,23,0,0,44
Illinois,Oconee,175,11,44,34,20,3,112
Illinois,Crete,8184,412,1530,1833,1238,848,5861
Illinois,Crystal Lawns,2086,128,500,689,108,70,1495
Illinois,Centreville,5059,495,1177,1058,185,73,2988
Illinois,Cortland,4087,153,598,897,640,196,2484
Illinois,Genoa,4878,378,1115,1191,342,129,3155
Illinois,St. Libory,510,18,170,148,36,14,386
Illinois,Warren,1198,74,374,289,111,31,879
Illinois,Washington Park,3962,906,881,612,118,38,2555
Illinois,Dupo,3893,195,1136,904,173,105,2513
Illinois,Freeburg,4254,151,827,1154,636,468,3236
Illinois,Edinburg,1186,90,353,286,85,31,845
Illinois,Bowen,444,50,141,78,23,15,307
Illinois,Elvaston,138,10,38,46,3,0,97
Illinois,Hamilton,2875,116,796,696,322,113,2043
Illinois,Dowell,473,73,122,97,15,5,312
Illinois,Murphysboro,7951,723,1892,1622,805,466,5508
Illinois,Vergennes,202,14,53,61,12,0,140
Illinois,West Peoria,4731,351,992,1438,503,192,3476
Illinois,Tallula,488,33,157,98,24,15,327
Illinois,Lenzburg,491,60,144,91,22,7,324
Illinois,West Salem,930,74,230,274,60,23,661
Illinois,Toledo,1322,111,378,309,64,19,881
Illinois,Casey,2518,200,752,562,128,116,1758
Illinois,Shelbyville,4527,320,1495,920,301,194,3230
Illinois,Lake of the Woods,2442,84,483,597,211,94,1469
Illinois,Ludlow,382,26,147,75,9,0,257
Illinois,Elk Grove Village,32997,1393,5822,8677,5848,2896,24636
Illinois,Glendale Heights,34280,4394,5296,7165,4432,1635,22922
Illinois,Freeman Spur,321,44,77,81,1,0,203
Illinois,Hurst,846,106,222,243,42,8,621
Illinois,Walshville,122,6,23,38,1,0,68
Illinois,McCullom Lake,1148,120,281,286,57,3,747
Illinois,Marengo,8175,468,1983,1692,760,439,5342
Illinois,Donnellson,172,34,58,45,2,0,139
Illinois,Taylor Springs,647,83,248,143,27,16,517
Illinois,Ridott,157,12,45,42,4,0,103
Illinois,El Paso,2820,143,811,560,328,47,1889
Illinois,Galena,3399,389,916,617,494,185,2601
Illinois,Nora,166,18,57,18,15,0,108
Illinois,Emden,518,32,151,105,58,11,357
Illinois,Long Grove,7978,136,492,893,1781,1983,5285
Illinois,Riverwoods,3656,68,148,486,870,1051,2623
Illinois,Round Lake,18489,1396,2531,3685,2835,888,11335
Illinois,Round Lake Heights,3208,317,632,430,302,134,1815
Illinois,Venetian Village,2870,88,867,707,201,92,1955
Illinois,Wadsworth,3584,31,623,717,807,381,2559
Illinois,Sherrard,622,19,158,196,52,21,446
Illinois,Mount Pulaski,1582,15,511,363,141,41,1071
Illinois,Joy,390,31,119,102,14,7,273
Illinois,North Henderson,175,9,59,51,15,8,142
Illinois,Barry,1552,88,431,353,109,36,1017
Illinois,Lima,120,9,31,32,15,6,93
Illinois,Gridley,1577,77,350,318,201,72,1018
Illinois,Towanda,491,27,195,99,45,17,383
Illinois,Woodson,404,12,117,87,65,24,305
Illinois,Marietta,101,14,37,10,4,16,81
Illinois,Vermont,777,101,242,140,31,17,531
Illinois,Hidalgo,120,12,41,21,1,0,75
Illinois,Newton,2766,312,812,532,181,145,1982
Illinois,Willow Hill,193,21,81,53,6,0,161
Illinois,St. Francisville,538,22,147,176,48,15,408
Illinois,Henry,2478,129,707,578,260,76,1750
Illinois,Varna,476,25,132,122,32,7,318
Illinois,Polo,2168,161,556,505,144,122,1488
Illinois,Raleigh,253,17,50,95,17,2,181
Illinois,Radom,159,9,64,44,5,7,129
Illinois,Berkeley,5171,657,1155,1030,495,311,3648
Illinois,Fairview,433,28,124,130,20,21,323
Illinois,Blue Island,22636,3298,4277,4956,1600,733,14864
Illinois,Thomson,479,48,163,102,42,19,374
Illinois,Eldred,156,14,76,31,7,0,128
Illinois,Camp Point,1136,86,332,273,80,49,820
Illinois,Columbus,47,5,14,4,3,3,29
Illinois,Carrollton,2461,136,676,673,187,69,1741
Illinois,Centralia,12538,1076,2776,3277,893,494,8516
Illinois,Irvington,749,42,174,233,31,27,507
Illinois,Okawville,1569,42,266,372,192,127,999
Illinois,Burbank,28947,3306,7145,5727,2052,662,18892
Illinois,Pleasant Plains,767,34,155,185,80,42,496
Illinois,Thayer,713,20,218,184,78,6,506
Illinois,Altona,642,38,128,158,56,8,388
Illinois,Rossville,1451,91,376,288,109,36,900
Illinois,Palestine,1191,73,294,426,38,18,849
Illinois,Glenwood,8766,398,1591,1985,1093,805,5872
Illinois,Flossmoor,9427,218,722,1450,1474,2434,6298
Illinois,Nokomis,2102,166,655,326,136,100,1383
Illinois,Panama,250,17,97,47,11,4,176
Illinois,Wenonah,40,0,21,2,2,0,25
Illinois,Congerville,575,23,134,128,57,26,368
Illinois,Goodfield,918,3,141,196,154,84,578
Illinois,Harmon,127,9,60,16,1,2,88
Illinois,Paw Paw,764,70,218,228,36,24,576
Illinois,Clear Lake,191,20,75,38,14,1,148
Illinois,Lynnville,68,4,21,18,11,0,54
Illinois,Bensenville,18400,2782,3771,3378,1818,627,12376
Illinois,Pesotum,501,10,169,112,61,22,374
Illinois,Rantoul,13222,633,3070,2864,845,694,8106
Illinois,Sidney,1368,42,181,426,161,41,851
Illinois,Roselle,22873,987,3737,4593,4248,2060,15625
Illinois,Winfield,9708,109,1124,1714,2702,1571,7220
Illinois,Ford Heights,2755,316,573,550,81,57,1577
Illinois,Herscher,1471,35,363,327,160,144,1029
Illinois,Bedford Park,514,34,110,121,85,23,373
Illinois,Cicero,83147,18459,15865,10008,3391,689,48412
Illinois,Franklin Park,18138,2282,4061,3749,1942,486,12520
Illinois,Glencoe,8919,96,245,452,2041,2996,5830
Illinois,Scott AFB,2697,0,115,556,224,355,1250
Illinois,Smithton,3980,150,754,961,586,308,2759
Illinois,Swansea,13863,466,2010,3598,2176,1888,10138
Illinois,Forest City,325,18,74,65,5,19,181
Illinois,Mason City,2364,192,795,457,109,99,1652
Illinois,Dolton,22927,1866,3975,6175,1769,1001,14786
Illinois,Hillcrest,1265,125,257,266,92,20,760
Illinois,Coffeen,622,58,174,158,17,2,409
Illinois,Pearl,207,24,43,38,15,0,120
Illinois,Mokena,20720,472,3080,3902,3959,2476,13889
Illinois,Edgewood,536,46,213,93,19,12,383
Illinois,Effingham,12624,712,3168,2770,1277,637,8564
Illinois,Mason,302,37,101,74,7,1,220
Illinois,Montrose,244,28,61,63,7,9,168
Illinois,Oquawka,1558,129,568,321,68,54,1140
Illinois,Oswego,34383,1311,3976,6444,6073,3764,21568
Illinois,Forsyth,2964,46,421,588,566,438,2059
Illinois,Long Creek,1548,99,397,302,192,57,1047
Illinois,Mount Zion,5973,163,1011,1238,911,526,3849
Illinois,Dongola,799,54,150,191,45,0,440
Illinois,Jonesboro,1935,157,413,541,220,66,1397
Illinois,Mill Creek,53,0,14,18,10,0,42
Illinois,Marion,17646,1086,3639,4783,1538,1295,12341
Illinois,Fidelity,149,24,42,29,3,0,98
Illinois,Jerseyville,8127,682,2222,1705,677,459,5745
Illinois,Forrest,1109,73,380,216,40,17,726
Illinois,Vandalia,6914,1063,1735,1570,319,183,4870
Illinois,Colona,4954,619,1151,993,445,189,3397
Illinois,Geneseo,6520,262,1354,1605,904,624,4749
Illinois,Glen Carbon,12845,252,1297,2454,2654,2260,8917
Illinois,Highland,10020,535,2001,2463,1436,622,7057
Illinois,St. Jacob,1392,36,266,321,201,78,902
Illinois,Reddick,222,10,40,56,25,3,134
Illinois,Baldwin,308,13,117,58,7,3,198
Illinois,Rockwood,28,9,7,7,0,0,23
Illinois,Thebes,392,43,75,53,23,7,201
Illinois,Fieldon,201,12,98,36,2,5,153
Illinois,Hillsdale,538,52,115,150,33,14,364
Illinois,Herrin,12869,908,2485,3401,1380,617,8791
Illinois,Creal Springs,433,56,116,164,6,1,343
Illinois,Monee,5124,231,1205,1328,690,324,3778
Illinois,New Lenox,26032,419,3967,5403,4465,2641,16895
Illinois,Steger,9439,679,2732,2102,613,455,6581
Illinois,Mount Carroll,1587,80,459,357,180,87,1163
Illinois,De Witt,202,13,76,54,12,1,156
Illinois,Maple Park,1482,56,282,347,255,41,981
Illinois,South Elgin,22522,1141,3390,4299,3629,1566,14025
Illinois,Greenwood,249,27,53,79,21,10,190
Illinois,Holiday Hills,740,66,275,147,66,12,566
Illinois,McLeansboro,2663,231,754,647,170,124,1926
Illinois,Macomb,18118,642,2075,2741,1750,2143,9351
Illinois,Cypress,216,27,48,47,6,3,131
Illinois,New Burnside,155,21,52,57,6,3,139
Illinois,Colchester,1481,121,531,304,100,43,1099
Illinois,Rosewood Heights,4101,247,1120,1224,349,96,3036
Illinois,Wilsonville,690,79,242,158,17,4,500
Illinois,Noble,621,59,148,162,41,15,425
Illinois,Hamel,866,13,131,260,100,47,551
Illinois,Pierron,446,42,125,128,21,37,353
Illinois,Pontoon Beach,5725,401,1314,1436,473,200,3824
Illinois,Roxana,1506,103,378,457,113,35,1086
Illinois,Venice,2128,177,532,437,82,16,1244
Illinois,Wood River,10234,820,2736,2558,683,322,7119
Illinois,Port Byron,1802,53,337,436,226,162,1214
Illinois,Bellmont,194,15,48,73,5,2,143
Illinois,Woodland,332,29,110,89,3,0,231
Illinois,Crainville,1499,69,241,392,191,112,1005
Illinois,Pittsfield,4375,437,1175,965,469,111,3157
Illinois,Sailor Springs,120,19,51,14,0,0,84
Illinois,Trout Valley,481,6,44,104,115,76,345
Illinois,Fulton,3302,151,821,832,328,247,2379
Illinois,Trenton,2637,111,502,687,413,106,1819
Illinois,Elliott,311,23,80,87,14,1,205
Illinois,Forest Lake,1451,42,158,341,322,174,1037
Illinois,Cobden,1161,168,256,207,116,67,814
Illinois,Cairo,2528,339,560,539,203,48,1689
Illinois,Galva,2565,165,595,651,296,142,1849
Illinois,Alton,26884,2111,6021,7229,2036,1238,18635
Illinois,Grayslake,21195,557,1945,4184,4152,3062,13900
Illinois,Highland Park,29731,538,1653,3158,7364,8177,20890
Illinois,Indian Creek,596,14,47,47,145,140,393
Illinois,Kildeer,4014,28,168,489,1164,722,2571
Illinois,Edwardsville,24868,360,2485,3651,4258,2885,13639
Illinois,Bartelso,661,22,150,131,74,48,425
Illinois,Old Mill Creek,166,5,26,45,27,17,120
Illinois,Creve Coeur,5493,493,1746,1326,168,55,3788
Illinois,Pekin,33371,2280,8627,8223,3191,1348,23669
Illinois,Spring Valley,5282,392,1329,1321,380,185,3607
Illinois,Scales Mound,493,22,143,100,44,12,321
Illinois,Broadwell,186,11,44,51,18,17,141
Illinois,Elkhart,422,13,91,80,63,47,294
Illinois,Gifford,900,47,230,225,88,39,629
Illinois,Bourbonnais,19526,714,2946,3763,2652,1569,11644
Illinois,Beach Park,13534,838,2954,3019,1450,704,8965
Illinois,Gurnee,30854,1045,3447,5619,6231,4206,20548
Illinois,Gages Lake,9862,284,1572,2271,1780,952,6859
Illinois,Payson,1243,41,339,249,86,25,740
Illinois,Tremont,2099,27,459,533,258,142,1419
Illinois,Glasgow,104,14,60,17,2,1,94
Illinois,Mulberry Grove,592,63,221,110,18,6,418
Illinois,Hoffman,464,41,107,133,35,14,330
Illinois,Monmouth,9189,1012,1770,1409,795,466,5452
Illinois,Mound Station,140,4,46,20,7,10,87
Illinois,St. David,634,64,184,171,15,8,442
Illinois,Ste. Marie,341,9,94,92,32,0,227
Illinois,Yale,111,22,39,16,4,0,81
Illinois,Sumner,3192,933,838,577,61,60,2469
Illinois,Davis Junction,2508,141,405,668,171,90,1475
Illinois,Oakdale,166,11,31,48,9,8,107
Illinois,Richview,280,10,84,67,4,2,167
Illinois,Venedy,193,5,42,54,2,10,113
Illinois,Alsip,19179,1443,4193,4650,1788,788,12862
Illinois,Broadview,7829,589,1854,2442,783,349,6017
Illinois,Mount Sterling,2227,130,430,538,282,86,1466
Illinois,Des Plaines,58694,5017,10427,11987,10562,5638,43631
Illinois,Forest View,892,75,230,182,82,26,595
Illinois,Hazel Crest,13729,569,2379,3722,1818,828,9316
Illinois,Versailles,576,38,214,171,18,0,441
Illinois,Robinson,7614,1182,1486,2205,533,343,5749
Illinois,Columbia,10503,307,1508,2332,2122,1188,7457
Illinois,East Carondelet,512,58,165,94,11,5,333
Illinois,Fairmont City,2519,572,547,279,4,8,1410
Illinois,Mascoutah,8007,375,1268,1735,1065,598,5041
Illinois,Bath,265,31,119,45,3,0,198
Illinois,San Jose,670,33,250,131,40,9,463
Illinois,Bartonville,6316,381,1681,1682,332,220,4296
Illinois,Bellevue,1847,165,582,402,91,58,1298
Illinois,Mapleton,295,10,77,75,23,9,194
Illinois,Fisher,1952,40,464,487,179,59,1229
Illinois,Ringwood,743,18,170,160,102,59,509
Illinois,Lake Forest,19219,154,851,1672,4920,5290,12887
Illinois,Fox Lake Hills,2198,97,611,721,260,115,1804
Illinois,Indianola,290,18,116,38,10,6,188
Illinois,Muncie,174,12,27,48,19,0,106
Illinois,Loami,1037,100,172,255,76,26,629
Illinois,Quincy,40428,2330,9637,9220,4316,2351,27854
Illinois,Ursa,579,14,143,166,77,20,420
Illinois,Broadlands,346,4,92,92,25,19,232
Illinois,Pawnee,2631,101,573,590,273,136,1673
Illinois,Jeffersonville,427,43,96,129,21,1,290
Illinois,Johnsonville,69,5,17,20,3,0,45
Illinois,Wayne City,1009,107,245,221,82,33,688
Illinois,Cowden,514,28,199,105,22,3,357
Illinois,Herrick,361,34,132,58,18,0,242
Illinois,Hoopeston,5229,755,1683,829,317,153,3737
Illinois,Moweaqua,1893,130,500,450,193,86,1359
Illinois,Ingalls Park,3200,344,1038,679,62,48,2171
Illinois,Manhattan,7813,278,1340,1480,1113,336,4547
Illinois,Park Forest,21699,808,3725,6154,2292,1417,14396
Illinois,Yates City,739,39,215,155,65,29,503
Illinois,Medora,410,67,133,73,12,14,299
Illinois,Claremont,230,13,48,70,19,2,152
Illinois,Fithian,445,25,150,134,25,20,354
Illinois,Springerton,119,10,32,27,12,0,81
Illinois,Carmi,4913,252,1372,1369,310,208,3511
Illinois,Crossville,765,60,186,192,43,18,499
Illinois,Grayville,1728,134,428,454,107,35,1158
Illinois,Phillipstown,54,10,21,8,3,0,42
Illinois,Braidwood,6284,201,1897,1764,360,140,4362
Illinois,Olney,8808,873,1671,2052,953,445,5994
Illinois,Standard City,191,30,49,39,8,2,128
Illinois,Royal Lakes,180,48,37,48,2,8,143
Illinois,Highwood,5361,600,1076,532,814,658,3680
Illinois,Cuba,1285,134,379,218,109,26,866
Illinois,Smithfield,182,21,55,44,12,11,143
Illinois,Leaf River,548,46,179,120,40,11,396
Illinois,Nashville,3093,155,644,872,406,211,2288
Illinois,Dakota,551,31,154,106,34,11,336
Illinois,Roanoke,2032,77,577,547,184,47,1432
Illinois,Loda,324,46,79,89,8,12,234
Illinois,Papineau,182,14,60,43,0,1,118
Illinois,Johnston City,3485,251,986,962,154,59,2412
Illinois,Petersburg,2346,178,607,515,155,140,1595
Illinois,Atwood,1004,90,360,230,57,11,748
Illinois,Cerro Gordo,1371,59,387,306,117,44,913
Illinois,Benton,6980,797,1421,1742,747,367,5074
Illinois,Glasford,1223,52,366,333,55,19,825
Illinois,Millstadt,3915,115,864,822,538,288,2627
Illinois,New Baden,3258,126,619,950,443,135,2273
Illinois,Shiloh,13250,364,1932,2842,2218,1697,9053
Illinois,Athens,2105,54,481,520,203,82,1340
Illinois,West City,772,84,143,195,30,16,468
Illinois,Salem,7100,495,1885,1669,407,324,4780
Illinois,Greenville,6607,516,1317,1260,677,547,4317
Illinois,Ashkum,800,42,227,215,51,6,541
Illinois,Junction City,539,75,144,121,12,5,357
Illinois,Cahokia,14271,1498,3707,2955,500,228,8888
Illinois,Washburn,1097,76,318,272,69,5,740
Illinois,East Galesburg,624,37,179,157,66,45,484
Illinois,North Barrington,2974,46,157,389,838,640,2070
Illinois,Tennessee,126,6,52,28,4,14,104
Illinois,Buncombe,173,7,32,32,16,2,89
Illinois,Savoy,8654,170,644,1264,1697,1715,5490
Illinois,Dalzell,736,48,195,202,74,38,557
Illinois,Victoria,289,22,100,58,22,0,202
Illinois,Wataga,773,51,237,188,49,9,534
Illinois,Emington,106,3,32,31,1,1,68
Illinois,South Pekin,1018,75,290,224,7,6,602
Illinois,Champaign,86791,2481,8135,12790,10831,12842,47079
Illinois,Marseilles,5088,391,1314,1270,275,90,3340
Illinois,Foosland,120,2,36,22,0,0,60
Illinois,Green Valley,750,41,206,199,42,13,501
Illinois,North Pekin,1384,98,393,371,49,25,936
Illinois,Bureau Junction,213,23,77,36,4,0,140
Illinois,Junction,114,5,29,28,10,1,73
Illinois,Shawneetown,1292,112,347,338,21,27,845
Illinois,Hartsburg,299,19,96,69,24,13,221
Illinois,Delavan,1668,89,518,340,124,58,1129
Illinois,Morrison,3872,179,945,982,408,206,2720
Illinois,Sterling,14810,1225,3401,3481,1082,674,9863
Illinois,Golden,646,41,218,170,37,20,486
Illinois,West Frankfort,7905,863,1996,2235,268,207,5569
Illinois,North City,717,49,183,182,54,24,492
Illinois,Neoga,1817,150,421,406,152,62,1191
Illinois,Goreville,1105,67,231,314,105,51,768
Illinois,Dahlgren,511,37,94,164,35,45,375
Illinois,Tuscola,4630,315,932,1158,585,220,3210
Illinois,Garrett,129,14,45,35,1,0,95
Illinois,Ashland,1367,66,433,274,115,73,961
Illinois,Posen,6211,622,1131,797,544,94,3188
Illinois,Park Ridge,37764,1144,3939,5732,8597,6632,26044
Illinois,River Grove,10148,696,2914,2279,1003,395,7287
Illinois,Chicago,2718555,288461,427009,433664,424212,291906,1865252
Illinois,Bonfield,419,13,97,126,29,11,276
Illinois,Hanover Park,38275,4855,6462,6838,4262,1536,23953
Illinois,Royal,307,8,93,74,43,9,227
Illinois,Latham,403,37,78,104,29,8,256
Illinois,Aledo,3520,202,967,792,412,188,2561
Illinois,Oakbrook Terrace,2912,143,419,594,622,413,2191
Illinois,Villa Park,21893,1325,3868,4540,3674,1457,14864
Illinois,Ewing,293,19,57,104,28,4,212
Illinois,Valier,668,59,101,192,47,22,421
Illinois,Gorham,206,18,65,23,6,4,116
Illinois,Leland,859,64,191,221,101,19,596
Illinois,North Utica,1373,73,328,364,144,85,994
Illinois,Oglesby,3669,232,917,916,333,176,2574
Illinois,Peru,9864,524,2417,2707,1182,434,7264
Illinois,Cleveland,287,19,94,57,9,6,185
Illinois,Wood Dale,13848,1081,3608,2620,1767,789,9865
Illinois,Barrington Hills,3916,96,232,518,1206,894,2946
Illinois,Virgil,400,30,112,98,28,20,288
Illinois,Mackinaw,2023,84,372,457,307,63,1283
Illinois,Morton,16731,551,2330,3501,3592,1656,11630
Illinois,West Dundee,7535,207,1013,1609,1938,544,5311
Illinois,Harvard,9292,1725,1751,1317,332,237,5362
Illinois,Buckner,422,45,119,117,10,11,302
Illinois,Walnut,1389,68,402,278,150,41,939
Illinois,Mattoon,17597,1264,4246,4435,1432,769,12146
Illinois,Danvers,1108,12,219,256,152,68,707
Illinois,Buckingham,254,24,68,51,4,13,160
Illinois,Cave-In-Rock,263,41,77,61,6,2,187
Illinois,East Dubuque,1557,94,492,278,172,81,1117
Illinois,Elizabeth,819,41,271,157,110,35,614
Illinois,Atlanta,1965,92,514,430,190,22,1248
Illinois,Lincoln,13738,978,3262,2970,1354,572,9136
Illinois,El Dara,70,0,10,34,9,3,56
Illinois,Dover,133,7,31,29,18,2,87
Illinois,Malden,275,21,115,52,11,8,207
Illinois,Tiskilwa,858,45,242,209,45,18,559
Illinois,Elizabethtown,261,15,78,60,12,5,170
Illinois,Hopkins Park,426,86,66,79,36,3,270
Illinois,Arrowsmith,299,2,81,74,20,6,183
Illinois,St. Anne,1361,128,300,224,97,24,773
Illinois,Carlock,549,21,110,107,59,20,317
Illinois,Thompsonville,604,47,141,162,39,5,394
Illinois,Huntley,26486,1141,4994,6234,4682,1976,19027
Illinois,Ridgway,877,74,258,211,67,8,618
Illinois,Kappa,245,11,44,24,47,10,136
Illinois,Lansing,28141,1860,5830,6843,3175,1398,19106
Illinois,La Grange Park,13491,422,1268,2339,2929,2288,9246
Illinois,Maywood,23810,2981,5356,5211,1403,740,15691
Illinois,Norridge,14888,1295,3606,3134,1845,1100,10980
Illinois,Northfield,5536,23,278,643,1652,1409,4005
Illinois,North Riverside,6813,317,1528,1513,878,520,4756
Illinois,Hodgkins,1967,441,454,282,109,45,1331
Illinois,River Forest,11064,121,352,1128,2620,2787,7008
Illinois,Skokie,64395,4575,8350,10908,13818,8421,46072
Illinois,Streamwood,40413,4117,8456,7946,5267,2209,27995
Illinois,Winnetka,12481,56,233,483,3208,3747,7727
Illinois,Golconda,781,116,261,167,45,19,608
Illinois,Camargo,595,40,137,167,76,20,440
Illinois,Belknap,113,10,38,14,5,0,67
Illinois,Rolling Meadows,23229,2273,3453,4560,4104,2188,16578
Illinois,Hillside,8096,833,2140,1880,692,305,5850
Illinois,Forest Park,14041,672,1768,3066,3131,2457,11094
Illinois,Evergreen Park,19666,816,3246,4586,2916,1715,13279
Illinois,Hecker,537,28,102,173,46,15,364
Illinois,Arenzville,465,24,123,85,52,16,300
Illinois,Bellwood,19112,1963,4507,4089,1567,770,12896
Illinois,Carbondale,25846,614,1661,4058,2397,3377,12107
Illinois,Walnut Hill,140,18,15,41,14,8,96
Illinois,O'Fallon,29277,644,3165,6324,4946,4307,19386
Illinois,Fults,25,1,10,6,4,0,21
Illinois,Darien,22126,655,2675,4719,5173,3021,16243
Illinois,Lake Zurich,19970,728,2010,3207,4402,2852,13199
Illinois,Lomax,394,45,108,108,31,0,292
Illinois,Percy,945,128,245,117,10,9,509
Illinois,Orion,2029,36,494,553,229,69,1381
Illinois,Calumet Park,8442,597,1835,2472,684,420,6008
Illinois,East Hazel Crest,1694,169,407,419,99,91,1185
Illinois,Tower Lakes,1205,6,101,142,315,213,777
Illinois,Vienna,1490,162,353,385,47,46,993
Illinois,Blandinsville,685,19,222,198,69,16,524
Illinois,Sciota,78,0,19,22,11,1,53
Illinois,Loves Park,24043,1477,5530,5572,2424,1343,16346
Illinois,Naperville,147411,2927,9807,18546,36706,29256,97242
Illinois,Frankfort Square,8638,237,1484,2167,1263,523,5674
Illinois,Diamond,2707,174,594,532,187,101,1588
Illinois,Crest Hill,20379,2594,4447,4716,1870,942,14569
Illinois,Coal City,5427,179,1484,1493,359,263,3778
Illinois,Sigel,399,16,101,101,38,14,270
Illinois,Danville,31554,2931,7789,6734,2081,1158,20693
Illinois,Scottville,109,9,52,15,6,4,86
Illinois,Chesterfield,206,7,63,37,14,5,126
Illinois,Henderson,250,19,57,94,14,6,190
Illinois,Calhoun,171,36,18,83,3,2,142
Illinois,Staunton,5036,232,1402,1330,429,151,3544
Illinois,Mount Olive,1996,161,597,536,117,24,1435
Illinois,Hettick,131,8,57,23,9,3,100
Illinois,Dorchester,120,6,53,34,7,6,106
Illinois,Rio,185,6,60,60,8,3,137
Illinois,Eureka,6114,301,1208,1070,921,438,3938
Illinois,Dix,362,48,94,103,25,13,283
Illinois,Xenia,422,29,71,126,18,1,245
Illinois,Prophetstown,2099,125,577,454,201,94,1451
Illinois,La Prairie,63,14,19,13,0,0,46
Illinois,Little York,305,31,78,77,22,0,208
Illinois,Kingston,1270,78,315,248,79,37,757
Illinois,Shorewood,17026,752,2694,3437,2701,1861,11445
Illinois,Cisco,246,14,89,49,23,13,188
Illinois,Hammond,485,54,119,139,19,5,336
Illinois,Brussels,154,17,52,40,9,3,121
Illinois,Hardin,759,109,266,146,16,12,549
Illinois,Cullom,650,31,188,129,25,25,398
Illinois,Brookport,882,116,258,251,31,28,684
Illinois,Chadwick,580,24,205,140,43,17,429
Illinois,Tamaroa,661,86,192,144,9,0,431
Illinois,Littleton,143,22,46,19,7,12,106
Illinois,Rushville,2841,191,878,558,284,126,2037
Illinois,Bluford,672,68,121,187,27,8,411
Illinois,Du Quoin,5818,476,1637,1335,354,216,4018
Illinois,Lake in the Hills,28832,1000,4064,6072,4866,1679,17681
Illinois,Richmond,1880,65,431,396,227,97,1216
Illinois,West York,104,0,18,52,6,0,76
Illinois,Twin Grove,1651,25,264,216,518,193,1216
Illinois,Westervelt,71,0,29,18,0,0,47
Illinois,West Union,394,20,96,95,34,16,261
Illinois,White Heath,243,30,66,73,14,0,183
Illinois,St. Rose,462,42,99,95,47,26,309
Illinois,The Galena Territory,1363,36,162,404,369,282,1253
Illinois,Garden Prairie,231,0,112,35,0,0,147
Illinois,Whiteash,229,27,42,65,18,19,171
Illinois,Secor,333,29,108,66,23,8,234
Illinois,Perry,297,11,96,99,5,17,228
Illinois,Pleasant Hill,1080,79,324,226,43,34,706
Illinois,Ohlman,112,6,52,11,3,10,82
Illinois,Pearl City,785,21,132,214,91,32,490
Illinois,Candlewick Lake,4877,231,1275,694,575,290,3065
Illinois,Seymour,304,0,64,38,30,0,132
Illinois,Rentchler,6,0,6,0,0,0,6
Illinois,Prestbury,1638,16,286,334,478,286,1400
Illinois,Grand Ridge,630,18,134,175,48,14,389
Illinois,Rutland,251,21,102,59,6,0,188
Illinois,Somonauk,2152,95,492,483,182,101,1353
Illinois,Tonica,725,38,182,195,51,20,486
Illinois,Kell,174,13,41,44,2,0,100
Illinois,Odin,1089,119,282,268,45,7,721
Illinois,Arthur,2622,342,575,530,191,149,1787
Illinois,Mitchell,1219,110,474,225,80,11,900
Illinois,Mulkeytown,181,24,7,53,0,19,103
Illinois,Oak Run,607,12,126,181,110,76,505
Illinois,Olive Branch,466,76,126,104,0,9,315
Illinois,Olivet,372,18,83,120,11,37,269
Illinois,Opdyke,249,11,52,103,4,3,173
Illinois,Paderborn,72,17,55,0,0,0,72
Illinois,Penfield,154,14,71,32,0,7,124
Illinois,Peoria Heights,5910,251,1193,1786,787,284,4301
Illinois,Spring Bay,445,10,156,120,35,6,327
Illinois,Coleta,212,11,40,34,5,22,112
Illinois,Erie,1438,25,402,360,152,49,988
Illinois,White City,234,16,99,37,28,2,182
Illinois,Sawyerville,276,29,83,46,9,3,170
Illinois,Modesto,212,22,84,33,5,15,159
Illinois,East Gillespie,214,6,86,68,16,7,183
Illinois,Benld,1616,127,428,415,108,41,1119
Illinois,St. Augustine,100,18,33,34,5,2,92
Illinois,Maquon,280,29,89,67,16,3,204
Illinois,London Mills,374,34,115,87,26,6,268
Illinois,Fayetteville,338,40,100,94,16,10,260
Illinois,Alorton,1965,187,529,317,74,27,1134
Illinois,Allenville,180,28,49,35,6,1,119
Illinois,Patoka,623,47,163,151,16,11,388
Illinois,Iuka,517,38,170,86,17,12,323
Illinois,Farina,630,87,190,143,36,26,482
Illinois,Troy Grove,261,14,60,88,7,7,176
Illinois,Fairmount,632,30,226,150,23,17,446
Illinois,Lerna,266,12,89,66,9,4,180
Illinois,Marshall,3401,157,863,839,315,153,2327
Illinois,Biggsville,316,11,121,78,26,8,244
Illinois,Longview,130,18,37,18,18,0,91
Illinois,Tolono,3086,31,544,745,475,137,1932
Illinois,Urbana,42375,927,3418,4779,5052,6728,20904
Illinois,Aroma Park,813,111,246,136,53,27,573
Illinois,Bloomingdale,22138,1267,3845,4982,4001,2155,16250
Illinois,Lombard,43904,1502,6666,7844,9003,5506,30521
Illinois,Farmer City,1926,117,455,552,209,88,1421
Illinois,Caseyville,4018,248,1139,848,317,88,2640
Illinois,Gays,216,12,64,59,10,12,157
Illinois,Dalton City,424,10,132,85,35,24,286
Illinois,Campbell Hill,303,17,78,76,24,10,205
Illinois,Hanaford,395,29,117,125,14,3,288
Illinois,Prairie du Rocher,538,40,177,166,19,8,410
Illinois,Earlville,1770,141,567,416,77,54,1255
Illinois,Coulterville,943,86,275,256,30,17,664
Illinois,Dieterich,629,55,165,129,57,24,430
Illinois,Pistakee Highlands,3253,91,965,870,300,76,2302
Illinois,Timberlane,1044,15,139,196,179,97,626
Illinois,Waterman,1567,45,362,419,132,74,1032
Illinois,McNabb,283,5,60,87,24,25,201
Illinois,Waverly,1286,106,455,201,86,46,894
Illinois,Meredosia,829,67,366,176,28,0,637
Illinois,Hudson,2073,31,272,422,389,167,1281
Illinois,Anchor,175,9,63,28,6,6,112
Illinois,Manteno,8652,432,1998,2046,1136,443,6055
Illinois,Armington,370,18,113,73,22,7,233
Illinois,Wheaton,53480,1404,3543,7830,12278,9738,34793
Illinois,Romeoville,39702,3478,6759,7927,4645,1200,24009
Illinois,Woodridge,33493,1010,3913,6670,7233,4546,23372
Illinois,Batavia,26282,865,2579,4935,5932,3520,17831
Illinois,Geneva,21799,344,2562,3574,4871,3871,15222
Illinois,Cary,17871,451,1976,4210,3656,1686,11979
Illinois,Wayne,2345,78,385,514,550,275,1802
Illinois,Westmont,25036,1392,3900,4905,4294,3417,17908
Illinois,Minier,1200,89,324,283,132,31,859
Illinois,East Dundee,3183,186,588,945,477,329,2525
Illinois,Elburn,5823,45,805,1046,1046,388,3330
Illinois,Menominee,235,7,56,58,23,13,157
Illinois,New Holland,268,15,71,73,28,6,193
Illinois,Keithsburg,619,89,246,86,15,8,444
Illinois,Time,10,2,7,1,0,0,10
Illinois,Valley City,22,0,0,9,0,0,9
Illinois,Golden Gate,77,7,24,28,0,0,59
Illinois,Milton,232,21,101,47,7,2,178
Illinois,Kinderhook,292,11,93,67,31,8,210
Illinois,Hull,510,22,197,123,13,10,365
Illinois,Viola,937,50,295,228,62,24,659
Illinois,Matherville,923,72,215,206,23,21,537
Illinois,Island Lake,8056,416,1706,1902,1088,415,5527
Illinois,New Haven,356,43,134,97,21,0,295
Illinois,Equality,551,66,176,158,29,4,433
Illinois,Hampshire,5852,86,495,1137,755,818,3291
Illinois,Fox Lake,10606,510,2676,2457,1203,555,7401
Illinois,Prairie Grove,1826,25,201,402,313,255,1196
Illinois,Butler,202,15,67,45,2,1,130
Illinois,Litchfield,7015,814,1631,1692,520,326,4983
Illinois,Waynesville,424,13,160,94,45,4,316
Illinois,Bolingbrook,74448,5271,11034,14042,11651,5737,47735
Illinois,Elwood,2396,63,750,566,213,65,1657
Illinois,Godley,651,65,204,151,19,2,441
Illinois,Matteson,19336,606,2588,5287,3075,1860,13416
Illinois,University Park,7115,210,1008,1976,821,446,4461
Illinois,Joliet,147957,14486,28483,28593,13627,6089,91278
Illinois,Lemont,16935,481,3216,3247,3166,1617,11727
Illinois,Hume,357,29,103,106,17,2,257
Illinois,Kansas,627,67,177,149,41,29,463
Illinois,Paris,8424,849,2361,1853,497,308,5868
Illinois,Bulpitt,199,19,66,35,4,4,128
Illinois,Tovey,514,50,156,85,28,17,336
Illinois,Augusta,465,13,177,111,30,16,347
Illinois,Caledonia,221,12,28,70,22,18,150
Illinois,Weldon,437,37,154,119,20,10,340
Illinois,Warsaw,1482,107,355,376,153,74,1065
Illinois,Gardner,1375,74,408,359,92,42,975
Illinois,Bull Valley,1267,25,186,202,307,216,936
Illinois,Elmwood,2292,140,467,521,281,140,1549
Illinois,Greenview,906,46,277,176,44,15,558
Illinois,Old Ripley,91,21,30,19,1,0,71
Illinois,Exeter,82,9,19,26,4,3,61
Illinois,Damiansville,587,73,99,162,54,24,412
Illinois,Kempton,231,9,79,59,11,2,160
Illinois,Bush,250,28,72,84,9,5,198
Illinois,Milford,1320,166,351,279,86,39,921
Illinois,Onarga,1079,172,248,213,54,5,692
Illinois,Sheridan,2628,665,575,642,38,7,1927
Illinois,Mundelein,31683,2279,4526,5274,5895,3784,21758
Illinois,Standard,266,28,69,77,7,4,185
Illinois,Lily Lake,1091,16,135,317,187,108,763
Illinois,Hoffman Estates,51282,2772,6313,8895,10726,6342,35048
Illinois,Burlington,668,24,127,139,100,52,442
Illinois,Morris,13983,744,2966,3607,1328,950,9595
Illinois,South Wilmington,911,59,260,226,45,14,604
Illinois,Evanston,75157,3182,5961,7327,13744,17829,48043
Illinois,Tilden,885,97,275,218,47,20,657
Illinois,Freeport,24300,1495,5843,6242,2076,1097,16753
Illinois,Germantown Hills,3478,55,375,772,849,283,2334
Illinois,Stewardson,723,23,230,167,54,19,493
Illinois,Strasburg,473,8,144,144,39,22,357
Illinois,Lakewood Shores,1381,80,448,412,41,43,1024
Illinois,Minooka,11291,362,1644,2442,1398,716,6562
Illinois,Orland Park,59100,2920,9963,11470,11334,7631,43318
Illinois,Karnak,462,52,110,112,11,2,287
Illinois,Rockdale,1932,215,503,403,98,61,1280
Illinois,Tinley Park,56898,2200,10990,13106,9207,4524,40027
Illinois,Wilmington,5913,280,1909,1331,425,192,4137
Illinois,McHenry,26740,1636,5437,6382,3205,1510,18170
Illinois,Lake Bluff,5612,49,209,495,1500,1547,3800
Illinois,Lake Villa,8762,90,1125,1414,1747,920,5296
Illinois,Lincolnshire,7469,203,641,976,1906,1843,5569
Illinois,Lindenhurst,14495,343,1650,2647,3027,1662,9329
Illinois,Symerton,105,4,29,25,4,2,64
Illinois,Oakland,1053,100,259,242,90,49,740
Illinois,Raymond,852,52,228,240,64,34,618
Illinois,Lakewood,3741,69,333,579,829,597,2407
Illinois,Hindsboro,434,40,114,137,17,4,312
Illinois,Rockford,147881,15784,29854,30881,12546,8760,97825
Illinois,Bradford,660,55,161,164,44,14,438
Illinois,Valmeyer,1320,26,264,308,203,61,862
Illinois,Pecatonica,2228,70,535,508,199,77,1389
Illinois,Bondville,455,23,149,108,40,6,326
Illinois,Ogden,760,33,148,223,88,48,540
Illinois,Fillmore,276,31,114,62,7,6,220
Illinois,Philo,1500,27,295,371,198,119,1010
Illinois,Thomasboro,1061,54,394,257,72,33,810
Illinois,East Brooklyn,90,2,42,30,7,0,81
Illinois,Georgetown,3316,260,1017,695,262,78,2312
Illinois,Sidell,429,42,157,92,14,3,308
Illinois,Westville,3288,214,789,669,238,109,2019
Illinois,Kinsman,140,9,29,43,7,0,88
Illinois,Crystal Lake,40170,1782,5845,8449,7378,3704,27158
Illinois,St. Joseph,4424,36,749,1016,536,429,2766
Illinois,Orient,415,72,136,108,15,7,338
Illinois,Royalton,1119,110,310,298,99,30,847
Illinois,Ava,602,58,189,147,14,11,419
Illinois,Long Lake,3415,358,709,699,366,86,2218
Illinois,Smithboro,216,4,60,59,5,0,128
Illinois,Breese,4453,147,740,1479,525,272,3163
Illinois,Westfield,728,29,207,194,27,14,471
Illinois,Altamont,2260,253,515,570,171,46,1555
Illinois,Lisbon,414,2,98,79,41,9,229
Illinois,Montgomery,19216,1466,2970,2834,2648,1407,11325
Illinois,Deer Park,3668,155,250,498,891,683,2477
Illinois,Amboy,2455,182,639,595,169,71,1656
Illinois,Waltonville,418,43,96,115,14,7,275
Illinois,Woodlawn,642,15,142,169,48,23,397
Illinois,Ashton,1081,55,342,248,84,18,747
Illinois,Riverdale,12786,1134,2804,2899,776,341,7954
Illinois,Decatur,72969,5817,17195,16491,6347,3921,49771
Illinois,Oreana,728,31,209,179,71,28,518
Illinois,Hanna City,1268,50,387,372,99,62,970
Illinois,Ina,2495,863,713,477,48,11,2112
Illinois,Channel Lake,1470,111,399,334,154,69,1067
Illinois,Arlington Heights,75724,2309,8629,12814,20111,12123,55986
Illinois,Antioch,14305,366,2420,3355,2224,1045,9410
Illinois,Elkville,910,59,212,206,60,22,559
Illinois,Dana,95,9,32,24,4,4,73
Illinois,Kangley,220,14,78,36,18,11,157
Illinois,Alma,327,24,80,95,7,9,215
Illinois,Marissa,1641,122,473,462,72,55,1184
Illinois,Sullivan,4538,288,988,1139,400,234,3049
Illinois,Brooklyn,469,56,112,99,15,9,291
Illinois,Madison,3714,678,936,896,85,26,2621
Illinois,Chester,8410,2266,2207,1563,374,168,6578
Illinois,Hinckley,2083,108,382,598,227,109,1424
Illinois,Boulder Hill,9179,582,2104,2162,729,418,5995
Illinois,Niantic,459,37,159,115,37,12,360
Illinois,Evansville,715,51,207,147,28,16,449
Illinois,Ruma,308,12,89,63,15,20,199
Illinois,Tamms,658,72,185,146,33,38,474
Illinois,Hooppole,236,18,60,64,4,3,149
Illinois,Kewanee,12570,1490,2987,2657,873,416,8423
Illinois,Willow Springs,5696,282,1162,1279,1067,427,4217
Illinois,Naplate,462,35,161,130,11,4,341
Illinois,Western Springs,13227,99,532,1200,3644,2987,8462
Illinois,Palos Heights,12534,460,2206,2614,2413,1809,9502
Illinois,Fairfield,5077,447,1263,1204,441,141,3496
Illinois,Beecher City,372,33,106,92,24,5,260
Illinois,Gulf Port,29,4,16,6,2,0,28
Illinois,Brocton,383,29,139,74,26,21,289
Illinois,Hainesville,3656,80,517,822,586,326,2331
Illinois,Deer Grove,57,0,18,17,0,4,39
Illinois,Beecher,4382,214,983,1220,549,149,3115
Illinois,Cantrall,223,3,21,35,43,23,125
Illinois,Preston Heights,2565,384,605,434,162,69,1654
Illinois,Hillsboro,6840,1009,1830,1750,481,333,5403
Illinois,Deer Creek,659,20,146,181,52,14,413
Illinois,Mark,544,14,151,191,35,21,412
Illinois,Bardolph,328,18,104,69,17,5,213
Illinois,South Beloit,7827,588,1808,1500,626,259,4781
Illinois,Hamburg,102,15,24,16,11,2,68
Illinois,St. Johns,257,30,66,70,16,4,186
Illinois,Enfield,549,40,182,140,11,9,382
Illinois,Belleville,41926,2039,8297,11434,4320,2453,28543
Illinois,Palmer,207,15,66,39,22,0,142
Illinois,Plainfield,43048,971,4742,6798,8375,4804,25690
Illinois,Manchester,259,6,116,54,10,5,191
Illinois,Lisle,23435,393,2312,3867,5502,4324,16398
Illinois,Princeton,7662,333,1898,1880,856,545,5512
Illinois,Sugar Grove,9545,124,1636,1958,1962,970,6650
Illinois,Belle Prairie City,69,4,13,26,6,1,50
Illinois,Fairbury,3597,190,1123,773,130,190,2406
Illinois,Kingston Mines,307,27,93,78,13,8,219
Illinois,Franklin Grove,955,94,244,238,85,24,685
Illinois,Sheldon,1305,123,441,288,43,32,927
Illinois,Wyanet,1024,48,291,252,42,11,644
Illinois,Metamora,3835,183,605,776,723,199,2486
Illinois,Fairmont,2641,255,821,481,181,51,1789
Illinois,Rock Falls,8911,878,2577,1968,349,245,6017
Illinois,Carol Stream,39989,2590,5829,7925,7708,3270,27322
Illinois,Humboldt,500,42,136,158,11,5,352
Illinois,Sherman,4440,115,562,1245,989,353,3264
Illinois,Ivesdale,232,17,75,56,21,7,176
Illinois,Savanna,2977,249,979,644,192,135,2199
Illinois,Braceville,779,47,229,158,31,8,473
Illinois,Blue Mound,1142,95,282,212,45,35,669
Illinois,Clay City,849,36,234,167,63,3,503
Illinois,Bingham,100,28,30,9,1,2,70
Illinois,Alpha,555,24,142,136,51,22,375
Illinois,Atkinson,1281,61,326,280,84,21,772
Illinois,Cambridge,2238,155,544,654,175,88,1616
Illinois,Woodhull,817,19,268,212,73,12,584
Illinois,Barrington,10304,424,700,1393,2434,2203,7154
Illinois,Wamac,1178,181,281,248,25,7,742
Illinois,Mahomet,8327,86,872,1502,1622,1164,5246
Illinois,Sadorus,321,42,99,76,21,15,253
Illinois,Burr Ridge,10795,145,750,1807,2512,2992,8206
Illinois,Downers Grove,49644,1219,5366,9249,11492,7991,35317
Illinois,McCook,261,17,75,61,12,22,187
Illinois,Mount Prospect,55127,3978,8199,9940,10745,5557,38419
Illinois,Oak Forest,27843,1759,5473,6724,3663,1851,19470
Illinois,Olympia Fields,5055,132,563,1126,931,1061,3813
Illinois,Oak Brook,8122,214,854,1107,2039,2304,6518
Illinois,New Minden,163,8,56,62,17,4,147
Illinois,Harrisburg,8958,917,1784,2560,626,399,6286
Illinois,Mount Morris,2841,246,604,592,274,273,1989
Illinois,Plano,11766,1044,1865,2790,991,310,7000
Illinois,Yorkville,19145,698,2778,4322,2031,1899,11728
Illinois,Harristown,1143,87,376,264,96,23,846
Illinois,Macon,1152,51,383,263,82,34,813
Illinois,Warrensburg,1506,53,276,341,124,72,866
Illinois,Alto Pass,278,67,40,70,35,7,219
Illinois,Flora,4842,384,1284,1149,328,214,3359
Illinois,Andover,563,59,131,134,32,13,369
Illinois,Annawan,895,44,255,212,93,36,640
Illinois,Deerfield,18930,95,775,1820,4938,4918,12546
Illinois,Bethalto,9311,331,2241,2716,888,535,6711
Illinois,East Alton,6099,673,1464,1320,630,141,4228
Illinois,Mendon,915,63,257,211,97,23,651
Illinois,Mount Auburn,562,14,177,134,51,9,385
Illinois,Rapids City,1047,58,218,241,134,58,709
Illinois,Alhambra,628,74,154,161,64,14,467
Illinois,Green Oaks,3851,113,368,509,758,794,2542
Illinois,South Barrington,4872,102,222,653,1134,1154,3265
Illinois,Auburn,4805,355,1210,996,452,180,3193
Illinois,Princeville,2073,105,413,542,217,67,1344
Illinois,Mechanicsburg,729,24,218,166,61,15,484
Illinois,De Soto,1635,156,360,371,128,99,1114
Illinois,Makanda,575,6,70,144,74,106,400
Illinois,Lee,335,16,67,90,29,11,213
Illinois,Sublette,454,22,140,125,29,11,327
Illinois,Buffalo,560,31,173,102,54,9,369
Illinois,Chatham,12535,96,1479,2619,2723,1338,8255
Illinois,Poplar Grove,4757,142,762,849,613,308,2674
Illinois,Rochester,3696,54,501,572,743,533,2403
Illinois,Cedar Point,296,11,99,68,9,4,191
Illinois,Lostant,472,35,104,107,47,15,308
Illinois,Central City,1259,91,321,372,49,11,844
Illinois,Sandoval,1269,157,240,291,68,16,772
Illinois,Sims,138,22,55,25,4,0,106
Illinois,Oneida,708,8,144,197,97,33,479
Illinois,Cisne,598,94,129,191,25,9,448
Illinois,Belvidere,25319,3051,5972,4548,1610,819,16000
Illinois,Ferris,106,9,44,27,10,0,90
Illinois,Sesser,1737,109,384,559,124,24,1200
Illinois,Addieville,344,32,83,66,29,12,222
Illinois,Dixmoor,3657,513,737,668,181,104,2203
Illinois,Oakwood,1770,74,481,438,118,53,1164
Illinois,Sleepy Hollow,3319,120,471,697,691,406,2385
Illinois,Schram City,632,91,228,122,23,11,475
Illinois,Tower Hill,790,45,271,104,37,13,470
Illinois,Winthrop Harbor,6767,321,1270,1827,1121,381,4920
Illinois,Villa Grove,2332,152,525,656,215,80,1628
Illinois,Rockton,7692,220,1551,1809,1060,621,5261
Illinois,Flat Rock,338,21,88,99,20,8,236
Illinois,Dawson,667,51,223,138,72,4,488
Illinois,Orland Hills,7181,200,1229,1673,834,540,4476
Illinois,Wheeler,175,8,40,28,16,0,92
Illinois,La Rose,105,4,46,28,5,0,83
Illinois,Northbrook,33463,699,2841,4113,9157,8028,24838
Illinois,Girard,1862,100,514,406,135,71,1226
Illinois,Ripley,53,9,14,10,0,0,33
Illinois,Mount Clare,266,25,112,51,15,8,211
Illinois,Wilmette,27419,263,942,2187,5996,8941,18329
Illinois,Stillman Valley,1091,49,232,232,103,60,676
Illinois,Galatia,833,81,210,246,59,8,604
Illinois,Hoyleton,598,31,106,131,64,13,345
Illinois,Kirkwood,721,41,208,157,43,11,460
Illinois,Oblong,1313,100,365,314,87,42,908
Illinois,Canton,13789,1611,2904,4032,1024,609,10180
Illinois,Adeline,111,11,40,23,2,1,77
Illinois,Dunfermline,388,43,88,88,16,6,241
Illinois,Rose Hill,84,13,23,15,5,2,58
Illinois,Russellville,94,16,38,17,4,2,77
Illinois,Forreston,1651,84,397,460,89,55,1085
Illinois,East Moline,21373,2355,4594,4874,2101,886,14810
Illinois,Muddy,48,6,10,25,2,0,43
Illinois,Ashley,538,78,141,114,22,3,358
Illinois,Ipava,491,20,181,98,44,8,351
Illinois,Lacon,1815,71,676,371,110,57,1285
Illinois,Farmington,2454,132,503,641,228,104,1608
Illinois,Avon,767,53,204,228,22,21,528
Illinois,Palatine,68847,4498,7711,12245,15158,8869,48481
Illinois,Rosemont,4315,610,751,886,372,248,2867
Illinois,South Holland,21866,1193,3850,5721,2138,1745,14647
Illinois,Cherry,469,18,155,96,35,5,309
Illinois,De Pue,1651,284,445,192,93,21,1035
Illinois,Mineral,231,17,90,52,11,2,172
Illinois,Harvey,24599,3268,5617,4913,1192,372,15362
Illinois,Justice,12919,1485,2972,2511,787,440,8195
Illinois,Kenilworth,2512,25,17,87,605,768,1502
Illinois,Lincolnwood,12539,715,1740,1710,3035,2053,9253
Illinois,Maeystown,104,8,7,31,14,3,63
Illinois,Waterloo,10268,311,2190,2647,1361,734,7243
Illinois,Wyoming,1365,90,362,364,98,45,959
Illinois,Lake Summerset,2019,0,561,573,338,143,1615
Illinois,Roscoe,10575,389,1698,2346,1315,873,6621
Illinois,Shipman,624,27,218,112,40,21,418
Illinois,Creston,665,50,157,176,44,21,448
Illinois,Stoy,87,3,26,26,7,2,64
Illinois,Table Grove,501,18,148,70,18,6,260
Illinois,Compton,299,36,80,73,12,9,210
Illinois,Divernon,1098,24,348,287,111,17,787
Illinois,Keenes,67,7,33,16,1,0,57
Illinois,Mount Erie,74,8,13,28,6,0,55
Illinois,Leland Grove,1457,15,108,261,364,432,1180
Illinois,Prairie City,413,43,135,77,23,9,287
Illinois,La Fayette,207,7,77,53,5,0,142
Illinois,Apple River,415,32,114,66,21,12,245
Illinois,Winslow,313,10,115,74,18,2,219
Illinois,Hanover,645,71,218,175,28,10,502
Illinois,Florence,61,7,19,20,4,0,50
Illinois,New Canton,363,45,116,81,10,2,254
Illinois,Arlington,212,21,78,40,9,9,157
Illinois,La Moille,771,25,193,225,48,17,508
Illinois,Manlius,347,25,120,85,16,4,250
Illinois,Neponset,539,31,139,160,25,9,364
Illinois,Jewett,288,49,107,46,9,2,213
Illinois,Winnebago,3425,76,647,830,436,249,2238
Illinois,Findlay,728,34,251,183,52,3,523
Illinois,Old Shawneetown,100,18,26,15,0,0,59
Illinois,Orangeville,803,54,233,182,52,33,554
Illinois,Benson,496,23,126,106,49,11,315
Illinois,Ottawa,18701,1549,4330,4305,1584,967,12735
Illinois,Basco,77,0,34,28,2,0,64
Illinois,Bismarck,614,17,153,152,49,32,403
Illinois,Gillespie,3045,281,867,787,217,52,2204
Illinois,Nilwood,204,27,93,38,10,0,168
Illinois,Palmyra,651,70,206,157,16,0,449
Illinois,Harwood Heights,8552,810,1684,1993,1491,546,6524
Illinois,Chicago Heights,30087,3969,5484,6483,1873,1094,18903
Illinois,Dixon,15496,1737,3214,4452,1053,780,11236
Illinois,Chicago Ridge,14254,1123,3684,2883,1161,479,9330
Illinois,Homewood,19592,509,2488,4736,3643,2161,13537
Illinois,Roseville,923,30,274,264,115,48,731
Illinois,Spring Grove,5792,106,1120,1756,867,332,4181
Illinois,Woodstock,25198,2083,4531,5417,2730,1700,16461
Illinois,Witt,896,41,302,187,50,12,592
Illinois,Mound City,653,78,174,150,24,18,444
Illinois,Mounds,926,104,226,218,20,11,579
Illinois,Pulaski,264,29,38,95,11,0,173
Illinois,Elmwood Park,24680,2248,4848,5646,3181,1429,17352
Illinois,Omaha,280,34,98,50,15,3,200
Illinois,Park City,7456,1251,1725,736,293,74,4079
Illinois,Coatsburg,186,9,58,56,12,0,135
Illinois,Glenview,47333,1336,4258,6246,11016,10483,33339
Illinois,Chatsworth,1196,125,379,204,38,29,775
Illinois,Allendale,698,37,132,203,31,7,410
Illinois,Greenup,1705,191,452,376,87,57,1163
Illinois,Potomac,807,32,238,121,63,5,459
Illinois,Clayton,634,86,209,109,23,8,435
Illinois,Bridgeview,16440,1982,4282,2870,1179,724,11037
Illinois,Carrier Mills,1938,233,441,511,87,50,1322
Illinois,Galesburg,30986,2828,7712,6905,2151,1498,21094
Illinois,Sauk Village,10516,554,2248,2333,659,96,5890
Illinois,Kaskaskia,10,0,4,1,1,0,6
Illinois,Ransom,386,11,130,100,16,8,265
Illinois,Topeka,106,14,31,14,5,15,79
Illinois,Bluffs,759,19,251,149,52,11,482
Illinois,Norris,140,14,45,35,9,3,106
Illinois,Abingdon,3452,356,1101,708,182,49,2396
Illinois,Catlin,2077,60,526,488,263,68,1405
Illinois,Brighton,2215,119,486,655,192,40,1492
Indiana,Center Point,303,12,98,70,13,3,196
Indiana,Mount Summit,468,28,102,122,29,24,305
Indiana,Lewisville,408,32,119,94,23,6,274
Indiana,Royal Center,828,52,256,151,46,31,536
Indiana,Madison,11890,880,3307,2603,1029,681,8500
Indiana,Memphis,935,12,260,201,139,15,627
Indiana,San Pierre,65,0,30,5,11,0,46
Indiana,New Haven,16047,1263,3781,3869,1304,418,10635
Indiana,Amo,530,70,87,114,48,3,322
Indiana,Etna Green,585,59,182,123,45,3,412
Indiana,Delphi,3139,387,853,617,212,123,2192
Indiana,Toad Hop,178,44,13,24,0,0,81
Indiana,Vallonia,323,78,129,46,33,8,294
Indiana,Waldron,533,41,218,149,35,0,443
Indiana,West Point,582,19,95,169,0,47,330
Indiana,Wheeler,366,129,153,36,0,9,327
Indiana,Williams,283,0,154,18,17,16,205
Indiana,Fishers,88717,1197,5971,12406,23057,13715,56346
Indiana,Westfield,37769,700,3364,6225,8906,4407,23602
Indiana,Fredericksburg,137,37,2,25,0,0,64
Indiana,Fillmore,646,36,254,132,18,9,449
Indiana,Orleans,2249,288,847,296,94,33,1558
Indiana,Albion,2472,214,800,445,140,25,1624
Indiana,Denver,463,62,158,83,33,7,343
Indiana,Evansville,118952,10766,28609,25594,11678,5705,82352
Indiana,Michiana Shores,231,4,39,52,52,56,203
Indiana,Elkhart,52308,7828,11951,8787,3081,1524,33171
Indiana,Advance,459,44,136,81,30,7,298
Indiana,Yeoman,118,18,33,19,3,6,79
Indiana,Montpelier,1837,203,609,407,59,14,1292
Indiana,Poseyville,1070,57,332,247,78,49,763
Indiana,Vincennes,17607,1730,3707,3504,1070,666,10677
Indiana,Burket,158,23,58,25,0,2,108
Indiana,Westphalia,82,9,15,17,21,0,62
Indiana,Chesterfield,2336,157,872,493,114,66,1702
Indiana,Van Bibber Lake,765,179,278,113,31,0,601
Indiana,Larwill,376,47,102,71,9,1,230
Indiana,Holton,548,53,177,78,13,5,326
Indiana,Riley,246,17,83,41,14,8,163
Indiana,Bristol,1577,105,491,358,83,94,1131
Indiana,Norway,560,86,189,123,35,8,441
Indiana,Darmstadt,1272,28,227,309,246,156,966
Indiana,Arcadia,1370,84,424,220,90,51,869
Indiana,Fairview Park,1167,88,383,230,80,41,822
Indiana,Universal,252,55,80,47,9,6,197
Indiana,Newburgh,3253,160,602,765,529,247,2303
Indiana,Windfall City,736,93,243,100,30,8,474
Indiana,Ingalls,2282,201,385,529,183,79,1377
Indiana,Wingate,248,30,80,29,14,2,155
Indiana,Clermont,1401,74,302,338,248,90,1052
Indiana,Elizabeth,157,18,51,23,11,5,108
Indiana,Aurora,3678,453,983,746,229,89,2500
Indiana,Hidden Valley,5449,188,1013,929,734,581,3445
Indiana,Francesville,963,22,365,208,70,17,682
Indiana,New Albany,36512,3797,8014,8018,3318,2110,25257
Indiana,Crandall,146,10,25,26,11,5,77
Indiana,Alamo,62,7,7,14,1,1,30
Indiana,New Ross,477,64,96,90,23,17,290
Indiana,Brooklyn,1403,147,372,363,80,32,994
Indiana,Cordry Sweetwater Lakes,1224,94,188,302,181,132,897
Indiana,Country Squire Lakes,3067,536,951,498,52,48,2085
Indiana,Whitestown,7220,208,357,1301,1932,760,4558
Indiana,Brownsburg,25264,1413,4212,5114,4172,2110,17021
Indiana,Crown Point,29368,1728,6004,6516,4670,2216,21134
Indiana,Merom,240,10,77,58,11,2,158
Indiana,Modoc,208,7,66,40,2,0,115
Indiana,Medora,600,88,190,80,15,18,391
Indiana,Jasper,15765,961,3898,3168,2072,770,10869
Indiana,Akron,1196,174,266,151,42,47,680
Indiana,Hebron,3690,194,1037,608,206,66,2111
Indiana,Leo-Cedarville,3767,166,708,800,498,85,2257
Indiana,Greensboro,148,4,41,20,3,1,69
Indiana,Montgomery,429,69,117,69,34,14,303
Indiana,De Motte,4026,342,1349,946,253,60,2950
Indiana,Holland,694,30,203,122,57,14,426
Indiana,Hammond,77071,9191,18400,13842,4982,1880,48295
Indiana,Dublin,665,64,234,140,53,8,499
Indiana,Deputy,45,0,29,16,0,0,45
Indiana,Danville,9791,521,1861,1766,1296,650,6094
Indiana,West Lebanon,638,48,209,146,23,24,450
Indiana,Clarks Hill,766,81,220,168,9,7,485
Indiana,Georgetown,3231,55,548,751,487,173,2014
Indiana,Kingman,530,77,164,85,26,11,363
Indiana,North Crows Nest,47,1,1,2,14,14,32
Indiana,Tennyson,282,47,94,41,6,0,188
Indiana,Kingsbury,203,34,70,29,5,0,138
Indiana,Avilla,2204,121,659,467,214,21,1482
Indiana,Greentown,2564,180,667,601,218,109,1775
Indiana,Leesburg,822,79,205,184,37,7,512
Indiana,Monon,1906,439,375,271,68,15,1168
Indiana,Lynn,1135,73,295,287,63,47,765
Indiana,Pierceton,910,99,294,137,84,30,644
Indiana,Tecumseh,779,0,173,213,85,62,533
Indiana,Dover Hill,13,0,13,0,0,0,13
Indiana,Dubois,127,16,106,0,0,0,122
Indiana,New Goshen,443,9,148,208,23,0,388
Indiana,New Salisbury,498,44,175,107,59,20,405
Indiana,New Trenton,225,127,88,0,0,0,215
Indiana,Notre Dame,6584,12,35,75,297,229,648
Indiana,Otwell,351,76,82,73,60,8,299
Indiana,Owensburg,648,37,156,184,51,13,441
Indiana,Painted Hills,627,0,202,151,47,16,416
Indiana,Parkers Settlement,630,13,159,224,42,14,452
Indiana,Point Isabel,181,0,57,31,10,0,98
Indiana,Raglesville,0,0,0,0,0,0,0
Indiana,Ragsdale,220,19,41,97,0,23,180
Indiana,Rolling Prairie,529,3,137,88,59,55,342
Indiana,St. Bernice,451,63,194,60,0,7,324
Indiana,St. Mary of the Woods,881,99,212,154,90,52,607
Indiana,St. Meinrad,731,0,326,92,33,57,508
Indiana,Salt Creek Commons,2125,174,560,328,123,54,1239
Indiana,Scipio,139,0,62,36,19,0,117
Indiana,Scotland,170,0,69,19,10,0,98
Indiana,Shelby,357,62,107,28,13,14,224
Indiana,Shepardsville,177,0,86,39,10,0,135
Indiana,Shorewood Forest,2742,75,413,494,537,418,1937
Indiana,Sims,111,0,52,8,0,0,60
Indiana,Smithville-Sanders,3285,252,374,707,724,412,2469
Indiana,Somerset,478,43,197,59,41,43,383
Indiana,Stockwell,385,0,98,91,18,22,229
Indiana,Montmorenci,332,0,37,88,28,51,204
Indiana,Milroy,645,147,259,39,10,5,460
Indiana,Mier,47,0,14,0,0,33,47
Indiana,Metamora,177,40,86,24,0,10,160
Indiana,East Enterprise,192,64,43,45,0,0,152
Indiana,Emison,198,50,75,49,0,0,174
Indiana,Fish Lake,1596,237,625,236,116,42,1256
Indiana,Florence,42,0,14,0,0,0,14
Indiana,Fontanet,286,0,164,61,9,29,263
Indiana,Freelandville,890,35,323,172,7,81,618
Indiana,Freetown,255,39,88,17,0,0,144
Indiana,Hanna,307,10,77,92,38,16,233
Indiana,Harlan,1540,192,270,272,103,26,863
Indiana,Harrodsburg,795,57,158,145,106,53,519
Indiana,Hatfield,879,68,239,132,8,6,453
Indiana,Hayden,835,0,253,161,26,0,440
Indiana,Dresser,32,4,5,13,0,0,22
Indiana,Herbst,93,0,25,31,6,5,67
Indiana,Hoagland,885,20,287,157,111,16,591
Indiana,Howe,399,17,161,35,41,16,270
Indiana,Hudson Lake,1549,82,496,380,120,18,1096
Indiana,Idaville,555,44,164,96,0,6,310
Indiana,Jalapa,209,14,195,0,0,0,209
Indiana,Kent,72,0,40,0,0,0,40
Indiana,Kimmell,510,57,120,84,25,0,286
Indiana,Lake Holiday,1102,21,349,275,147,35,827
Indiana,Lake Santee,907,9,246,215,110,95,675
Indiana,Laketon,478,51,114,63,22,20,270
Indiana,Landess,53,7,25,0,14,7,53
Indiana,Manilla,315,22,166,19,6,6,219
Indiana,Heritage Lake,3152,76,560,902,332,372,2242
Indiana,Granger,30815,589,3822,5025,6292,4954,20682
Indiana,Spurgeon,143,9,72,24,6,0,111
Indiana,Portage,36859,2803,10185,8285,2601,1353,25227
Indiana,Coatesville,609,76,169,66,73,14,398
Indiana,Jamestown,928,47,206,185,103,60,601
Indiana,Stilesville,261,13,107,68,22,6,216
Indiana,Mentone,1193,89,332,191,58,28,698
Indiana,Nappanee,6872,594,1815,1330,454,338,4531
Indiana,Middlebury,3572,253,483,946,453,253,2388
Indiana,Sidney,72,7,19,21,1,0,48
Indiana,Bruceville,448,25,135,125,7,2,294
Indiana,Brazil,8288,624,2239,1641,504,241,5249
Indiana,Lizton,512,8,128,110,74,8,328
Indiana,Oolitic,1184,146,394,229,41,18,828
Indiana,Collegeville,562,0,0,15,0,12,27
Indiana,Camden,556,37,163,149,15,5,369
Indiana,Gosport,823,86,313,93,20,48,560
Indiana,Rosedale,751,51,164,194,44,26,479
Indiana,Lakes of the Four Seasons,7243,203,1506,1924,999,404,5036
Indiana,Ogden Dunes,1123,7,99,175,320,324,925
Indiana,Newtown,311,18,103,66,14,14,215
Indiana,Veedersburg,2059,226,675,385,56,61,1403
Indiana,Switz City,250,37,76,43,5,4,165
Indiana,Worthington,1178,124,383,268,60,52,887
Indiana,Fowlerton,310,31,116,45,15,1,208
Indiana,Shamrock Lakes,286,6,68,74,27,19,194
Indiana,Mount Auburn,106,7,34,26,8,4,79
Indiana,Fountain City,747,60,222,192,29,7,510
Indiana,East Germantown,339,27,139,86,4,7,263
Indiana,Elizabethtown,528,52,197,48,7,2,306
Indiana,Corunna,240,30,88,26,13,2,159
Indiana,Greenfield,21871,1321,5661,4376,2306,1011,14675
Indiana,New Palestine,2235,67,448,462,405,148,1530
Indiana,Jeffersonville,47175,2926,10911,11610,5011,2399,32857
Indiana,New Washington,654,23,137,173,84,6,423
Indiana,Brooksburg,134,25,52,13,5,0,95
Indiana,Whiting,4845,485,1460,742,379,156,3222
Indiana,Dune Acres,172,4,7,27,43,62,143
Indiana,Porter,4833,155,1182,802,652,378,3169
Indiana,Vera Cruz,118,11,38,18,8,0,75
Indiana,Bloomfield,2126,270,660,533,141,33,1637
Indiana,Fairmount,2871,312,816,627,115,38,1908
Indiana,Birdseye,521,54,156,70,17,3,300
Indiana,State Line City,195,13,76,42,7,5,143
Indiana,Boswell,775,112,244,137,16,4,513
Indiana,Grabill,1325,33,338,351,134,42,898
Indiana,Lake Dalecarlia,1690,13,524,537,69,12,1155
Indiana,Dunreith,177,10,60,28,3,5,106
Indiana,Middletown,2554,205,826,483,176,48,1738
Indiana,Highland,22743,1001,5545,5237,3143,1521,16447
Indiana,Lake Station,12059,1763,3611,1848,341,192,7755
Indiana,St. John,16839,409,3009,3420,2788,1528,11154
Indiana,Matthews,664,86,237,144,16,5,488
Indiana,Sweetser,1452,86,516,244,147,55,1048
Indiana,Laconia,83,9,14,51,0,2,76
Indiana,Mauckport,62,6,18,13,0,0,37
Indiana,Greenwood,56791,3323,11041,11010,7832,3132,36338
Indiana,Tipton,5137,539,1590,772,516,155,3572
Indiana,Pine Village,213,10,78,38,18,1,145
Indiana,Williamsport,1814,150,548,391,113,43,1245
Indiana,Whiteland,4394,126,1063,882,588,221,2880
Indiana,Stinesville,223,16,62,55,16,15,164
Indiana,Alexandria,5025,557,1281,1097,316,115,3366
Indiana,East Chicago,28448,5145,6269,4556,1130,462,17562
Indiana,Winamac,2710,222,718,590,157,80,1767
Indiana,Lafayette,72444,5684,14304,16036,7722,4081,47827
Indiana,Hagerstown,1826,99,364,466,181,81,1191
Indiana,West Terre Haute,2216,298,542,528,29,30,1427
Indiana,Centerville,2562,200,562,617,206,85,1670
Indiana,Economy,133,26,35,28,6,4,99
Indiana,Bedford,13285,1040,3892,2984,887,582,9385
Indiana,Lake Village,851,65,244,135,36,27,507
Indiana,Morocco,1067,96,311,206,37,41,691
Indiana,French Lick,1832,274,541,264,83,31,1193
Indiana,Greencastle,10461,647,2457,1510,482,436,5532
Indiana,Russellville,356,45,112,41,8,2,208
Indiana,Patoka,1233,90,367,226,82,23,788
Indiana,Princeton,8627,678,2213,2126,434,221,5672
Indiana,West Harrison,240,31,77,35,3,0,146
Indiana,Crows Nest,98,0,0,6,19,35,60
Indiana,Columbus,47227,2474,7999,8102,7386,5665,31626
Indiana,Hymera,757,91,272,144,18,0,525
Indiana,Chesterton,13899,572,2732,3139,1907,1134,9484
Indiana,Muncie,69164,5125,12527,11440,4905,4141,38138
Indiana,Spencer,2272,216,555,576,133,47,1527
Indiana,Marshall,235,19,87,56,10,5,177
Indiana,Montezuma,990,98,308,198,30,19,653
Indiana,Bluffton,9855,576,2629,2360,629,395,6589
Indiana,Ossian,3361,210,773,811,271,127,2192
Indiana,Uniondale,331,20,83,65,19,6,193
Indiana,Zanesville,611,44,195,139,31,22,431
Indiana,Elwood,8449,929,2615,1622,389,203,5758
Indiana,Oxford,1165,93,366,213,81,23,776
Indiana,Chrisney,724,38,157,207,56,22,480
Indiana,Bryant,173,10,75,29,6,2,122
Indiana,Redkey,1561,155,488,338,62,29,1072
Indiana,Bargersville,6950,352,1239,1221,1009,479,4300
Indiana,Galena,1566,68,372,295,245,70,1050
Indiana,Lanesville,675,13,172,140,92,26,443
Indiana,Darlington,822,89,221,169,83,15,577
Indiana,Trafalgar,1286,50,347,267,74,28,766
Indiana,Markleville,474,32,136,116,35,6,325
Indiana,Dayton,1569,93,422,437,97,39,1088
Indiana,West Lafayette,47224,664,1468,2238,4009,6901,15280
Indiana,Chandler,3424,178,973,714,144,66,2075
Indiana,Burns Harbor,1605,38,461,286,232,53,1070
Indiana,Rensselaer,5757,690,1506,1132,440,202,3970
Indiana,Cannelburg,174,41,48,37,0,1,127
Indiana,Dugger,787,42,280,172,47,9,550
Indiana,Remington,1350,151,423,255,100,65,994
Indiana,Albany,2005,125,630,450,187,61,1453
Indiana,Edwardsport,326,33,117,61,14,6,231
Indiana,Syracuse,2883,357,602,558,264,127,1908
Indiana,Winona Lake,4921,167,622,727,764,536,2816
Indiana,Oaktown,674,36,230,140,11,16,433
Indiana,Wolcott,1095,58,307,226,103,13,707
Indiana,Highland,4846,127,1108,1052,706,353,3346
Indiana,Buffalo,729,57,290,134,5,41,527
Indiana,Chalmers,499,14,133,114,45,8,314
Indiana,West College Corner,620,55,172,95,53,28,403
Indiana,McCordsville,6523,25,479,1158,1907,663,4232
Indiana,Lakeville,828,72,225,194,27,24,542
Indiana,Roseland,475,24,149,72,64,36,345
Indiana,South Haven,5159,383,1653,1135,171,115,3457
Indiana,Mooresville,9604,827,2742,2078,591,289,6527
Indiana,Churubusco,1800,87,422,454,137,44,1144
Indiana,Lagro,479,52,145,81,7,3,288
Indiana,Kouts,1972,89,566,371,250,80,1356
Indiana,Town of Pines,691,74,248,151,42,32,547
Indiana,Valparaiso,32916,1128,5555,6154,5387,3244,21468
Indiana,Gas City,5844,507,1761,1298,243,139,3948
Indiana,Marion,28118,2847,7136,5245,1378,1085,17691
Indiana,Bethany,60,9,19,16,2,0,46
Indiana,Connersville,13069,1900,3951,2285,707,215,9058
Indiana,Swayzee,896,61,255,202,79,52,649
Indiana,Hamlet,613,84,204,86,36,11,421
Indiana,Richmond,35653,3784,8722,7261,2398,1967,24132
Indiana,Covington,2424,171,764,457,204,145,1741
Indiana,Hillsboro,560,50,170,101,27,8,356
Indiana,Jasonville,1749,167,501,333,52,35,1088
Indiana,Carbon,470,20,198,48,13,2,281
Indiana,Oldenburg,542,36,121,74,115,92,438
Indiana,Burlington,510,9,153,155,45,22,384
Indiana,Grissom AFB,2452,178,592,589,130,51,1540
Indiana,Peru,11460,1250,3151,2300,598,188,7487
Indiana,New Chicago,1653,320,462,336,57,2,1177
Indiana,Gary,76677,7621,19571,16959,4063,2644,50858
Indiana,Hobart,28309,1938,7021,6327,2900,1225,19411
Indiana,Munster,22840,798,4026,4063,4652,2604,16143
Indiana,Lawrence,48405,4227,8018,8954,7268,3247,31714
Indiana,Spring Lake,250,13,94,73,21,3,204
Indiana,Marengo,690,121,232,104,23,15,495
Indiana,Taylorsville,934,11,318,105,39,19,492
Indiana,St. Joe,409,20,116,51,7,1,195
Indiana,Galveston,1163,35,339,311,72,34,791
Indiana,Borden,1171,66,305,215,74,15,675
Indiana,Utica,628,38,148,181,76,25,468
Indiana,Schererville,28698,1267,6229,6369,4249,2455,20569
Indiana,Schneider,238,13,69,40,12,1,135
Indiana,Winfield,5543,258,1237,1096,771,378,3740
Indiana,Goodland,1072,112,370,166,57,16,721
Indiana,Beverly Shores,563,13,46,75,161,226,521
Indiana,New Middletown,113,1,14,36,4,1,56
Indiana,Scottsburg,6696,658,1748,1496,474,158,4534
Indiana,Speedway,12188,1022,1953,2453,1646,907,7981
Indiana,Bicknell,3003,355,682,756,78,55,1926
Indiana,Monroe City,674,27,148,151,28,18,372
Indiana,Troy,393,50,163,64,30,14,321
Indiana,New Harmony,674,80,219,144,53,58,554
Indiana,Loogootee,2560,163,782,631,145,130,1851
Indiana,Crane,243,25,55,44,8,15,147
Indiana,Shoals,732,107,300,80,35,26,548
Indiana,La Crosse,601,24,162,166,24,14,390
Indiana,Michigan City,31251,2916,8072,6649,2345,1203,21185
Indiana,La Paz,643,70,190,114,14,0,388
Indiana,Kendallville,9522,1245,2616,1793,526,271,6451
Indiana,Ligonier,4654,1040,906,605,28,14,2593
Indiana,Brookston,1456,48,362,319,133,38,900
Indiana,Glenwood,252,18,83,59,0,2,162
Indiana,Russiaville,1032,57,224,300,113,34,728
Indiana,Blountsville,96,16,33,19,3,2,73
Indiana,Knightstown,2270,114,637,342,125,71,1289
Indiana,Mooreland,291,22,99,55,9,5,190
Indiana,Carlisle,691,28,213,189,29,25,484
Indiana,Woodburn,1644,140,456,372,87,59,1114
Indiana,Parker City,1327,128,438,198,96,36,896
Indiana,Saratoga,272,35,69,67,6,14,191
Indiana,Princes Lakes,1659,63,492,425,147,113,1240
Indiana,New Market,609,15,150,165,18,21,369
Indiana,Portland,5996,739,1832,1023,181,96,3871
Indiana,Sharpsville,868,57,303,127,67,17,571
Indiana,Angola,8645,651,1905,1328,664,398,4946
Indiana,New Richmond,286,27,80,50,20,12,189
Indiana,Waynetown,1042,84,313,226,66,20,709
Indiana,Columbia City,9084,548,2064,1861,1077,452,6002
Indiana,La Fontaine,877,75,335,211,56,17,694
Indiana,Napoleon,186,27,70,27,1,4,129
Indiana,Upland,3537,111,359,306,273,364,1413
Indiana,Bass Lake,1430,118,265,344,60,81,868
Indiana,Union City,3396,483,867,648,65,60,2123
Indiana,Shelburn,1339,142,415,278,43,24,902
Indiana,Alfordsville,61,10,24,20,0,0,54
Indiana,Odon,1526,143,481,329,76,66,1095
Indiana,Seymour,19357,2121,4984,3438,1454,969,12966
Indiana,Ferdinand,2000,192,601,349,202,173,1517
Indiana,Daleville,1636,73,435,429,155,59,1151
Indiana,Losantville,238,37,75,49,17,1,179
Indiana,Farmersburg,1284,33,298,395,77,41,844
Indiana,Elnora,581,73,156,132,28,18,407
Indiana,Plainville,393,61,135,69,22,10,297
Indiana,Huntington,17147,1275,4917,3033,1055,737,11017
Indiana,Warren,1288,79,532,215,74,60,960
Indiana,Shipshewana,918,185,184,118,65,34,586
Indiana,Warren Park,1622,203,487,324,98,100,1212
Indiana,Fowler,2282,170,762,386,196,91,1605
Indiana,Ridgeville,539,64,180,85,20,3,352
Indiana,Owensville,1356,112,479,237,73,34,935
Indiana,Southport,1848,188,391,334,178,87,1178
Indiana,Yorktown,11178,415,2196,2882,1364,905,7762
Indiana,South Bend,102233,10192,19844,17936,9186,6520,63678
Indiana,New Carlisle,1911,106,357,472,228,92,1255
Indiana,Dupont,297,18,109,62,12,2,203
Indiana,Waterloo,2222,126,566,441,97,103,1333
Indiana,Garrett,6661,587,2098,1213,357,140,4395
Indiana,Altona,333,23,124,60,13,5,225
Indiana,Andrews,938,106,380,190,25,19,720
Indiana,Hartsville,411,29,133,72,26,5,265
Indiana,English,670,126,192,105,16,3,442
Indiana,Alton,34,6,8,8,8,0,30
Indiana,Spring Hill,75,2,4,9,13,45,73
Indiana,Indianapolis city (balance),857637,81653,157513,153221,111087,59923,563397
Indiana,Long Beach,1108,8,105,187,338,291,929
Indiana,La Porte,21874,2060,5723,4273,1558,753,14367
Indiana,Dunlap,6115,372,1713,1373,403,350,4211
Indiana,Clifford,247,12,74,109,9,3,207
Indiana,Hartford City,5929,510,1816,1033,252,310,3921
Indiana,Michigantown,521,34,165,99,21,12,331
Indiana,Patriot,446,68,142,22,6,0,238
Indiana,Wheatland,473,26,156,108,18,4,312
Indiana,Warsaw,15062,1367,2542,2619,1799,967,9294
Indiana,Winslow,906,79,246,186,29,23,563
Indiana,Mexico,751,111,252,246,27,0,636
Indiana,Macy,249,31,71,23,5,2,132
Indiana,Culver,1211,123,231,224,162,156,896
Indiana,Griffith,16377,688,4058,4186,1702,574,11208
Indiana,Bloomingdale,307,19,80,79,17,11,206
Indiana,Sandborn,398,25,98,122,54,6,305
Indiana,Hope,2441,108,686,524,159,82,1559
Indiana,Rossville,1700,90,449,362,129,60,1090
Indiana,Mulberry,1290,128,395,250,130,24,927
Indiana,Bloomington,84058,2975,5726,8724,10324,11646,39395
Indiana,Dale,1442,242,439,228,76,14,999
Indiana,Dunkirk,2111,277,574,422,84,28,1385
Indiana,Kirklin,822,62,271,127,37,20,517
Indiana,Jonesville,236,12,96,35,13,7,163
Indiana,Tell City,7270,468,2117,1542,410,402,4939
Indiana,Cynthiana,627,77,197,106,36,17,433
Indiana,Claypool,520,96,145,73,15,2,331
Indiana,Sulphur Springs,287,14,77,72,18,7,188
Indiana,Lowell,9546,628,1904,2402,781,520,6235
Indiana,Butler,2729,339,815,445,156,34,1789
Indiana,Fortville,4460,184,1174,888,523,287,3056
Indiana,Milford,1444,262,428,191,62,10,953
Indiana,New Point,354,34,124,62,2,2,224
Indiana,Hamilton,1466,75,385,365,152,85,1062
Indiana,Clarksville,21336,2059,5608,4564,1816,773,14820
Indiana,Fairland,684,23,250,166,33,15,487
Indiana,Aberdeen,1463,14,133,374,320,164,1005
Indiana,Americus,349,31,59,79,60,44,273
Indiana,Arlington,420,56,183,77,7,0,323
Indiana,Austin,3879,694,1179,512,94,31,2510
Indiana,Avoca,894,67,225,229,70,21,612
Indiana,Blanford,245,7,188,17,0,0,212
Indiana,Buck Creek,150,0,113,13,0,13,139
Indiana,Richland,440,20,129,111,23,9,292
Indiana,Cannelton,1541,125,468,305,46,30,974
Indiana,Clinton,4743,404,1459,1178,284,115,3440
Indiana,Milan,1958,228,485,394,105,49,1261
Indiana,Clayton,998,32,214,271,78,45,640
Indiana,Laurel,548,98,157,61,11,6,333
Indiana,Staunton,435,29,165,98,12,4,308
Indiana,Roselawn,4599,497,1204,1090,108,128,3027
Indiana,West Baden Springs,475,55,173,129,33,13,403
Indiana,Roachdale,905,137,236,179,71,5,628
Indiana,Bright,5649,285,1413,1289,730,203,3920
Indiana,Edinburgh,4671,555,1850,803,146,41,3395
Indiana,Dillsboro,1551,184,482,233,50,14,963
Indiana,Winchester,4924,528,1361,1044,296,234,3463
Indiana,Brownstown,2945,266,869,586,134,90,1945
Indiana,Cromwell,452,77,119,68,18,5,287
Indiana,Burnettsville,418,38,136,76,30,4,284
Indiana,Cadiz,236,21,27,52,10,1,111
Indiana,New Castle,17402,1380,5497,3355,1248,486,11966
Indiana,Hudson,504,21,144,107,30,6,308
Indiana,Greendale,4165,96,1137,922,437,325,2917
Indiana,Mount Vernon,6513,554,1900,1354,401,289,4498
Indiana,Vernon,388,27,83,132,24,8,274
Indiana,Markle,1399,95,435,297,131,40,998
Indiana,Hanover,3504,168,747,643,115,106,1779
Indiana,Indian Village,133,11,31,32,8,17,99
Indiana,North Liberty,1842,99,390,421,181,57,1148
Indiana,Noblesville,61558,2021,8131,10938,12370,4883,38343
Indiana,Mellott,179,22,64,37,0,0,123
Indiana,Wallace,91,18,18,15,12,3,66
Indiana,Lyons,733,73,287,125,19,13,517
Indiana,Sellersburg,9013,725,1413,2310,943,517,5908
Indiana,Greensburg,11712,683,3362,2382,1056,497,7980
Indiana,Orestes,515,36,177,108,15,7,343
Indiana,Koontz Lake,1538,184,446,297,86,98,1111
Indiana,Pendleton,4213,113,810,1099,599,344,2965
Indiana,Gentryville,328,23,108,69,25,0,225
Indiana,Grandview,852,110,288,176,17,8,599
Indiana,Edgewood,2156,95,382,513,378,153,1521
Indiana,Mount Etna,112,9,43,17,9,1,79
Indiana,Anderson,54788,5332,14532,11568,3666,1974,37072
Indiana,Kennard,507,40,100,108,20,7,275
Indiana,Henryville,2106,120,552,458,132,81,1343
Indiana,Tri-Lakes,1643,14,481,387,194,108,1184
Indiana,Milltown,896,110,286,153,52,30,631
Indiana,Ladoga,1179,48,408,200,45,16,717
Indiana,Linden,711,56,236,135,39,10,476
Indiana,Paragon,653,103,192,92,17,0,404
Indiana,North Manchester,5917,412,1306,816,556,549,3639
Indiana,Roann,412,30,133,104,13,6,286
Indiana,Fort Branch,2998,104,824,691,232,108,1959
Indiana,Charlestown,8134,909,1993,1785,459,193,5339
Indiana,Osgood,1886,190,572,281,74,14,1131
Indiana,Kewanna,535,64,180,131,36,11,422
Indiana,Rochester,6043,375,1861,1500,346,152,4234
Indiana,Mecca,368,33,136,38,4,0,211
Indiana,New Amsterdam,23,1,13,5,1,0,20
Indiana,Martinsville,11646,1416,3550,1988,517,262,7733
Indiana,Morgantown,1030,95,344,209,31,16,695
Indiana,South Whitley,1837,116,617,350,69,85,1237
Indiana,Eaton,1833,129,498,422,88,69,1206
Indiana,Springport,145,8,41,54,8,6,117
Indiana,Nashville,1349,74,302,400,131,160,1067
Indiana,Salamonia,224,16,59,37,0,0,112
Indiana,Kentland,1853,213,590,333,94,60,1290
Indiana,Flora,1968,169,573,357,148,70,1317
Indiana,North Vernon,6662,827,2189,1140,332,165,4653
Indiana,Lebanon,15816,1480,3373,2864,1982,808,10507
Indiana,Thorntown,1429,139,432,250,120,34,975
Indiana,Ulen,213,6,15,38,44,37,140
Indiana,Argos,1795,174,478,328,105,43,1128
Indiana,Brook,1065,155,327,172,39,13,706
Indiana,Plymouth,9996,1266,2470,1349,570,516,6171
Indiana,Versailles,2039,205,546,378,110,72,1311
Indiana,Wheatfield,952,65,307,180,34,26,612
Indiana,Washington,12069,1695,3071,1915,760,357,7798
Indiana,Huntingburg,6634,846,1492,1272,366,153,4129
Indiana,Gaston,837,73,249,166,39,36,563
Indiana,Selma,885,55,291,190,68,10,614
Indiana,Fulton,354,16,136,62,12,4,230
Indiana,Bunker Hill,494,41,148,106,28,7,330
Indiana,Whitewater,69,14,20,12,2,0,48
Indiana,Spring Grove,447,47,141,75,36,57,356
Indiana,Saltillo,80,9,30,15,4,4,62
Indiana,Frankton,1980,117,595,334,161,71,1278
Indiana,Rising Sun,2091,220,764,411,146,65,1606
Indiana,Monrovia,1500,88,368,304,99,26,885
Indiana,Mishawaka,48926,3998,11020,9863,5404,2874,33159
Indiana,Walkerton,2240,213,550,483,139,102,1487
Indiana,Liberty,1881,220,533,331,174,67,1325
Indiana,Haubstadt,1596,54,416,361,161,75,1067
Indiana,Hazleton,392,23,119,103,20,10,275
Indiana,Somerville,299,24,100,38,11,8,181
Indiana,Atlanta,890,86,262,200,15,11,574
Indiana,Carmel,90163,1227,5265,10317,25236,17811,59856
Indiana,St. Leon,802,55,268,134,67,24,548
Indiana,Lawrenceburg,4979,401,1552,1015,256,187,3411
Indiana,Westport,1324,81,435,261,75,23,875
Indiana,Hardinsburg,177,18,84,22,2,14,140
Indiana,New Pekin,1647,192,433,338,86,25,1074
Indiana,Salem,6181,951,1660,926,408,250,4195
Indiana,Burns City,143,0,38,75,10,0,123
Indiana,Butlerville,267,15,93,34,70,0,212
Indiana,Pottawattamie Park,256,9,34,56,61,40,200
Indiana,Clarksburg,75,56,13,2,0,0,71
Indiana,Sullivan,4109,426,1202,1038,102,179,2947
Indiana,Crothersville,1755,105,581,351,45,22,1104
Indiana,Homecroft,662,21,108,146,132,70,477
Indiana,Millhousen,150,5,44,43,4,6,102
Indiana,Sheridan,2847,195,820,523,226,47,1811
Indiana,Cicero,4861,324,1089,1233,532,316,3494
Indiana,Bainbridge,779,72,238,170,28,8,516
Indiana,Paoli,3697,542,1192,626,120,113,2593
Indiana,Mount Ayr,111,20,40,17,4,0,81
Indiana,Mitchell,4270,649,1378,713,197,125,3062
Indiana,Franklin,24813,1679,5934,4973,2581,1519,16686
Indiana,New Whiteland,5955,321,1757,1105,649,285,4117
Indiana,Summitville,929,75,275,195,56,13,614
Indiana,Rockport,2419,290,734,495,115,45,1679
Indiana,Santa Claus,2601,79,560,503,377,228,1747
Indiana,Farmland,1290,73,447,190,92,56,858
Indiana,Battle Ground,1665,18,180,402,261,185,1046
Indiana,Fort Wayne,264052,19534,48851,54664,30697,16264,170010
Indiana,Rushville,6149,793,1994,1005,365,193,4350
Indiana,Monroeville,1185,65,461,279,51,35,891
Indiana,Berne,3962,190,1184,678,467,154,2673
Indiana,Carthage,894,93,239,140,53,46,571
Indiana,Cloverdale,1831,194,511,444,83,37,1269
Indiana,Milton,344,45,98,68,19,6,236
Indiana,Terre Haute,60691,5608,11824,11354,5025,3486,37297
Indiana,Silver Lake,951,141,232,228,42,25,668
Indiana,Pittsboro,3298,71,404,874,526,262,2137
Indiana,North Salem,508,47,184,109,42,0,382
Indiana,Mount Carmel,43,9,13,4,1,0,27
Indiana,Cedar Grove,152,18,49,42,14,0,123
Indiana,Brookville,2546,241,763,392,223,123,1742
Indiana,Clay City,845,59,259,198,56,12,584
Indiana,Canaan,115,18,34,25,20,9,106
Indiana,Rome City,1197,124,371,280,109,54,938
Indiana,Monroe,828,14,193,170,64,51,492
Indiana,Kokomo,57947,5463,15378,12160,4461,2613,40075
Indiana,Otterbein,1036,55,213,247,89,20,624
Indiana,Linton,5262,587,1514,988,350,224,3663
Indiana,Trail Creek,2019,90,492,626,177,112,1497
Indiana,Corydon,3125,423,837,546,349,213,2368
Indiana,Amboy,366,40,110,82,17,17,266
Indiana,Monticello,5282,497,1413,1256,225,178,3569
Indiana,Greenville,731,25,188,178,71,22,484
Indiana,Crawfordsville,16053,1524,4403,2783,1366,612,10688
Indiana,Wolcottville,1021,172,324,133,22,4,655
Indiana,Melody Hill,3809,73,855,753,578,311,2570
Indiana,Meridian Hills,1834,3,80,164,490,502,1239
Indiana,Rocky Ripple,576,24,70,155,106,90,445
Indiana,Osceola,2558,243,564,469,224,133,1633
Indiana,Logansport,18141,2867,4334,3326,942,397,11866
Indiana,Onward,101,4,36,25,9,0,74
Indiana,Walton,1296,139,291,280,69,46,825
Indiana,Cambridge City,1861,218,593,339,71,42,1263
Indiana,Wakarusa,1983,190,428,280,267,81,1246
Indiana,Elberfeld,730,22,163,193,58,32,468
Indiana,Goshen,33915,4666,6879,5103,2678,1972,21298
Indiana,Greens Fork,456,45,151,91,28,5,320
Indiana,Newberry,190,35,81,19,6,2,143
Indiana,Medaryville,652,105,199,108,7,8,427
Indiana,Star City,226,11,102,38,38,0,189
Indiana,Palmyra,1350,88,427,325,98,37,975
Indiana,Waveland,441,35,114,72,41,8,270
Indiana,Vevay,1493,166,467,355,76,60,1124
Indiana,Wabash,10184,1035,3131,2013,580,288,7047
Indiana,Francisco,579,52,219,125,11,0,407
Indiana,Sunman,1176,162,347,159,50,37,755
Indiana,Ashley,1061,86,330,202,40,14,672
Indiana,Clear Lake,394,2,67,106,115,69,359
Indiana,Boston,163,16,39,49,6,2,112
Indiana,Merrillville,35032,2208,7422,8019,3804,2121,23574
Indiana,North Terre Haute,4498,313,1074,953,325,187,2852
Indiana,Seelyville,819,63,214,224,40,20,561
Indiana,Zionsville,26209,360,1742,2775,6152,5666,16695
Indiana,Spiceland,703,24,241,121,58,16,460
Indiana,Converse,1303,119,288,276,107,43,833
Indiana,Cumberland,5792,335,1203,1250,576,361,3725
Indiana,Griffin,139,17,49,36,4,0,106
Indiana,Beech Grove,14912,1290,3948,2977,1263,557,10035
Indiana,Wanatah,1226,72,402,271,91,34,870
Indiana,Bremen,4519,401,1076,713,332,342,2864
Indiana,Knightsville,710,75,266,137,38,26,542
Indiana,Topeka,1022,192,213,124,40,10,579
Indiana,Lagrange,2796,374,857,473,118,65,1887
Indiana,Roanoke,1842,43,322,466,284,83,1198
Indiana,Harmony,805,48,229,219,65,8,569
Indiana,Livonia,105,15,29,13,3,2,62
Indiana,Little York,231,22,57,79,6,3,167
Indiana,Campbellsburg,598,53,164,96,8,27,348
Indiana,Moores Hill,707,38,247,131,6,11,433
Indiana,North Judson,2057,277,450,452,85,34,1298
Indiana,Knox,3609,470,1146,687,105,89,2497
Indiana,Petersburg,2472,282,702,536,144,61,1725
Indiana,Decker,281,37,84,65,9,1,196
Indiana,North Webster,1212,103,338,265,82,50,838
Indiana,Plainfield,32045,1604,6774,6693,4117,2473,21661
Indiana,Coalmont,232,29,115,35,0,0,179
Indiana,Colburn,330,29,41,80,15,0,165
Indiana,Cedar Lake,12242,809,3122,2493,1233,506,8163
Indiana,Dyer,16006,600,3659,3648,2452,1313,11672
Indiana,Westville,6343,1027,2489,1327,251,32,5126
Indiana,Millersburg,746,76,214,120,35,4,449
Indiana,Simonton Lake,5121,561,990,1071,500,192,3314
Indiana,Poneto,181,8,82,34,13,0,137
Indiana,Kingsford Heights,1320,190,380,231,15,8,824
Indiana,Reynolds,501,34,190,94,53,10,381
Indiana,Decatur,10331,863,3005,2334,560,269,7031
Indiana,Geneva,1459,174,403,306,87,39,1009
Indiana,Huntertown,6787,190,1075,1743,773,466,4247
Indiana,Shirley,898,88,292,119,33,16,548
Indiana,Straughn,313,28,74,56,8,4,170
Indiana,Avon,17169,646,2510,3450,2767,1634,11007
Indiana,Bourbon,1843,165,405,387,129,39,1125
Indiana,Kempton,359,41,136,70,13,3,263
Indiana,New Paris,1409,158,395,256,65,24,898
Indiana,Van Buren,888,56,321,182,52,24,635
Indiana,Ambia,299,30,57,34,9,0,130
Indiana,Dana,543,71,184,126,12,9,402
Indiana,Morristown,1358,118,489,233,63,30,933
Indiana,Williams Creek,398,1,10,35,105,129,280
Indiana,Rockville,2620,225,708,603,77,99,1712
Indiana,Oakland City,2259,305,607,352,221,75,1560
Indiana,Mackey,116,2,22,30,11,3,68
Indiana,St. Paul,1166,129,343,183,38,8,701
Indiana,Batesville,6555,341,1360,1396,862,557,4516
Indiana,Orland,410,38,150,79,10,7,284
Indiana,Fremont,2223,198,842,402,142,56,1640
Indiana,Monterey,298,30,93,84,10,0,217
Indiana,Colfax,722,78,183,158,34,10,463
Indiana,Leavenworth,324,45,94,65,25,9,238
Indiana,Wynnedale,184,6,14,26,56,52,154
Indiana,Frankfort,16186,2230,4608,2188,741,425,10192
Indiana,Wilkinson,373,31,75,119,36,14,275
Indiana,Auburn,13162,758,3228,3082,1283,561,8912
Indiana,Perrysville,440,22,127,117,8,7,281
Indiana,Shelbyville,18898,2215,5470,3033,1346,885,12949
Indiana,Jonesboro,1311,135,433,260,86,33,947
Indiana,Attica,3196,281,860,702,206,188,2237
Indiana,Boonville,6337,536,1698,1384,357,250,4225
Indiana,Woodlawn Heights,77,3,16,12,14,11,56
Indiana,River Forest,18,0,0,7,10,1,18
Indiana,Lapel,2327,160,679,530,293,71,1733
Indiana,Country Club Heights,89,3,15,11,21,30,80
Indiana,Lynnville,915,43,279,186,73,50,631
Indiana,Pennville,772,80,218,139,17,28,482
Indiana,Shadeland,1943,102,540,375,193,123,1333
Indiana,Earl Park,408,33,145,90,20,8,296
Indiana,Newport,393,41,138,75,18,22,294
Indiana,Cayuga,1202,80,412,205,56,17,770
Indiana,Ellettsville,6602,428,1401,1451,801,333,4414
Iowa,Harcourt,304,19,85,72,22,6,204
Iowa,Montrose,829,40,268,208,40,14,570
Iowa,Little Sioux,148,23,52,31,1,0,107
Iowa,Dunlap,940,56,281,240,74,42,693
Iowa,Dike,1235,35,173,286,235,102,831
Iowa,West Burlington,2929,226,595,793,235,120,1969
Iowa,Gruver,54,5,22,15,1,2,45
Iowa,Ladora,257,12,89,73,9,0,183
Iowa,Estherville,5859,449,1071,1245,647,284,3696
Iowa,Otho,460,19,152,134,50,5,360
Iowa,Farnhamville,401,8,89,122,22,10,251
Iowa,Callender,448,27,114,100,31,6,278
Iowa,Coburg,23,2,6,7,1,2,18
Iowa,Williamsburg,3150,99,787,930,345,81,2242
Iowa,Creston,7832,514,1951,1942,531,234,5172
Iowa,Pocahontas,1712,89,536,501,98,44,1268
Iowa,Gray,145,0,36,17,29,0,82
Iowa,Wyoming,423,29,132,117,18,11,307
Iowa,Alexander,147,9,29,44,12,0,94
Iowa,Coalville,594,14,139,138,57,17,365
Iowa,Alvord,265,7,96,44,15,0,162
Iowa,Little Rock,456,26,166,96,23,2,313
Iowa,Fonda,558,36,132,176,29,26,399
Iowa,Brayton,123,6,49,28,1,5,89
Iowa,Clarence,916,40,255,246,112,21,674
Iowa,Palmer,173,20,49,43,8,1,121
Iowa,Decatur City,210,8,76,47,5,0,136
Iowa,Weldon,172,10,102,12,9,13,146
Iowa,Manilla,819,61,255,221,32,7,576
Iowa,Denison,8358,1851,1430,1135,432,196,5044
Iowa,Aspinwall,19,0,6,9,1,0,16
Iowa,Gilmore City,452,29,144,108,22,5,308
Iowa,Stratford,646,29,196,156,68,10,459
Iowa,Kingsley,1581,48,322,414,152,72,1008
Iowa,Dows,552,38,154,119,55,16,382
Iowa,Mount Sterling,37,20,0,0,17,0,37
Iowa,Mount Union,134,11,20,64,5,0,100
Iowa,DeWitt,5198,140,923,1038,667,337,3105
Iowa,Center Junction,110,6,51,31,11,3,102
Iowa,Jacksonville,9,0,9,0,0,0,9
Iowa,Irvington,0,0,0,0,0,0,0
Iowa,Hutchins,20,0,0,0,0,0,0
Iowa,Hancock,195,16,71,59,10,0,156
Iowa,Kirkman,72,5,33,20,2,0,60
Iowa,Garnavillo,848,59,283,164,76,25,607
Iowa,Elkader,1381,86,354,286,187,77,990
Iowa,Urbandale,42881,1112,5025,8790,9906,4314,29147
Iowa,Saylorville,3492,91,662,1055,410,254,2472
Iowa,Runnells,515,5,120,145,23,14,307
Iowa,Pleasant Hill,9736,369,1824,2103,1612,602,6510
Iowa,McClelland,191,7,47,45,22,1,122
Iowa,Keomah Village,78,0,16,21,17,17,71
Iowa,Marshalltown,27275,3792,5585,4965,2168,1069,17579
Iowa,Bettendorf,35793,632,4845,6784,7257,5077,24595
Iowa,Story City,3395,97,637,828,470,223,2255
Iowa,Slater,1556,13,250,394,261,79,997
Iowa,McCallsburg,378,7,64,127,24,5,227
Iowa,Kelley,292,5,50,87,42,10,194
Iowa,Delphos,24,7,6,3,0,3,19
Iowa,Benton,41,4,16,7,14,0,41
Iowa,Cylinder,89,2,22,21,8,1,54
Iowa,Clive,17195,597,1495,2903,4402,2257,11654
Iowa,Curlew,66,5,17,18,1,0,41
Iowa,Delaware,128,3,56,20,9,2,90
Iowa,Mapleton,1196,105,339,247,123,55,869
Iowa,Riverdale,433,10,77,153,57,28,325
Iowa,Le Claire,3949,70,549,992,422,599,2632
Iowa,Eldridge,6399,134,1114,1458,735,538,3979
Iowa,Durant,1717,51,437,420,264,33,1205
Iowa,Blue Grass,1473,74,396,347,160,86,1063
Iowa,Parnell,218,13,59,75,1,0,148
Iowa,Ryan,388,34,148,84,26,9,301
Iowa,Dundee,259,21,71,45,7,0,144
Iowa,Rock Falls,151,3,35,65,12,3,118
Iowa,Sigourney,1922,74,632,418,150,120,1394
Iowa,Alden,850,69,261,221,61,20,632
Iowa,Colesburg,428,47,137,94,41,7,326
Iowa,Dana,42,3,14,8,4,0,29
Iowa,Plover,84,0,31,18,1,0,50
Iowa,Monroe,1743,53,476,425,190,50,1194
Iowa,Elgin,683,13,194,199,81,16,503
Iowa,Elberon,149,11,67,31,1,1,111
Iowa,Glenwood,5276,328,1425,1064,547,201,3565
Iowa,Shell Rock,1396,67,337,375,145,42,966
Iowa,Aredale,49,3,27,11,4,0,45
Iowa,Anita,1127,52,352,277,76,60,817
Iowa,Riverside,998,35,257,246,138,43,719
Iowa,Kalona,2516,199,537,622,188,146,1692
Iowa,Essex,874,82,301,186,50,14,633
Iowa,Coin,168,17,49,47,5,7,125
Iowa,Hardy,73,8,10,4,5,0,27
Iowa,Gilman,508,26,141,122,39,9,337
Iowa,Sidney,1081,85,288,251,54,48,726
Iowa,Orchard,53,7,18,12,8,0,45
Iowa,Dougherty,64,4,14,19,9,2,48
Iowa,Hartley,1698,110,399,488,120,51,1168
Iowa,Oakville,187,15,40,46,0,2,103
Iowa,Cotter,42,0,25,11,0,0,36
Iowa,Columbus Junction,2311,465,484,281,148,94,1472
Iowa,Ute,358,27,124,81,18,2,252
Iowa,Long Grove,1007,14,156,194,161,108,633
Iowa,Thurman,146,12,38,25,5,3,83
Iowa,Le Grand,933,32,273,227,72,9,613
Iowa,Mount Ayr,2066,138,585,438,210,100,1471
Iowa,Ruthven,743,35,163,194,65,28,485
Iowa,Rodman,31,3,11,11,2,0,27
Iowa,Tingley,142,0,59,35,13,5,112
Iowa,West Des Moines,64400,1938,6065,12017,16151,8438,44609
Iowa,Mitchellville,2304,142,804,585,106,43,1680
Iowa,Alleman,383,6,70,103,82,30,291
Iowa,Haverhill,188,3,39,56,24,3,125
Iowa,Greenfield,1713,58,559,476,98,57,1248
Iowa,Donahue,411,14,103,87,49,37,290
Iowa,Martelle,236,12,61,71,25,3,172
Iowa,Rodney,46,9,14,7,0,1,31
Iowa,Douds,88,16,24,29,11,0,80
Iowa,Fruitland,1050,42,237,264,82,37,662
Iowa,Walker,825,36,192,238,68,3,537
Iowa,Oto,117,24,18,24,2,5,73
Iowa,Stockton,153,6,33,48,8,0,95
Iowa,Lawton,1001,22,194,216,155,50,637
Iowa,Sloan,1186,24,210,302,122,58,716
Iowa,Merrill,871,101,205,171,52,16,545
Iowa,Numa,83,17,18,21,3,0,59
Iowa,Milton,526,40,127,99,14,3,283
Iowa,Birmingham,615,25,187,133,33,14,392
Iowa,Prairieburg,193,18,71,48,7,0,144
Iowa,Central City,1334,26,429,328,63,21,867
Iowa,Salem,524,28,170,151,25,3,377
Iowa,Rose Hill,145,29,38,40,17,0,124
Iowa,Bernard,146,2,46,38,13,2,101
Iowa,Centralia,123,3,55,23,8,3,92
Iowa,Rickardsville,171,5,59,42,13,8,127
Iowa,Baxter,1029,63,244,305,88,47,747
Iowa,West Union,2561,146,756,520,279,167,1868
Iowa,St. Lucas,129,17,31,31,16,8,103
Iowa,Joice,209,14,39,62,18,12,145
Iowa,Monticello,3835,189,969,931,437,125,2651
Iowa,Thor,203,10,55,50,7,5,127
Iowa,Rutland,131,10,43,40,2,0,95
Iowa,Hillsboro,189,19,35,52,9,0,115
Iowa,Renwick,286,22,74,74,18,3,191
Iowa,Fairfax,2596,37,387,591,428,240,1683
Iowa,Beacon,580,83,226,88,17,2,416
Iowa,Underwood,931,20,134,240,107,67,568
Iowa,Dawson,159,5,27,37,15,0,84
Iowa,Adel,4316,110,761,972,792,201,2836
Iowa,Denver,1676,66,345,389,266,101,1167
Iowa,Worthington,427,38,156,67,40,11,312
Iowa,Lisbon,2281,57,434,498,349,150,1488
Iowa,Yale,255,15,77,56,16,7,171
Iowa,Stuart,1501,90,423,385,150,23,1071
Iowa,Hornick,230,14,65,55,18,2,154
Iowa,Avoca,1427,86,290,428,163,44,1011
Iowa,Harlan,4883,303,1280,1054,651,200,3488
Iowa,Montour,297,15,111,63,28,2,219
Iowa,Chelsea,272,33,72,39,9,6,159
Iowa,Leighton,205,3,60,42,21,1,127
Iowa,Shelby,621,30,185,158,40,19,432
Iowa,Minden,602,26,109,173,61,15,384
Iowa,Crescent,574,38,110,170,58,35,411
Iowa,Oskaloosa,11505,680,2827,2340,1136,514,7497
Iowa,Oakland Acres,131,0,29,26,25,17,97
Iowa,Westgate,210,7,68,66,7,6,154
Iowa,Oelwein,6050,413,1569,1421,443,258,4104
Iowa,Hawkeye,460,30,123,89,39,12,293
Iowa,Grafton,218,10,67,63,11,5,156
Iowa,Livermore,341,14,100,94,16,7,231
Iowa,Onslow,200,15,67,55,4,4,145
Iowa,Prairie City,2204,63,500,473,318,50,1404
Iowa,Emerson,476,17,112,128,35,11,303
Iowa,Barnes City,233,28,74,67,5,3,177
Iowa,Farley,1742,87,431,382,170,57,1127
Iowa,Tama,2793,302,781,469,84,71,1707
Iowa,Lone Rock,199,19,40,43,9,2,113
Iowa,Buckeye,98,12,32,30,1,0,75
Iowa,Scranton,554,43,157,146,30,2,378
Iowa,Ralston,71,6,24,14,2,0,46
Iowa,Swaledale,93,1,43,28,3,0,75
Iowa,Onawa,2830,159,848,761,173,109,2050
Iowa,Durango,9,2,5,0,0,0,7
Iowa,Williamson,143,3,46,34,3,0,86
Iowa,Rockwell,946,35,203,299,84,21,642
Iowa,Balltown,61,9,14,13,7,2,45
Iowa,Jackson Junction,37,1,14,5,1,1,22
Iowa,Fort Atkinson,308,15,86,84,34,19,238
Iowa,Thompson,423,35,132,96,29,2,294
Iowa,Leland,259,10,77,59,21,6,173
Iowa,Peosta,1746,49,264,322,259,90,984
Iowa,Edgewood,612,30,280,119,49,21,499
Iowa,Beaver,38,1,12,13,5,0,31
Iowa,Belmond,2574,151,658,719,196,72,1796
Iowa,Paullina,1067,80,243,253,116,30,722
Iowa,Perry,7667,1174,1623,1311,349,182,4639
Iowa,Clarksville,1448,105,400,302,104,42,953
Iowa,Peterson,368,36,98,68,34,14,250
Iowa,Macksburg,107,17,32,17,7,0,73
Iowa,Hopkinton,603,27,205,118,25,3,378
Iowa,Walcott,1539,76,428,377,133,83,1097
Iowa,Lu Verne,298,21,71,81,21,0,194
Iowa,Pleasanton,32,4,12,6,2,0,24
Iowa,Bagley,348,20,112,78,18,15,243
Iowa,Fontanelle,610,30,257,119,37,4,447
Iowa,Stanwood,627,42,154,161,53,18,428
Iowa,Van Wert,161,19,46,52,10,0,127
Iowa,Waucoma,211,7,68,51,18,6,150
Iowa,Thornton,436,18,76,137,42,6,279
Iowa,Silver City,253,25,73,61,27,2,188
Iowa,Drakesville,200,31,60,61,4,4,160
Iowa,Rowan,155,5,55,29,11,2,102
Iowa,Calamus,441,14,109,117,17,9,266
Iowa,Houghton,151,16,47,25,20,6,114
Iowa,Minburn,400,11,121,100,36,2,270
Iowa,De Soto,980,32,200,244,139,21,636
Iowa,Massena,310,15,83,77,39,7,221
Iowa,Cumberland,192,17,72,37,8,4,138
Iowa,Atlantic,6709,752,1691,1392,691,325,4851
Iowa,Sherrill,247,14,122,19,18,7,180
Iowa,Epworth,1939,46,510,353,232,92,1233
Iowa,Ventura,814,2,160,225,131,53,571
Iowa,Asbury,5469,224,712,953,907,694,3490
Iowa,Waterloo,68134,5371,14774,14688,7360,3146,45339
Iowa,La Porte City,2598,72,608,672,202,149,1703
Iowa,Hudson,2470,31,367,634,442,204,1678
Iowa,Clare,178,11,48,56,10,0,125
Iowa,Harpers Ferry,257,27,101,62,29,3,222
Iowa,Solon,2581,62,303,514,408,201,1488
Iowa,Red Oak,5434,428,1390,1181,428,189,3616
Iowa,Strawberry Point,1376,75,445,298,86,31,935
Iowa,Dubuque,58340,3297,12649,11046,7617,4318,38927
Iowa,Malcom,272,21,88,42,18,4,173
Iowa,Galt,29,3,1,1,12,0,17
Iowa,Hospers,718,33,166,189,76,16,480
Iowa,Orange City,6115,115,1104,1103,665,504,3491
Iowa,Rock Valley,3712,207,849,573,389,109,2127
Iowa,Oakland,1533,91,301,402,183,45,1022
Iowa,Northboro,83,2,50,19,0,0,71
Iowa,Nichols,374,34,141,81,14,3,273
Iowa,Bertram,381,13,82,91,40,28,254
Iowa,Terril,372,28,79,91,40,9,247
Iowa,Boone,12529,510,3001,3284,1250,492,8537
Iowa,Webb,162,17,44,29,8,8,106
Iowa,Fremont,735,52,128,223,45,27,475
Iowa,Chillicothe,96,6,24,24,8,2,64
Iowa,Dallas Center,1733,36,323,390,257,106,1112
Iowa,Sioux City,82486,7884,16698,15571,7917,3761,51831
Iowa,Correctionville,786,71,256,149,57,19,552
Iowa,Carter Lake,3792,274,801,757,344,105,2281
Iowa,Ayrshire,150,14,17,52,15,2,100
Iowa,Marengo,2620,173,754,648,133,60,1768
Iowa,Vincent,149,17,38,52,13,0,120
Iowa,Rossie,39,0,9,19,3,0,31
Iowa,Somers,129,5,20,55,5,0,85
Iowa,Frederika,370,11,56,108,25,12,212
Iowa,University Park,485,41,87,104,44,10,286
Iowa,Halbur,289,11,67,56,27,12,173
Iowa,Sheldon,5132,272,1176,1100,619,208,3375
Iowa,Knierim,42,1,18,9,4,1,33
Iowa,Garwin,550,20,173,130,38,11,372
Iowa,Carlisle,4134,131,747,933,580,239,2630
Iowa,La Motte,222,17,84,49,7,8,165
Iowa,Maquoketa,6026,268,1588,1533,484,256,4129
Iowa,Preston,975,52,329,240,60,18,699
Iowa,Sabula,422,5,161,84,24,14,288
Iowa,Zwingle,103,8,17,37,2,1,65
Iowa,New Market,405,20,111,135,27,7,300
Iowa,Moorland,207,20,58,45,10,1,134
Iowa,Grand Junction,879,49,255,199,37,2,542
Iowa,Cedar Falls,41202,849,4430,6551,6080,3970,21880
Iowa,Jesup,2894,49,631,708,283,79,1750
Iowa,Spencer,11092,366,2727,2913,1319,413,7738
Iowa,McIntire,79,10,36,23,0,0,69
Iowa,Bondurant,5826,211,788,1062,1161,238,3460
Iowa,Armstrong,945,57,268,265,70,10,670
Iowa,Corwith,213,28,56,61,21,6,172
Iowa,Kanawha,826,65,250,180,56,7,558
Iowa,Klemme,616,15,192,134,25,10,376
Iowa,New Virginia,507,19,118,150,29,24,340
Iowa,Humeston,408,26,151,89,24,6,296
Iowa,Pioneer,4,0,1,1,0,0,2
Iowa,Westfield,142,20,37,29,2,0,88
Iowa,Danbury,334,23,115,81,26,3,248
Iowa,Bristow,141,16,46,27,5,0,94
Iowa,Cascade,2078,145,700,417,173,66,1501
Iowa,Olin,841,57,274,205,13,5,554
Iowa,Tabor,1254,70,309,305,135,38,857
Iowa,Martinsburg,107,19,30,20,5,2,76
Iowa,Thayer,43,5,17,15,0,0,37
Iowa,West Point,998,36,307,271,117,16,747
Iowa,Corydon,1682,96,545,387,99,79,1206
Iowa,Dow City,506,43,151,115,26,4,339
Iowa,Buck Grove,42,1,16,10,0,0,27
Iowa,Exira,905,94,291,198,55,20,658
Iowa,Fort Madison,10614,605,3102,2727,714,252,7400
Iowa,Logan,1592,86,367,351,157,55,1016
Iowa,Middletown,402,14,82,94,41,8,239
Iowa,Mitchell,134,21,27,48,3,4,103
Iowa,Aurelia,948,69,237,269,91,46,712
Iowa,Reinbeck,1492,53,382,384,244,73,1136
Iowa,Hayesville,34,6,25,1,2,0,34
Iowa,Thornburg,73,4,13,23,12,0,52
Iowa,Riverton,305,19,77,78,19,6,199
Iowa,Hamburg,1119,68,326,261,64,29,748
Iowa,Farragut,430,15,128,130,42,23,338
Iowa,Marysville,113,4,36,20,0,0,60
Iowa,Allerton,546,10,145,141,29,7,332
Iowa,North English,1106,73,226,260,64,36,659
Iowa,Fostoria,243,10,65,76,12,0,163
Iowa,Marcus,1234,60,293,333,149,53,888
Iowa,Lakeside,717,90,118,137,95,51,491
Iowa,Huxley,3672,70,445,740,687,327,2269
Iowa,Sheldahl,273,9,70,65,50,5,199
Iowa,Princeton,1114,66,258,284,116,55,779
Iowa,Gravity,135,18,55,20,5,1,99
Iowa,Swan,68,0,19,18,5,0,42
Iowa,Melcher-Dallas,1255,49,376,306,93,24,848
Iowa,Bussey,491,27,158,115,27,13,340
Iowa,Shueyville,641,2,87,148,113,91,441
Iowa,Oxford,882,49,202,191,97,63,602
Iowa,Woodburn,159,10,55,45,13,0,123
Iowa,Vinton,5124,225,1363,964,721,211,3484
Iowa,Van Horne,868,30,162,220,49,47,508
Iowa,Urbana,1477,45,328,351,186,66,976
Iowa,Janesville,956,39,259,225,126,13,662
Iowa,Moravia,675,61,191,173,43,6,474
Iowa,Redding,74,2,22,16,2,0,42
Iowa,Clearfield,386,34,124,55,24,3,240
Iowa,Roland,1233,19,203,303,185,61,771
Iowa,West Bend,714,16,189,245,77,12,539
Iowa,Newell,965,38,242,232,125,20,657
Iowa,Rembrandt,171,19,40,39,7,3,108
Iowa,Ricketts,112,16,30,23,2,0,71
Iowa,Carpenter,119,4,24,40,2,1,71
Iowa,Grimes,11930,168,2101,2404,2128,1040,7841
Iowa,Brooklyn,1549,58,438,289,112,72,969
Iowa,Beaconsfield,22,6,15,1,0,0,22
Iowa,Holstein,1354,45,292,340,224,61,962
Iowa,Audubon,1989,212,562,481,121,68,1444
Iowa,Deloit,358,49,110,59,6,18,242
Iowa,Schleswig,909,76,243,236,56,15,626
Iowa,Lone Tree,1236,76,261,337,131,41,846
Iowa,Hamilton,86,8,27,16,0,0,51
Iowa,Clio,64,2,31,5,8,1,47
Iowa,Grinnell,9223,430,1789,1493,861,836,5409
Iowa,Graettinger,806,70,194,215,61,11,551
Iowa,Waukon,3716,396,937,686,423,158,2600
Iowa,Fraser,146,21,34,46,7,1,109
Iowa,Nemaha,103,6,32,10,6,0,54
Iowa,Forest City,4089,178,895,874,346,159,2452
Iowa,Blockton,137,5,49,41,6,5,106
Iowa,Winterset,5203,242,1093,1215,628,256,3434
Iowa,Bedford,1566,94,431,397,107,61,1090
Iowa,New Albin,562,29,149,172,27,2,379
Iowa,Arispe,120,3,31,44,5,1,84
Iowa,Stanton,581,21,146,185,72,29,453
Iowa,St. Paul,90,3,20,36,9,0,68
Iowa,Lansing,769,24,307,180,80,32,623
Iowa,Mondamin,338,25,98,71,40,6,240
Iowa,Stout,174,10,54,37,21,6,128
Iowa,Morrison,118,9,41,35,6,0,91
Iowa,Burlington,25127,1649,5799,6432,2324,1079,17283
Iowa,Lenox,1557,205,385,345,71,31,1037
Iowa,Seymour,596,72,212,113,30,15,442
Iowa,Harvey,172,21,60,33,4,0,118
Iowa,Conway,23,0,6,9,0,0,15
Iowa,Kiron,249,10,67,74,7,11,169
Iowa,Westside,326,12,111,81,39,6,249
Iowa,Sheffield,1101,62,256,348,105,23,794
Iowa,Farmington,741,59,185,197,35,13,489
Iowa,Moville,1669,15,289,475,199,98,1076
Iowa,Plymouth,383,14,79,148,22,7,270
Iowa,Lovilia,684,30,244,123,38,6,441
Iowa,Moorhead,196,14,77,53,9,5,158
Iowa,Hartwick,108,3,25,33,8,6,75
Iowa,Park View,2755,90,796,418,285,126,1715
Iowa,Swisher,917,10,173,252,155,63,653
Iowa,Woodbine,1585,92,380,405,200,56,1133
Iowa,Wellsburg,813,28,185,235,94,16,558
Iowa,Conrad,1053,48,244,269,140,59,760
Iowa,Pleasantville,1715,84,410,390,174,38,1096
Iowa,Knoxville,7200,402,2027,1774,506,279,4988
Iowa,University Heights,1206,0,31,97,227,380,735
Iowa,Tiffin,3008,147,374,832,368,237,1958
Iowa,Coralville,20645,635,1911,3136,4124,3448,13254
Iowa,Missouri Valley,2646,291,705,599,156,77,1828
Iowa,Keosauqua,901,35,307,242,84,50,718
Iowa,Iowa City,74566,1697,5385,8789,10943,12190,39004
Iowa,Coulter,195,9,54,66,8,3,140
Iowa,Aurora,208,23,41,40,28,6,138
Iowa,State Center,1595,45,356,450,133,38,1022
Iowa,Arthur,250,10,74,72,16,4,176
Iowa,Cherokee,4966,310,1268,1125,487,271,3461
Iowa,Rinard,44,6,12,12,3,0,33
Iowa,Lohrville,381,17,80,119,30,13,259
Iowa,Blairstown,699,43,226,162,36,11,478
Iowa,Belle Plaine,2427,211,667,612,152,40,1682
Iowa,Lake Mills,2082,157,513,494,221,132,1517
Iowa,Hartford,678,30,161,177,43,7,418
Iowa,Milo,804,11,265,201,42,19,538
Iowa,Newhall,993,20,212,285,121,40,678
Iowa,Baldwin,139,16,51,31,3,0,101
Iowa,Kirkville,197,2,69,64,15,0,150
Iowa,Sanborn,1452,107,406,314,127,39,993
Iowa,Lamont,563,40,199,97,17,6,359
Iowa,Ackley,1785,122,439,457,220,75,1313
Iowa,Radcliffe,595,33,148,165,61,8,415
Iowa,Algona,5455,259,1270,1505,660,186,3880
Iowa,Council Bluffs,62478,5379,14126,14517,5069,2521,41612
Iowa,Maurice,337,22,103,61,22,3,211
Iowa,Hull,2044,163,416,436,201,60,1276
Iowa,Chatsworth,81,13,24,24,0,4,65
Iowa,Treynor,941,23,148,197,163,78,609
Iowa,Sutherland,639,38,188,174,48,17,465
Iowa,Calumet,159,1,45,36,12,1,95
Iowa,Popejoy,47,1,11,11,0,1,24
Iowa,Columbus City,438,114,107,60,21,5,307
Iowa,St. Olaf,144,3,42,30,7,1,83
Iowa,North Buena Vista,82,17,35,15,3,2,72
Iowa,Alta,2152,194,413,468,212,70,1357
Iowa,Albert City,625,40,202,148,37,13,440
Iowa,Toledo,2296,229,623,427,147,60,1486
Iowa,Clutier,231,30,46,72,11,2,161
Iowa,Whittemore,487,9,153,132,33,3,330
Iowa,Cresco,3780,281,945,906,230,167,2529
Iowa,Ossian,873,47,300,198,82,39,666
Iowa,Oyens,99,0,27,39,4,0,70
Iowa,Hinton,831,16,190,189,128,38,561
Iowa,Lucas,199,16,77,46,8,0,147
Iowa,Boyden,891,56,163,178,66,26,489
Iowa,Spring Hill,71,5,23,9,5,0,42
Iowa,Norwalk,10568,169,1527,2388,2048,712,6844
Iowa,Ackworth,219,8,60,25,13,1,107
Iowa,Russell,608,34,174,123,40,5,376
Iowa,Sandyville,63,12,14,5,5,1,37
Iowa,Springbrook,142,4,52,33,4,2,95
Iowa,Meriden,196,10,47,42,22,2,123
Iowa,Raymond,713,25,190,168,93,15,491
Iowa,Dunkerton,811,24,186,208,81,22,521
Iowa,Johnston,20767,396,2208,3617,4921,2982,14124
Iowa,Altoona,17936,594,3414,3932,2551,870,11361
Iowa,Osage,3574,185,1111,786,355,138,2575
Iowa,Ottumwa,24676,2318,5672,5467,1744,1026,16227
Iowa,Doon,687,51,202,151,31,9,444
Iowa,Miles,422,30,115,78,38,22,283
Iowa,Monmouth,171,25,57,33,6,1,122
Iowa,Ashton,482,35,103,124,26,13,301
Iowa,Harris,132,19,48,31,5,0,103
Iowa,Garrison,421,21,140,99,19,14,293
Iowa,Redfield,644,58,227,172,20,6,483
Iowa,Linden,165,16,52,44,16,2,130
Iowa,Readlyn,742,25,186,177,101,23,512
Iowa,Dumont,604,65,216,127,20,13,441
Iowa,Wiota,73,6,23,34,8,2,73
Iowa,Quasqueton,576,27,224,90,24,9,374
Iowa,Floris,185,15,41,39,16,2,113
Iowa,Volga,181,6,73,33,18,11,141
Iowa,Monona,1581,81,516,386,187,39,1209
Iowa,Truesdale,123,6,35,34,4,0,79
Iowa,Sageville,52,3,15,21,2,3,44
Iowa,Dyersville,4110,250,1127,852,613,169,3011
Iowa,Bankston,17,0,11,3,0,3,17
Iowa,Storm Lake,10672,2138,1457,1442,639,369,6045
Iowa,Dedham,264,3,85,55,15,0,158
Iowa,Sergeant Bluff,4669,176,598,1143,817,277,3011
Iowa,Independence,6027,213,1654,1378,676,301,4222
Iowa,Washta,176,13,59,36,14,2,124
Iowa,Kensett,289,13,116,74,29,3,235
Iowa,Randalia,86,8,35,17,5,0,65
Iowa,Sumner,2124,85,551,524,218,122,1500
Iowa,Ellsworth,542,7,64,166,60,8,305
Iowa,Coggon,679,37,172,159,64,20,452
Iowa,Robins,3414,20,402,629,852,456,2359
Iowa,Leon,2037,189,524,344,145,58,1260
Iowa,Webster City,7779,450,1841,1986,924,381,5582
Iowa,Rathbun,51,1,17,15,12,4,49
Iowa,Carbon,45,2,21,3,11,0,37
Iowa,Prescott,218,1,51,48,21,4,125
Iowa,Panama,199,8,46,55,18,4,131
Iowa,Granville,397,32,103,86,22,12,255
Iowa,Ireton,939,33,222,207,131,34,627
Iowa,Smithland,161,5,68,28,2,5,108
Iowa,Hanlontown,174,5,33,73,12,9,132
Iowa,Wahpeton,372,9,81,105,110,35,340
Iowa,Alburnett,641,12,119,176,61,14,382
Iowa,Bonaparte,459,20,120,125,7,3,275
Iowa,Larrabee,162,10,68,46,6,6,136
Iowa,Cleghorn,236,4,66,47,17,14,148
Iowa,Gilbertville,840,36,244,216,88,3,587
Iowa,Lytton,268,10,80,72,15,6,183
Iowa,Lake View,1062,63,261,331,128,68,851
Iowa,Bronson,257,4,85,63,17,4,173
Iowa,Anthon,632,31,163,178,53,16,441
Iowa,Hazleton,824,33,263,169,47,3,515
Iowa,Struble,112,3,33,20,2,1,59
Iowa,Akron,1542,106,385,345,132,42,1010
Iowa,Conesville,437,104,98,42,3,3,250
Iowa,New Sharon,1146,53,335,265,111,61,825
Iowa,Luxemburg,253,28,85,49,25,5,192
Iowa,Farmersburg,304,13,97,70,9,3,192
Iowa,Lowden,869,38,232,218,78,15,581
Iowa,Exline,168,19,60,48,4,0,131
Iowa,Craig,81,5,23,16,7,0,51
Iowa,Guthrie Center,1570,100,432,363,117,73,1085
Iowa,New Providence,258,16,47,70,26,16,175
Iowa,West Okoboji,308,10,81,91,66,25,273
Iowa,New Vienna,385,25,138,95,33,9,300
Iowa,Holy Cross,375,15,116,102,18,14,265
Iowa,Eddyville,1219,38,392,246,62,26,764
Iowa,Wall Lake,737,55,240,173,46,17,531
Iowa,Odebolt,1011,71,259,266,92,42,730
Iowa,Auburn,262,14,75,78,11,12,190
Iowa,Ridgeway,273,10,78,74,26,3,191
Iowa,Castalia,195,14,65,34,19,10,142
Iowa,Scarville,78,3,27,18,4,5,57
Iowa,Spillville,446,59,109,103,39,8,318
Iowa,Lacona,392,17,137,94,21,2,271
Iowa,Ida Grove,2137,135,585,489,253,49,1511
Iowa,Galva,447,40,104,132,18,3,297
Iowa,Quimby,397,38,125,98,14,0,275
Iowa,Andrew,446,27,96,113,29,3,268
Iowa,Battle Creek,737,43,199,194,72,6,514
Iowa,Winthrop,909,29,264,202,94,18,607
Iowa,Marathon,242,27,76,57,16,1,177
Iowa,Garber,121,9,38,22,0,2,71
Iowa,New London,1941,75,427,552,157,60,1271
Iowa,Palo,1182,29,302,265,113,26,735
Iowa,Mount Vernon,4454,36,295,485,809,481,2106
Iowa,Wayland,1061,39,311,273,77,39,739
Iowa,Menlo,414,24,106,109,26,4,269
Iowa,Lake Park,1201,38,312,356,130,43,879
Iowa,Alta Vista,330,22,118,39,12,5,196
Iowa,Walnut,717,42,191,229,42,37,541
Iowa,Ionia,312,15,90,65,14,7,191
Iowa,Berkley,16,4,8,0,3,0,15
Iowa,Willey,126,3,29,31,8,3,74
Iowa,Breda,414,9,107,128,42,4,290
Iowa,Waukee,19344,241,2029,3251,4665,1970,12156
Iowa,Granger,1819,59,268,390,359,111,1187
Iowa,Osterdock,85,1,21,29,2,0,53
Iowa,Marquette,405,45,141,80,39,9,314
Iowa,Luther,183,5,59,54,21,2,141
Iowa,Olds,210,3,56,44,8,24,135
Iowa,Spirit Lake,5021,167,964,1380,855,290,3656
Iowa,North Washington,152,0,63,22,3,1,89
Iowa,Holland,253,10,48,79,11,4,152
Iowa,Beaman,221,6,48,66,14,3,137
Iowa,Keswick,213,13,50,68,14,0,145
Iowa,Hedrick,579,32,162,147,28,13,382
Iowa,Randolph,194,18,54,41,12,5,130
Iowa,Dolliver,62,9,22,14,4,0,49
Iowa,Sharpsburg,116,4,22,33,6,0,65
Iowa,Millerton,109,0,10,16,11,2,39
Iowa,Latimer,518,47,120,124,38,9,338
Iowa,Charter Oak,644,56,132,185,26,12,411
Iowa,Arion,111,19,42,18,2,0,81
Iowa,Dayton,765,55,184,222,63,26,550
Iowa,Remsen,1748,57,440,428,168,20,1113
Iowa,Stockport,350,16,83,80,10,9,198
Iowa,Muscatine,23864,2093,5329,4904,2253,975,15554
Iowa,Pisgah,293,17,104,65,15,1,202
Iowa,Keokuk,10412,727,2804,2419,744,382,7076
Iowa,Villisca,1340,98,369,362,91,26,946
Iowa,Vail,501,66,154,79,20,8,327
Iowa,Nashua,1515,98,407,382,91,75,1053
Iowa,Lawler,369,25,107,85,33,15,265
Iowa,Fredericksburg,1136,30,332,203,119,44,728
Iowa,Orient,419,15,126,132,15,1,289
Iowa,Shellsburg,921,33,289,271,78,32,703
Iowa,Luzerne,134,2,37,47,2,0,88
Iowa,Keystone,578,31,158,143,62,21,415
Iowa,Arnolds Park,1173,24,291,370,190,45,920
Iowa,Truro,537,16,92,129,18,9,264
Iowa,Promise City,81,6,39,15,5,0,65
Iowa,Pella,10273,504,1860,1515,1519,775,6173
Iowa,Hansell,90,5,35,26,2,0,68
Iowa,Hampton,4280,397,1013,890,389,131,2820
Iowa,Kimballton,296,17,93,96,18,13,237
Iowa,Hills,827,16,223,207,120,29,595
Iowa,Geneva,125,5,42,34,10,1,92
Iowa,Manson,1838,68,427,544,142,103,1284
Iowa,Cantril,282,27,65,55,17,1,165
Iowa,Ely,2078,43,314,540,393,76,1366
Iowa,Marion,38699,823,7264,9450,6566,2787,26890
Iowa,Malvern,1005,78,225,277,107,43,730
Iowa,New Hartford,676,12,155,174,41,8,390
Iowa,Jamaica,277,31,59,79,17,0,186
Iowa,Fairfield,10216,419,1440,2418,1478,1305,7060
Iowa,Rudd,451,34,110,143,23,12,322
Iowa,Charles City,7413,696,1647,1708,811,169,5031
Iowa,Welton,147,7,42,53,7,2,111
Iowa,Goose Lake,236,11,48,65,25,5,154
Iowa,Clinton,25637,2023,6859,5889,2303,984,18058
Iowa,Unionville,88,4,33,31,3,0,71
Iowa,Moulton,518,18,139,122,48,17,344
Iowa,Dickens,228,20,63,41,10,1,135
Iowa,Marne,124,5,43,28,3,5,84
Iowa,Lewis,482,62,153,105,26,3,349
Iowa,Bode,278,23,92,67,15,17,214
Iowa,Adair,787,11,245,228,47,19,550
Iowa,Bayard,391,38,114,80,28,4,264
Iowa,Steamboat Rock,311,23,86,108,15,5,237
Iowa,Union,422,26,129,114,31,10,310
Iowa,Kamrar,159,6,67,33,7,3,116
Iowa,Blairsburg,136,3,49,37,14,8,111
Iowa,Mingo,261,17,69,76,14,1,177
Iowa,Stanhope,392,26,105,98,34,7,270
Iowa,Jefferson,4160,191,1036,978,413,231,2849
Iowa,Masonville,113,4,47,18,2,0,71
Iowa,Churdan,474,16,141,111,42,5,315
Iowa,Washington,7345,388,2241,1512,658,350,5149
Iowa,Whiting,925,45,229,178,110,27,589
Iowa,Soldier,216,9,61,59,18,12,159
Iowa,Davenport,102318,6358,22412,21614,11928,5982,68294
Iowa,Rhodes,248,15,105,50,13,2,185
Iowa,Melbourne,895,30,200,234,68,13,545
Iowa,Swea City,570,35,146,119,36,9,345
Iowa,Ledyard,91,7,35,26,5,6,79
Iowa,Lakota,269,26,81,72,11,4,194
Iowa,Turin,119,8,27,20,8,3,66
Iowa,Packwood,351,38,63,84,29,8,222
Iowa,Aplington,996,38,237,252,108,40,675
Iowa,Ottosen,38,8,15,10,2,2,37
Iowa,Corning,1566,92,424,408,154,78,1156
Iowa,West Chester,104,28,35,17,7,0,87
Iowa,Shenandoah,4945,417,1108,1100,697,192,3514
Iowa,Patterson,187,7,59,65,14,0,145
Iowa,Batavia,605,55,227,99,18,12,411
Iowa,Marble Rock,286,25,83,76,24,13,221
Iowa,Wheatland,728,55,177,169,55,13,469
Iowa,Cincinnati,380,28,142,67,30,7,274
Iowa,Charlotte,325,20,81,66,13,16,196
Iowa,Elliott,512,50,138,100,23,1,312
Iowa,Fenton,290,12,69,93,20,5,199
Iowa,Le Mars,9894,532,2071,2605,973,387,6568
Iowa,Floyd,325,24,106,75,22,3,230
Iowa,Grand Mound,617,20,158,147,58,32,415
Iowa,Camanche,4342,146,1270,1272,287,190,3165
Iowa,West Liberty,3749,630,967,548,225,123,2493
Iowa,Cromwell,97,8,26,27,6,7,74
Iowa,Ainsworth,522,66,135,84,47,14,346
Iowa,Plano,70,5,21,27,3,0,56
Iowa,Parkersburg,1913,70,484,404,223,97,1278
Iowa,Dakota City,798,45,265,163,50,11,534
Iowa,Wellman,1333,49,390,357,100,44,940
Iowa,Coppock,31,3,11,5,0,0,19
Iowa,Yorktown,67,1,29,13,3,2,48
Iowa,Shambaugh,151,6,34,65,4,1,110
Iowa,Hepburn,17,0,2,9,0,0,11
Iowa,Blanchard,21,5,10,3,0,0,18
Iowa,Allison,1106,63,290,290,53,99,795
Iowa,St. Charles,724,24,186,204,71,13,498
Iowa,Pleasant Plain,75,11,22,16,2,5,56
Iowa,Colwell,69,2,27,20,2,0,51
Iowa,Toronto,94,9,29,28,2,0,68
Iowa,Andover,100,1,29,18,10,4,62
Iowa,Sully,865,21,242,216,80,39,598
Iowa,Kellogg,603,41,166,168,33,9,417
Iowa,Wadena,254,15,66,86,10,4,181
Iowa,Brighton,679,48,206,127,55,4,440
Iowa,East Peru,101,15,48,12,5,1,81
Iowa,Crawfordsville,317,18,84,85,17,13,217
Iowa,Nora Springs,1523,52,381,440,129,63,1065
Iowa,Griswold,1189,82,274,271,67,24,718
Iowa,Everly,597,40,151,177,28,4,400
Iowa,Royal,339,36,70,114,30,6,256
Iowa,Nodaway,97,2,21,26,13,3,65
Iowa,Guttenberg,1852,157,647,480,226,44,1554
Iowa,Pomeroy,603,35,168,164,50,15,432
Iowa,Rockwell City,2165,117,712,588,161,35,1613
Iowa,Sioux Rapids,791,49,200,174,76,19,518
Iowa,Bouton,135,5,33,48,5,5,96
Iowa,Greene,1006,82,303,236,127,22,770
Iowa,Plainfield,518,10,139,150,31,2,332
Iowa,Tripoli,1210,70,294,320,127,50,861
Iowa,Woodward,1543,192,289,336,74,18,909
Iowa,Mystic,375,46,121,94,3,1,265
Iowa,Carroll,9899,489,2146,2380,1248,529,6792
Iowa,Bloomfield,2658,88,663,675,336,129,1891
Iowa,Templeton,389,24,99,99,33,10,265
Iowa,Manning,1542,69,436,315,160,42,1022
Iowa,Glidden,1177,45,240,295,129,25,734
Iowa,Carson,729,45,143,182,103,39,512
Iowa,Sioux Center,7499,443,861,985,1124,590,4003
Iowa,Portsmouth,134,5,51,31,9,1,97
Iowa,Elk Horn,501,40,138,159,42,20,399
Iowa,Earling,367,26,120,70,33,17,266
Iowa,Defiance,209,23,92,38,8,2,163
Iowa,Jolley,23,0,9,10,0,0,19
Iowa,Lidderdale,181,7,80,29,8,2,126
Iowa,Early,664,12,159,189,58,17,435
Iowa,Bevington,50,6,12,12,0,0,30
Iowa,Mount Auburn,112,9,25,46,4,0,84
Iowa,Derby,146,8,24,55,0,0,87
Iowa,Lockridge,311,27,115,60,18,2,222
Iowa,Rolfe,623,73,142,134,28,18,395
Iowa,Goldfield,555,37,186,121,45,12,401
Iowa,Arcadia,477,24,119,132,39,7,321
Iowa,Decorah,7765,169,1146,1092,1005,838,4250
Iowa,Postville,2530,380,429,415,86,61,1371
Iowa,Brandon,305,32,77,70,13,6,198
Iowa,Rowley,260,8,90,60,8,9,175
Iowa,Van Meter,1192,41,257,301,155,46,800
Iowa,Springville,1093,19,293,276,126,45,759
Iowa,Morley,80,10,22,21,3,0,56
Iowa,Lanesboro,129,13,50,29,4,4,100
Iowa,Pacific Junction,425,68,94,132,9,3,306
Iowa,Newton,15167,798,4584,3538,1021,354,10295
Iowa,Gillett Grove,25,6,16,2,1,0,25
Iowa,Graf,60,6,20,9,4,4,43
Iowa,Greenville,64,8,11,27,2,0,48
Iowa,Lake City,1825,104,486,477,197,130,1394
Iowa,Lost Nation,493,49,135,131,23,7,345
Iowa,Earlham,1489,27,286,398,223,53,987
Iowa,Pulaski,321,23,101,53,20,9,206
Iowa,Dexter,619,17,150,168,66,21,422
Iowa,Waverly,10075,151,1644,1885,1422,950,6052
Iowa,Woolstock,171,11,48,63,6,2,130
Iowa,Atkins,1861,56,362,438,296,112,1264
Iowa,Gladbrook,981,14,255,282,79,54,684
Iowa,Westphalia,126,6,29,43,3,2,83
Iowa,Stacyville,552,54,212,120,19,4,409
Iowa,Norway,551,29,149,159,44,2,383
Iowa,Clarion,2772,237,633,737,241,62,1910
Iowa,Orleans,420,3,91,133,111,37,375
Iowa,Hawarden,2706,415,632,464,175,68,1754
Iowa,Wilton,2833,128,737,590,321,127,1903
Iowa,Leando,42,0,8,34,0,0,42
Iowa,Rock Rapids,2556,164,413,545,350,168,1640
Iowa,Ringsted,480,11,124,157,47,13,352
Iowa,Low Moor,276,22,65,65,8,14,174
Iowa,Lorimor,369,36,120,78,4,7,245
Iowa,Afton,900,62,240,271,82,10,665
Iowa,Windsor Heights,4990,178,598,1185,1271,452,3684
Iowa,Maloy,17,0,5,6,1,1,13
Iowa,Lineville,195,25,77,26,8,10,146
Iowa,Crystal Lake,246,17,102,52,6,2,179
Iowa,Deep River,239,32,82,48,9,4,175
Iowa,Harper,85,2,22,15,12,0,51
Iowa,Bridgewater,141,2,36,54,14,6,112
Iowa,Neola,933,35,198,279,95,22,629
Iowa,Burt,547,41,146,164,20,9,380
Iowa,Spragueville,129,16,24,25,0,2,67
Iowa,Wesley,389,28,90,115,19,3,255
Iowa,Titonka,535,33,148,127,34,8,350
Iowa,Whitten,170,12,43,57,1,0,113
Iowa,Iowa Falls,5124,334,1181,1339,441,235,3530
Iowa,Evansdale,4786,378,1358,1030,256,50,3072
Iowa,Elk Run Heights,970,94,347,272,78,18,809
Iowa,Schaller,798,66,201,158,68,17,510
Iowa,Sac City,2137,107,566,474,237,81,1465
Iowa,Calmar,1017,37,225,267,87,45,661
Iowa,Yetter,30,2,8,10,0,0,20
Iowa,Rake,164,19,54,44,13,1,131
Iowa,St. Marys,184,3,39,65,26,8,141
Iowa,Martensdale,498,14,138,101,29,6,288
Iowa,Cumming,384,3,66,64,82,38,253
Iowa,Clarinda,5398,329,1248,1514,550,201,3842
Iowa,Donnellson,939,37,264,204,89,27,621
Iowa,Delmar,512,22,124,136,38,18,338
Iowa,Rockford,785,20,190,231,96,33,570
Iowa,Udell,45,5,9,19,0,4,37
Iowa,Centerville,5487,434,1326,1453,535,203,3951
Iowa,Williams,392,14,116,85,38,6,259
Iowa,Tipton,3196,91,904,791,323,85,2194
Iowa,Lester,269,16,73,75,21,1,186
Iowa,Inwood,938,57,207,260,54,15,593
Iowa,Reasnor,138,6,39,31,11,3,90
Iowa,Ocheyedan,512,31,167,107,45,21,371
Iowa,Hiawatha,7281,340,1479,1615,906,248,4588
Iowa,Cedar Rapids,131360,5517,22828,30654,20259,8124,87382
Iowa,Westwood,94,0,10,23,24,24,81
Iowa,Rome,89,15,25,16,2,0,58
Iowa,Mount Pleasant,8528,455,2221,1887,900,304,5767
Iowa,College Springs,226,14,56,53,18,4,145
Iowa,Braddyville,131,1,37,44,16,4,102
Iowa,Libertyville,378,17,129,93,39,5,283
Iowa,Center Point,2534,54,414,680,314,82,1544
Iowa,Elkhart,813,12,227,222,56,24,541
Iowa,Des Moines,215932,19541,42200,42365,24970,11261,140337
Iowa,St. Ansgar,1237,79,264,276,129,66,814
Iowa,Cushing,208,11,75,37,13,7,143
Iowa,Brunsville,134,2,48,40,15,0,105
Iowa,Atalissa,350,20,129,82,11,0,242
Iowa,Pierson,378,10,89,117,20,0,236
Iowa,Walford,1471,11,211,438,222,107,989
Iowa,Coon Rapids,1283,78,310,270,164,36,858
Iowa,Randall,170,10,30,51,14,10,115
Iowa,Salix,367,10,92,118,23,9,252
Iowa,Le Roy,6,0,6,0,0,0,6
Iowa,Varina,48,5,15,8,3,0,31
Iowa,Larchwood,927,62,229,181,142,29,643
Iowa,Fayette,1146,36,140,195,108,66,545
Iowa,Fairbank,1154,44,290,338,127,21,820
Iowa,Fertile,307,19,103,77,28,3,230
Iowa,Stanley,131,6,38,20,13,6,83
Iowa,Traer,1603,89,387,437,192,53,1158
Iowa,Mechanicsville,986,59,305,218,93,33,708
Iowa,Delhi,491,22,175,91,62,15,365
Iowa,Oxford Junction,415,24,172,108,9,2,315
Iowa,Paton,195,9,43,62,19,6,139
Iowa,Riceville,827,37,266,158,60,25,546
Iowa,What Cheer,773,77,215,140,42,7,481
Iowa,Webster,141,12,27,39,4,3,85
Iowa,South English,278,28,69,52,21,11,181
Iowa,Ollie,202,18,61,59,5,3,146
Iowa,Keota,1027,43,266,247,60,35,651
Iowa,Delta,338,43,118,77,7,0,245
Iowa,Hubbard,739,38,214,206,85,14,557
Iowa,Garner,3059,74,671,666,532,134,2077
Iowa,Wapello,2055,180,458,550,77,64,1329
Iowa,Grandview,503,48,162,103,37,17,367
Iowa,Lincoln,121,10,44,27,1,1,83
Iowa,Dysart,1437,70,410,392,119,46,1037
Iowa,Bancroft,688,20,184,173,65,13,455
Iowa,Eldora,2664,202,675,584,223,110,1794
Iowa,Rippey,224,32,65,43,14,3,157
Iowa,Primghar,917,47,229,199,103,32,610
Iowa,Boxholm,162,6,75,34,18,4,137
Iowa,Barnum,273,12,60,65,9,5,151
Iowa,Ogden,1997,77,528,539,194,68,1406
Iowa,Washburn,656,21,259,172,33,91,576
Iowa,Twin Lakes,189,0,17,73,40,48,178
Iowa,Toeterville,38,0,8,17,13,0,38
Iowa,Sun Valley Lake,249,0,88,66,68,17,239
Iowa,Stone City,241,30,72,26,45,0,173
Iowa,Sexton,0,0,0,0,0,0,0
Iowa,Watkins,116,0,61,27,10,0,98
Iowa,St. Joseph,123,0,25,21,4,0,50
Iowa,South Amana,121,0,7,60,14,40,121
Iowa,Roseville,0,0,0,0,0,0,0
Iowa,Rochester,90,0,9,45,0,0,54
Iowa,River Sioux,97,17,29,13,0,5,64
Iowa,Portland,55,0,27,18,10,0,55
Iowa,Percival,90,17,20,25,4,5,71
Iowa,St. Benedict,26,0,13,7,6,0,26
Iowa,Otranto,0,0,0,0,0,0,0
Iowa,West Amana,220,0,28,60,14,0,102
Iowa,Amana,324,14,80,127,29,0,250
Iowa,Corley,23,0,0,0,23,0,23
Iowa,Conroy,255,17,116,42,11,0,186
Iowa,Climbing Hill,124,5,60,23,0,0,88
Iowa,Chapin,110,26,25,27,25,0,103
Iowa,California Junction,76,8,7,31,7,0,53
Iowa,Burr Oak,175,3,62,41,12,0,118
Iowa,Weston,84,26,58,0,0,0,84
Iowa,Burchinal,13,0,0,13,0,0,13
Iowa,Bolan,8,0,0,8,0,0,8
Iowa,Bentley,105,0,55,7,11,7,80
Iowa,Beaverdale,1032,71,263,236,89,33,692
Iowa,Bartlett,10,5,5,0,0,0,10
Iowa,Athelstan,16,6,4,0,0,0,10
Iowa,Anderson,44,0,17,5,0,0,22
Iowa,Bradford,89,0,0,70,0,0,70
Iowa,Denmark,376,49,106,79,39,18,291
Iowa,New Haven,80,24,12,6,6,0,48
Iowa,Mineola,154,11,41,26,26,14,118
Iowa,Franklin,141,6,53,40,12,5,116
Iowa,Persia,301,15,69,81,24,0,189
Iowa,Collins,436,23,110,91,27,10,261
Iowa,Kellerton,294,38,81,70,7,2,198
Iowa,Diagonal,387,29,110,93,30,15,277
Iowa,Grant,126,8,38,41,0,0,87
Iowa,Badger,509,7,151,150,42,21,371
Iowa,Emmetsburg,3771,165,726,1000,511,240,2642
Iowa,Richland,617,24,159,174,72,22,451
Iowa,Kinross,51,10,20,13,1,0,44
Iowa,Gibson,43,1,17,11,1,4,34
Iowa,Woden,233,26,60,52,17,3,158
Iowa,Imogene,31,0,7,10,1,1,19
Iowa,Wallingford,198,16,57,64,8,2,147
Iowa,Searsboro,184,10,56,49,9,1,125
Iowa,Mona,96,0,36,25,0,0,61
Iowa,Colo,916,32,260,206,59,21,578
Iowa,Ferguson,171,18,75,46,4,0,143
Iowa,Miller,22,0,22,0,0,0,22
Iowa,Middle Amana,752,39,125,173,192,7,536
Iowa,Meyer,12,0,0,12,0,0,12
Iowa,Loveland,0,0,0,0,0,0,0
Iowa,Madrid,2584,79,651,638,393,103,1864
Iowa,Arlington,471,27,168,109,24,7,335
Iowa,Gilbert,955,9,117,203,193,69,591
Iowa,Northwood,2205,144,591,475,196,84,1490
Iowa,Henderson,172,10,36,58,13,0,117
Iowa,Little Cedar,41,8,33,0,0,0,41
Iowa,Lake Panorama,864,0,216,236,210,107,769
Iowa,Kent,26,0,0,13,0,0,13
Iowa,Maharishi Vedic City,593,14,36,107,105,174,436
Iowa,Liscomb,278,4,107,64,15,3,193
Iowa,Manly,1471,70,353,416,100,42,981
Iowa,Lehigh,405,35,135,141,20,8,339
Iowa,Diamondhead Lake,347,49,90,33,85,9,266
Iowa,East Amana,43,7,30,6,0,0,43
Iowa,Irwin,341,10,97,113,32,11,263
Iowa,Casey,385,24,124,85,17,4,254
Iowa,Okoboji,881,4,88,210,206,157,665
Iowa,Milford,2989,144,677,806,292,93,2012
Iowa,New Hampton,3445,234,923,745,406,57,2365
Iowa,Eagle Grove,3437,233,883,814,291,90,2311
Iowa,Tennant,72,8,19,16,7,0,50
Iowa,Murray,717,32,200,194,28,11,465
Iowa,Garden Grove,208,19,62,28,11,3,123
Iowa,Osceola,5021,557,1231,1012,369,193,3362
Iowa,Modale,286,19,101,75,10,11,216
Iowa,Magnolia,149,15,73,26,5,0,119
Iowa,Grundy Center,2700,150,638,640,388,123,1939
Iowa,Mediapolis,1713,46,323,438,256,83,1146
Iowa,Lamoni,2498,162,261,291,214,261,1189
Iowa,Danville,1042,26,220,241,114,57,658
Iowa,Alton,1299,75,287,244,171,58,835
Iowa,Macedonia,241,19,54,73,14,10,170
Iowa,Superior,226,22,54,53,2,0,131
Iowa,Pilot Mound,189,14,98,54,7,0,173
Iowa,Jewell Junction,1265,37,224,294,142,78,775
Iowa,Grand River,202,24,48,51,24,0,147
Iowa,Davis City,239,35,90,41,2,6,174
Iowa,Havelock,132,3,41,35,3,3,85
Iowa,Matlock,82,7,26,28,2,0,63
Iowa,George,1150,111,288,299,119,39,856
Iowa,North Liberty,18357,286,1506,3320,3741,2405,11258
Iowa,Laurel,256,28,76,53,22,4,183
Iowa,Clemons,156,14,49,32,8,12,115
Iowa,Zearing,540,21,128,159,74,11,393
Iowa,Cambridge,804,38,127,213,100,18,496
Iowa,Millersburg,133,11,62,20,4,1,98
Iowa,Owasa,46,0,24,8,3,3,38
Iowa,Duncan,103,11,39,19,22,0,91
Iowa,Waterville,116,11,34,40,8,3,96
Iowa,Maxwell,832,24,191,228,99,19,561
Iowa,Guernsey,47,1,21,10,4,0,36
Iowa,Albia,3761,394,896,777,390,52,2509
Iowa,Blencoe,248,8,68,73,16,9,174
Iowa,Panorama Park,90,8,32,28,4,5,77
Iowa,Maysville,179,10,82,21,27,0,140
Iowa,McCausland,309,11,54,84,45,21,215
Iowa,Montezuma,1388,77,381,313,130,27,928
Iowa,Buffalo,1184,118,457,235,53,14,877
Iowa,Holiday Lake,399,9,163,106,63,28,369
Iowa,High Amana,77,0,19,17,11,10,57
Iowa,Hayfield,82,16,9,22,0,14,61
Iowa,Green Mountain,165,27,38,31,10,4,110
Iowa,Garden City,146,0,42,54,6,0,102
Iowa,Frytown,35,0,19,16,0,0,35
Iowa,Homestead,250,0,21,53,44,11,129
Iowa,Albion,615,86,192,121,39,9,447
Iowa,Victor,843,41,294,176,76,17,604
Iowa,Morning Sun,857,79,206,211,84,20,600
Iowa,Ellston,32,0,5,11,10,0,26
Iowa,Nevada,6798,210,1252,1867,930,277,4536
Iowa,Gowrie,940,56,169,270,122,32,649
Iowa,Shannon City,81,2,46,10,4,0,62
Iowa,Fort Dodge,24417,1612,5352,5728,2428,833,15953
Iowa,Bennett,357,18,127,86,25,10,266
Iowa,Lime Springs,538,34,212,103,28,14,391
Iowa,Laurens,1224,96,346,344,108,14,908
Iowa,Lynnville,446,24,166,72,22,9,293
Iowa,Lambs Grove,250,7,44,79,26,14,170
Iowa,Colfax,1915,48,625,427,181,36,1317
Iowa,Maynard,542,13,122,128,59,21,343
Iowa,Mason City,27309,1504,5917,7633,2669,1317,19040
Iowa,Agency,603,41,184,175,44,8,452
Iowa,Valeria,41,2,7,13,4,0,26
Iowa,Duncombe,287,17,87,90,18,6,218
Iowa,Clermont,581,24,179,168,58,22,451
Iowa,West Branch,2061,58,460,537,354,170,1579
Iowa,Bellevue,2267,151,558,471,258,107,1545
Iowa,Meservey,197,9,76,70,6,1,162
Iowa,Clear Lake,7644,428,1650,2049,1211,407,5745
Iowa,Castana,145,9,41,26,10,4,90
Iowa,Britt,1915,159,569,395,178,62,1363
Iowa,New Liberty,173,7,57,40,8,2,114
Iowa,Dixon,185,0,69,41,20,5,135
Iowa,St. Anthony,50,3,16,17,1,0,37
Iowa,Mallard,215,18,86,55,11,5,175
Iowa,St. Donatus,107,7,49,27,8,2,93
Iowa,Hastings,188,11,46,35,8,7,107
Iowa,Ames,65937,713,3746,6718,9381,9093,29651
Iowa,Humboldt,4583,302,1070,1073,635,188,3268
Iowa,Bradgate,63,3,22,27,0,1,53
Iowa,Manchester,5037,391,1316,1165,356,283,3511
Iowa,Greeley,260,24,108,35,7,1,175
Iowa,Earlville,841,68,300,188,47,14,617
Iowa,Polk City,4481,54,578,977,800,339,2748
Iowa,Ankeny,59152,872,6567,11937,12627,5365,37368
Iowa,Goodell,89,10,45,20,0,0,75
Iowa,Anamosa,5461,562,1618,1210,278,275,3943
Iowa,Chariton,4151,276,1195,1022,328,63,2884
Iowa,Melrose,155,16,50,41,8,0,115
Iowa,Sibley,2639,224,610,607,224,130,1795
Iowa,Bassett,49,2,27,11,1,0,41
Iowa,Panora,1162,73,238,280,140,24,755
Iowa,Winfield,1042,98,231,259,104,20,712
Iowa,Archer,144,7,55,42,4,2,110
Iowa,Vining,70,3,31,14,5,1,54
Iowa,Melvin,248,34,72,41,25,2,174
Iowa,Fredonia,292,50,85,27,2,0,164
Iowa,Eldon,1071,74,330,246,36,20,706
Iowa,Linn Grove,190,39,54,34,18,8,153
Iowa,Clayton,53,8,14,20,5,3,50
Iowa,Elma,612,27,229,129,34,9,428
Iowa,Luana,268,24,71,53,20,8,176
Iowa,McGregor,821,46,218,229,88,37,618
Iowa,Buffalo Center,989,78,190,247,132,28,675
Iowa,Chester,193,9,39,67,6,5,126
Iowa,Protivin,327,15,125,76,23,13,252
Iowa,Letts,451,29,117,111,16,4,277
Iowa,Blakesburg,297,29,79,101,12,5,226
Iowa,Indianola,15653,437,2864,3288,1970,1094,9653
Iowa,Elkport,6,1,4,1,0,0,6
Kansas,Paradise,28,0,4,18,2,2,26
Kansas,Cedar Vale,519,20,118,151,23,7,319
Kansas,Fall River,137,10,34,49,15,1,109
Kansas,Beloit,3995,97,786,974,493,239,2589
Kansas,Olsburg,217,4,81,45,15,11,156
Kansas,Harper,1287,130,400,259,66,37,892
Kansas,Cawker City,591,38,177,153,29,18,415
Kansas,Hunter,63,0,27,22,6,2,57
Kansas,Scottsville,26,5,6,9,0,4,24
Kansas,Peru,169,28,68,18,8,9,131
Kansas,Perry,894,27,254,240,62,22,605
Kansas,Woodbine,211,14,60,41,30,2,147
Kansas,Plainville,2025,120,404,472,209,94,1299
Kansas,Morrill,234,5,80,41,22,0,148
Kansas,Americus,723,58,221,186,50,16,531
Kansas,Willis,24,1,14,5,1,2,23
Kansas,Selden,337,11,60,108,53,2,234
Kansas,Deerfield,710,170,73,93,21,12,369
Kansas,Lake Quivira,982,2,41,97,300,226,666
Kansas,Council Grove,2282,202,543,597,199,61,1602
Kansas,Gridley,314,26,81,78,23,2,210
Kansas,Douglass,1881,122,420,357,169,102,1170
Kansas,Lucas,387,20,99,120,42,7,288
Kansas,El Dorado,12988,714,2424,3428,1289,634,8489
Kansas,Garfield,197,33,44,62,11,8,158
Kansas,Garden City,26806,4825,3475,4903,1686,929,15818
Kansas,Almena,398,21,101,93,31,15,261
Kansas,Oxford,1065,51,265,276,121,38,751
Kansas,Wellington,7834,459,1851,1741,792,283,5126
Kansas,Olpe,575,41,198,104,44,25,412
Kansas,Palco,163,7,29,33,24,6,99
Kansas,Bucklin,828,42,137,222,127,41,569
Kansas,Elwood,850,138,322,161,13,17,651
Kansas,Effingham,534,50,146,141,33,19,389
Kansas,Nortonville,619,34,160,144,36,18,392
Kansas,Admire,79,2,29,23,10,2,66
Kansas,Great Bend,15544,1324,3318,3828,1218,515,10203
Kansas,Natoma,302,19,86,83,37,10,235
Kansas,Lewis,399,67,61,123,25,4,280
Kansas,Strong City,454,56,102,125,40,14,337
Kansas,Leona,32,4,4,7,2,0,17
Kansas,Fowler,495,68,55,112,39,25,299
Kansas,Horton,1758,142,444,398,90,56,1130
Kansas,Conway Springs,1475,52,307,304,113,79,855
Kansas,Agra,222,12,57,96,18,3,186
Kansas,Kensington,464,21,147,115,51,22,356
Kansas,Basehor,5669,85,1059,1223,735,681,3783
Kansas,Walton,305,9,114,71,19,3,216
Kansas,Cedar,19,2,9,3,1,0,15
Kansas,Frankfort,698,54,192,187,80,18,531
Kansas,Colby,5505,172,825,1663,562,216,3438
Kansas,Luray,165,4,59,34,23,7,127
Kansas,Emporia,24649,1936,3936,4059,2444,1446,13821
Kansas,Dodge City,27808,5118,3872,4347,1704,880,15921
Kansas,Utica,127,2,27,60,11,2,102
Kansas,Collyer,69,6,21,27,5,0,59
Kansas,Powhattan,93,8,19,22,4,0,53
Kansas,Caldwell,996,51,320,245,57,50,723
Kansas,Argonia,535,15,75,134,63,17,304
Kansas,Chautauqua,42,11,16,4,1,2,34
Kansas,Anthony,2169,158,565,490,182,110,1505
Kansas,Wheaton,66,6,15,20,5,6,52
Kansas,Westmoreland,665,37,213,125,33,58,466
Kansas,Bassett,17,0,7,7,0,1,15
Kansas,Mulberry,451,59,132,95,13,32,331
Kansas,Cedar Point,21,0,2,2,2,0,6
Kansas,Wamego,4811,192,811,1071,888,239,3201
Kansas,Lancaster,225,5,94,56,10,4,169
Kansas,Arcadia,425,46,106,100,8,15,275
Kansas,Huron,89,12,21,22,1,2,58
Kansas,Galatia,29,0,11,14,1,1,27
Kansas,Downs,806,37,245,239,75,48,644
Kansas,Milan,60,12,20,14,3,0,49
Kansas,Moran,408,33,130,105,25,12,305
Kansas,Copeland,323,60,58,58,31,13,220
Kansas,Winchester,628,48,170,135,60,29,442
Kansas,Yoder,192,0,35,81,62,0,178
Kansas,Wright,109,0,20,33,10,10,73
Kansas,Wilroads Gardens,432,114,128,69,6,5,322
Kansas,Weskan,140,0,11,32,21,8,72
Kansas,Welda,63,18,36,9,0,0,63
Kansas,Wakarusa,257,18,65,49,20,34,186
Kansas,Vassar,822,16,321,147,118,15,617
Kansas,Ensign,221,56,37,56,8,4,161
Kansas,Talmage,117,11,20,65,0,0,96
Kansas,Rosalia,100,12,25,20,21,0,78
Kansas,Riverton,881,56,272,131,28,51,538
Kansas,Piqua,93,5,16,22,10,0,53
Kansas,Odin,125,0,41,36,8,8,93
Kansas,Munjor,217,0,132,31,7,0,170
Kansas,Menlo,52,1,10,11,6,0,28
Kansas,Gem,125,1,15,20,17,2,55
Kansas,Roxbury,40,16,24,0,0,0,40
Kansas,Elsmore,81,7,22,17,0,2,48
Kansas,De Soto,6138,505,782,1386,1012,471,4156
Kansas,Kansas City,152069,20745,31001,27596,10973,5410,95725
Kansas,Sedan,951,109,304,189,89,18,709
Kansas,Williamsburg,385,28,117,53,56,6,260
Kansas,Geuda Springs,157,10,53,50,1,8,122
Kansas,Logan,594,16,134,147,74,49,420
Kansas,Paxico,262,18,29,74,25,8,154
Kansas,Burdett,433,10,119,126,52,19,326
Kansas,Scott City,3954,386,828,800,374,143,2531
Kansas,Lane,225,10,80,62,20,0,172
Kansas,Latham,169,13,43,49,2,0,107
Kansas,Dresden,96,28,17,11,3,0,59
Kansas,Thayer,609,10,127,205,31,31,404
Kansas,Hardtner,182,22,41,47,15,4,129
Kansas,Radium,22,1,14,0,4,0,19
Kansas,Seward,38,2,26,3,0,0,31
Kansas,Sylvan Grove,290,9,77,74,32,25,217
Kansas,Holcomb,2204,183,318,451,167,103,1222
Kansas,Ingalls,222,18,46,52,27,7,150
Kansas,Rantoul,199,15,60,25,13,4,117
Kansas,Jennings,146,12,56,21,13,5,107
Kansas,Bushton,285,16,68,69,17,11,181
Kansas,Overbrook,938,37,273,232,85,56,683
Kansas,Melvern,455,45,129,79,20,22,295
Kansas,Arlington,545,45,141,169,38,5,398
Kansas,Holton,3257,136,796,756,229,196,2113
Kansas,Junction City,23703,902,3525,6170,1994,889,13480
Kansas,Longton,376,25,96,80,17,9,227
Kansas,Partridge,217,39,56,49,8,4,156
Kansas,Pretty Prairie,536,27,129,136,53,48,393
Kansas,Wathena,1437,108,371,266,152,60,957
Kansas,Brownell,55,2,12,18,4,1,37
Kansas,Mayfield,95,5,35,14,7,2,63
Kansas,Mulvane,5719,95,1100,1481,856,437,3969
Kansas,Hamlin,71,2,16,4,10,0,32
Kansas,Severance,122,16,39,24,0,0,79
Kansas,Coolidge,187,10,42,9,39,3,103
Kansas,St. Paul,614,55,94,169,64,27,409
Kansas,Stark,73,6,21,32,1,0,60
Kansas,Spearville,1015,18,140,215,158,131,662
Kansas,Raymond,70,3,26,27,2,0,58
Kansas,Haddam,113,5,33,18,14,5,75
Kansas,Earlton,102,11,10,32,0,0,53
Kansas,Atchison,10675,473,1950,2020,943,623,6009
Kansas,Blue Rapids,1081,51,325,231,37,19,663
Kansas,Danville,46,4,17,10,2,2,35
Kansas,Miltonvale,586,61,155,111,61,19,407
Kansas,Jamestown,341,14,70,101,36,13,234
Kansas,Aurora,75,9,34,8,0,0,51
Kansas,Redfield,113,9,44,21,0,0,74
Kansas,Zurich,99,4,34,28,8,0,74
Kansas,Woodston,100,22,32,13,0,0,67
Kansas,Stockton,1543,139,326,380,146,113,1104
Kansas,Ashland,633,26,146,161,93,54,480
Kansas,Greeley,271,6,95,64,10,0,175
Kansas,Marquette,704,29,177,199,73,21,499
Kansas,Bendena,113,0,15,47,21,12,95
Kansas,Bucyrus,412,0,132,104,45,0,281
Kansas,Wallace,73,3,24,21,8,0,56
Kansas,Glen Elder,427,8,92,135,38,5,278
Kansas,Simpson,54,8,11,23,2,0,44
Kansas,Emmett,122,8,47,17,0,0,72
Kansas,Burden,715,31,166,155,55,10,417
Kansas,Hesston,3777,31,443,570,873,478,2395
Kansas,Winfield,12138,848,2623,2794,1070,643,7978
Kansas,Ottawa,12275,682,2700,2830,981,619,7812
Kansas,Halstead,2158,120,427,531,200,68,1346
Kansas,Tonganoxie,5073,247,1103,917,804,273,3344
Kansas,Gaylord,165,13,35,31,12,7,98
Kansas,Catharine,32,0,8,12,0,0,20
Kansas,Toronto,239,25,66,77,15,3,186
Kansas,McLouth,1184,52,270,259,89,35,705
Kansas,Park,142,7,51,21,11,3,93
Kansas,Gove City,89,5,17,18,7,3,50
Kansas,Scranton,645,43,172,153,37,11,416
Kansas,Timken,68,2,6,25,0,4,37
Kansas,Soldier,90,3,16,28,6,2,55
Kansas,Pawnee Rock,266,29,61,81,9,1,181
Kansas,Wetmore,354,8,82,91,23,6,210
Kansas,Lost Springs,108,13,49,16,0,4,82
Kansas,Chicopee,673,11,129,134,141,72,487
Kansas,Falun,60,14,23,7,0,0,44
Kansas,Benedict,94,29,10,29,0,0,68
Kansas,Coyville,50,5,1,21,0,1,28
Kansas,McCune,396,14,86,120,37,11,268
Kansas,New Albany,165,12,33,38,2,0,85
Kansas,Brewster,327,10,61,86,31,13,201
Kansas,Montezuma,892,252,111,197,56,33,649
Kansas,Bunker Hill,179,20,44,30,6,4,104
Kansas,Dorrance,223,1,51,53,15,14,134
Kansas,Summerfield,124,14,58,22,10,2,106
Kansas,Denton,160,7,53,34,21,1,116
Kansas,White Cloud,109,9,25,27,7,5,73
Kansas,Elmdale,67,17,3,29,5,3,57
Kansas,Long Island,153,2,35,38,19,2,96
Kansas,Prairie View,116,3,29,26,20,1,79
Kansas,Coats,142,33,19,40,0,0,92
Kansas,Milton,169,26,55,34,0,0,115
Kansas,Marienthal,53,0,1,13,20,19,53
Kansas,McConnell AFB,1488,38,102,355,169,43,707
Kansas,Lowell,368,0,90,118,12,24,244
Kansas,Fort Dodge,172,36,66,18,34,18,172
Kansas,Fort Riley,7116,83,925,921,363,31,2323
Kansas,Franklin,499,65,85,127,0,18,295
Kansas,Grantville,186,0,31,52,18,0,101
Kansas,Harris,0,0,0,0,0,0,0
Kansas,Healy,203,10,43,66,20,11,150
Kansas,Hillsdale,305,0,59,157,46,17,279
Kansas,Detroit,135,10,66,0,0,0,76
Kansas,Home,143,0,53,44,32,0,129
Kansas,Kickapoo Site 1,59,5,8,19,0,0,32
Kansas,Kickapoo Site 2,61,0,9,15,0,0,24
Kansas,Kickapoo Site 5,32,3,19,1,0,2,25
Kansas,Kickapoo Site 7,34,5,13,12,0,0,30
Kansas,Kickapoo Tribal Center,144,10,32,44,16,6,108
Kansas,Kipp,112,0,25,0,0,0,25
Kansas,Levant,30,0,13,17,0,0,30
Kansas,Kickapoo Site 6,36,0,9,6,0,0,15
Kansas,Sublette,1556,199,193,387,160,53,992
Kansas,Lawrence,95294,2228,8148,13981,14159,14098,52614
Kansas,Walnut,186,21,43,44,1,0,109
Kansas,Peabody,1171,42,342,349,57,42,832
Kansas,Dexter,327,21,90,78,33,16,238
Kansas,Wellsville,1987,78,496,444,177,46,1241
Kansas,Newton,18923,1312,3492,4354,1938,1346,12442
Kansas,Athol,37,4,17,6,6,0,33
Kansas,Neosho Falls,143,34,47,24,4,0,109
Kansas,Formoso,92,14,41,18,2,3,78
Kansas,Clifton,425,38,91,131,47,13,320
Kansas,Palmer,168,14,33,60,14,6,127
Kansas,Havana,97,18,17,22,6,0,63
Kansas,Salina,47230,3027,9899,10537,5384,2897,31744
Kansas,Canton,754,71,230,150,63,14,528
Kansas,Altoona,282,44,71,70,18,4,207
Kansas,Benton,971,16,165,252,200,53,686
Kansas,Sun City,36,4,10,12,1,0,27
Kansas,Ulysses,5639,830,938,1034,312,149,3263
Kansas,Tribune,765,50,148,144,129,18,489
Kansas,Longford,130,5,20,37,10,0,72
Kansas,Lakin,1974,349,396,314,109,41,1209
Kansas,Little River,497,16,134,126,48,0,324
Kansas,Medicine Lodge,2027,134,478,572,126,91,1401
Kansas,Lebo,753,37,189,203,69,33,531
Kansas,Waverly,677,31,169,123,105,31,459
Kansas,Blue Mound,332,45,92,116,5,7,265
Kansas,Havensville,138,2,70,28,13,0,113
Kansas,Louisville,214,54,70,26,16,0,166
Kansas,Belle Plaine,1585,80,454,466,102,42,1144
Kansas,Arma,1313,125,333,305,91,93,947
Kansas,Merriam,11243,641,1860,2833,1802,1109,8245
Kansas,Greenleaf,438,66,101,79,13,6,265
Kansas,Dunlap,30,3,22,2,3,0,30
Kansas,Hoxie,1145,65,300,321,164,43,893
Kansas,Bentley,558,40,114,130,51,15,350
Kansas,Olathe,135986,5584,13857,24632,27219,14252,85544
Kansas,Prairie Village,22048,162,1282,2969,6887,4675,15975
Kansas,Fairway,3947,15,205,466,966,1186,2838
Kansas,Bel Aire,7671,94,475,1304,2074,1265,5212
Kansas,La Harpe,579,32,199,151,32,5,419
Kansas,Gas,488,42,150,131,17,24,364
Kansas,Barnes,165,7,52,36,2,6,103
Kansas,Latimer,23,0,3,3,3,1,10
Kansas,Edgerton,1665,86,341,357,215,50,1049
Kansas,Gardner,21351,521,3168,4699,3291,1085,12764
Kansas,Herndon,134,6,50,34,8,1,99
Kansas,Dighton,1031,28,253,284,76,38,679
Kansas,Horace,109,20,28,11,11,0,70
Kansas,Goessel,582,24,139,134,74,32,403
Kansas,Ramona,107,17,16,34,9,2,78
Kansas,Udall,660,38,166,222,35,23,484
Kansas,Gypsum,441,20,101,141,33,10,305
Kansas,New Cambria,67,17,20,17,7,0,61
Kansas,Abilene,6422,628,1403,1314,821,333,4499
Kansas,Carlton,12,1,4,6,0,0,11
Kansas,Hepler,139,18,41,27,3,3,92
Kansas,Tampa,124,5,38,20,17,3,83
Kansas,Bronson,281,19,72,63,5,8,167
Kansas,Moundridge,2186,204,517,475,219,117,1532
Kansas,Lehigh,220,16,51,47,12,7,133
Kansas,Claflin,491,18,110,166,67,9,370
Kansas,Alton,119,20,30,19,16,3,88
Kansas,Schoenchen,161,9,61,31,16,2,119
Kansas,Ellis,2158,158,462,366,289,122,1397
Kansas,Oketo,82,4,37,9,17,0,67
Kansas,Axtell,384,22,114,71,36,11,254
Kansas,Valley Falls,1017,76,316,231,85,28,736
Kansas,Iola,5400,332,1136,1163,521,282,3434
Kansas,Meriden,731,23,170,170,43,25,431
Kansas,Prescott,255,43,68,42,28,12,193
Kansas,Pleasanton,1454,88,384,330,74,36,912
Kansas,Norcatur,316,25,64,93,22,2,206
Kansas,Greeley County unified government (balance),326,30,51,73,51,18,223
Kansas,Chase,514,65,94,131,24,10,324
Kansas,Frederick,6,3,2,1,0,0,6
Kansas,Niotaze,91,11,32,26,3,0,72
Kansas,Lincoln Center,1323,85,337,379,68,41,910
Kansas,Mission,9437,356,979,1876,2366,1323,6900
Kansas,Larned,3865,273,754,1196,457,198,2878
Kansas,Minneola,928,53,157,209,133,32,584
Kansas,Baileyville,269,0,120,32,19,0,171
Kansas,Parkerville,70,4,16,12,6,0,38
Kansas,Chetopa,1329,145,360,300,52,28,885
Kansas,Oswego,1839,117,454,528,127,68,1294
Kansas,Shawnee,65239,2161,7810,12689,13429,7235,43324
Kansas,Westwood,1624,33,98,199,405,376,1111
Kansas,Westwood Hills,378,6,18,27,98,140,289
Kansas,Cheney,2028,102,460,419,273,95,1349
Kansas,Linn,444,48,114,104,33,8,307
Kansas,Cherryvale,2194,166,449,603,131,51,1400
Kansas,Elk City,299,26,76,70,7,0,179
Kansas,Cullison,48,2,9,16,3,3,33
Kansas,Pratt,6774,348,1196,1654,782,331,4311
Kansas,Richfield,37,1,10,13,2,0,26
Kansas,Rolla,589,46,109,119,39,27,340
Kansas,Jewell,506,21,188,87,22,26,344
Kansas,Inman,1309,105,223,328,182,59,897
Kansas,Clearwater,2608,100,443,725,368,67,1703
Kansas,Leavenworth,36008,2022,6636,7615,3833,3542,23648
Kansas,Asherville,0,0,0,0,0,0,0
Kansas,Ada,139,0,45,10,0,0,55
Kansas,LeRoy,657,30,169,161,32,11,403
Kansas,Parkerfield,376,6,94,122,46,14,282
Kansas,Ransom,345,14,88,124,17,20,263
Kansas,Manhattan,55489,1117,3824,8079,7183,6832,27035
Kansas,Riley,1434,36,269,395,211,62,973
Kansas,Portis,100,4,18,29,12,0,63
Kansas,Reserve,54,28,11,9,2,0,50
Kansas,Hiawatha,3158,141,724,795,322,200,2182
Kansas,Nickerson,1038,82,218,294,72,30,696
Kansas,Chapman,1241,39,301,306,127,81,854
Kansas,Labette,55,11,17,11,5,0,44
Kansas,Linwood,508,60,172,103,22,4,361
Kansas,Bird City,530,45,105,132,90,4,376
Kansas,Elbing,336,3,44,90,49,16,202
Kansas,Barnard,39,1,12,16,5,5,39
Kansas,Harveyville,265,22,56,55,35,6,174
Kansas,Oberlin,1640,101,394,498,139,86,1218
Kansas,Plains,1121,159,180,166,90,44,639
Kansas,Galesburg,166,23,23,21,11,7,85
Kansas,Ford,226,12,86,49,22,0,169
Kansas,Louisburg,4386,123,685,1217,479,230,2734
Kansas,Willard,95,3,26,28,0,0,57
Kansas,Andover,12862,333,1151,2248,2376,1526,7634
Kansas,Bern,168,5,52,38,22,2,119
Kansas,Corning,235,2,36,45,35,4,122
Kansas,Goff,167,9,26,41,8,2,86
Kansas,Roseland,99,17,28,17,5,0,67
Kansas,Enterprise,1069,43,228,267,47,24,609
Kansas,Delphos,406,36,143,72,27,7,285
Kansas,Concordia,5138,299,936,1182,459,370,3246
Kansas,Madison,854,71,207,209,67,31,585
Kansas,Sharon Springs,858,34,177,233,115,41,600
Kansas,Atlanta,172,6,36,68,28,0,138
Kansas,Freeport,0,0,0,0,0,0,0
Kansas,Waldron,19,0,11,4,2,0,17
Kansas,Minneapolis,1736,94,405,476,222,71,1268
Kansas,Hillsboro,2851,183,443,663,342,176,1807
Kansas,Otis,274,38,61,82,22,8,211
Kansas,Olivet,44,1,25,15,0,0,41
Kansas,Quenemo,370,59,128,58,7,0,252
Kansas,Lenexa,53051,1508,5059,9454,12827,7719,36567
Kansas,Leoti,1549,189,318,338,129,41,1015
Kansas,McDonald,184,28,33,53,10,5,129
Kansas,Richmond,657,26,201,147,21,11,406
Kansas,Lansing,11835,846,2144,2557,1569,1142,8258
Kansas,Derby,23768,569,3127,5553,4413,2013,15675
Kansas,La Crosse,1170,91,228,334,127,72,852
Kansas,Offerle,228,15,29,49,36,6,135
Kansas,Cambridge,161,11,15,82,0,0,108
Kansas,Arkansas City,11986,935,2319,2819,776,436,7285
Kansas,Oneida,86,6,8,7,0,2,23
Kansas,Munden,105,0,26,35,15,8,84
Kansas,Vining,73,0,34,15,0,1,50
Kansas,Washington,1088,40,330,277,96,25,768
Kansas,Coffeyville,9578,1017,1703,2520,732,232,6204
Kansas,Sawyer,140,3,27,29,8,2,69
Kansas,Oak Hill,58,1,9,19,0,0,29
Kansas,Randall,65,0,21,27,2,1,51
Kansas,Florence,460,40,135,103,54,10,342
Kansas,Rossville,1263,45,302,306,108,27,788
Kansas,Marion,1832,147,353,479,203,106,1288
Kansas,Assaria,466,28,93,133,51,15,320
Kansas,Brookville,296,13,72,75,20,7,187
Kansas,White City,635,43,211,159,20,11,444
Kansas,Wilsey,144,9,55,36,8,5,113
Kansas,Kinsley,1569,199,352,398,141,69,1159
Kansas,Morganville,192,11,70,55,7,1,144
Kansas,Wakefield,1048,29,184,302,127,74,716
Kansas,Durham,100,20,46,13,2,3,84
Kansas,Lincolnville,167,15,73,24,8,7,127
Kansas,Burr Oak,199,30,53,63,20,2,168
Kansas,Maize,4696,44,738,1002,294,439,2517
Kansas,Belpre,125,21,25,13,5,0,64
Kansas,Allen,166,20,33,49,7,3,112
Kansas,Robinson,204,19,55,42,11,11,138
Kansas,Ozawkie,647,13,126,165,91,61,456
Kansas,Bennington,749,43,119,189,88,36,475
Kansas,Cuba,283,11,59,100,22,2,194
Kansas,Cottonwood Falls,770,58,170,216,88,31,563
Kansas,South Haven,342,26,54,83,49,13,225
Kansas,Grainfield,289,19,85,79,30,7,220
Kansas,Hunnewell,108,11,14,25,8,0,58
Kansas,Matfield Green,22,7,5,6,2,2,22
Kansas,Parsons,9876,895,2127,2384,775,487,6668
Kansas,Hanover,627,46,140,120,87,34,427
Kansas,Iuka,162,12,31,44,15,10,112
Kansas,Webber,26,2,8,16,0,0,26
Kansas,Centralia,558,32,118,139,60,24,373
Kansas,Scandia,507,16,100,147,45,29,337
Kansas,Clay Center,4079,266,847,984,423,336,2856
Kansas,Sterling,2515,110,327,478,209,232,1356
Kansas,Mildred,12,0,5,3,0,0,8
Kansas,La Cygne,1134,94,302,275,54,10,735
Kansas,Quinter,889,51,194,210,138,46,639
Kansas,Norton,2792,189,606,766,241,100,1902
Kansas,Leon,675,52,151,190,14,19,426
Kansas,Liberal,20251,3623,3739,3080,909,308,11659
Kansas,Hoyt,601,19,163,136,58,35,411
Kansas,Elgin,85,14,25,24,0,0,63
Kansas,Susank,24,4,6,10,1,0,21
Kansas,Mission Woods,177,0,8,14,69,54,145
Kansas,Albert,159,11,56,43,10,1,121
Kansas,Ellinwood,2375,201,505,624,180,118,1628
Kansas,St. George,951,20,90,178,175,63,526
Kansas,Bison,164,19,43,51,11,4,128
Kansas,Eudora,6745,249,1074,1224,1080,402,4029
Kansas,Macksville,545,94,85,88,31,16,314
Kansas,Bonner Springs,7796,613,1962,1517,703,440,5235
Kansas,Hope,380,22,144,77,34,7,284
Kansas,Bluff City,146,5,43,43,0,2,93
Kansas,Onaga,808,97,234,128,89,48,596
Kansas,Overland Park,188687,4013,15850,31368,47937,30466,129634
Kansas,Lebanon,283,18,96,53,27,5,199
Kansas,Sabetha,2555,147,631,472,320,125,1695
Kansas,Baxter Springs,4004,280,925,963,359,142,2669
Kansas,Tipton,218,8,60,67,26,2,163
Kansas,North Newton,1879,38,197,259,309,373,1176
Kansas,Edwardsville,4462,316,802,1125,335,197,2775
Kansas,Linn Valley,745,61,212,177,108,23,581
Kansas,Cunningham,403,18,79,129,45,25,296
Kansas,Stafford,1122,57,265,293,105,34,754
Kansas,Hays,20956,747,2887,3840,3178,1459,12111
Kansas,Fort Scott,7800,524,1502,2127,625,313,5091
Kansas,Fulton,116,2,33,27,9,2,73
Kansas,Cimarron,2312,187,301,541,262,89,1380
Kansas,Oskaloosa,1438,80,395,276,158,40,949
Kansas,Elk Falls,94,19,11,31,4,3,68
Kansas,Vermillion,86,3,29,16,7,3,58
Kansas,Clyde,861,39,190,227,74,31,561
Kansas,Eureka,2308,205,595,610,190,62,1662
Kansas,Lenora,326,7,92,82,42,23,246
Kansas,Hamilton,271,9,63,80,20,1,173
Kansas,Russell,4460,446,920,1191,406,492,3455
Kansas,Tescott,289,16,78,58,15,8,175
Kansas,Severy,207,6,72,70,12,10,170
Kansas,Liebenthal,163,11,45,24,12,3,95
Kansas,Hugoton,4067,515,762,958,163,101,2499
Kansas,Baldwin City,4658,118,711,735,612,485,2661
Kansas,Lecompton,701,49,128,111,40,35,363
Kansas,Green,171,11,23,62,16,4,116
Kansas,Burns,288,41,65,48,28,3,185
Kansas,Burlingame,968,58,227,218,65,22,590
Kansas,Savonburg,57,8,9,16,3,0,36
Kansas,Neosho Rapids,212,10,81,42,20,7,160
Kansas,Rose Hill,4024,221,612,1102,507,225,2667
Kansas,Winona,270,9,43,76,20,3,151
Kansas,Circleville,193,6,55,43,12,6,122
Kansas,Rexford,232,20,26,44,20,9,119
Kansas,Gorham,408,13,68,109,31,12,233
Kansas,Osborne,1507,80,380,315,190,30,995
Kansas,Milford,321,10,56,64,31,15,176
Kansas,Denison,127,11,47,29,3,2,92
Kansas,Zenda,79,9,20,19,17,1,66
Kansas,Meade,1592,80,431,353,179,55,1098
Kansas,Ellsworth,3030,261,803,770,260,113,2207
Kansas,Alta Vista,504,26,167,109,72,6,380
Kansas,Penalosa,2,0,0,2,0,0,2
Kansas,Kismet,424,86,74,92,53,5,310
Kansas,Norwich,487,13,72,129,73,22,309
Kansas,Russell Springs,25,4,9,4,2,0,19
Kansas,Nashville,27,1,10,10,3,1,25
Kansas,Fontana,263,39,46,70,18,0,173
Kansas,Osawatomie,4315,131,1220,927,320,85,2683
Kansas,Spring Hill,6315,89,1113,1498,717,325,3742
Kansas,Speed,33,4,10,9,1,2,26
Kansas,Kingman,2977,185,736,864,310,84,2179
Kansas,Burrton,876,39,191,197,98,32,557
Kansas,Beattie,215,23,90,23,30,10,176
Kansas,Agenda,44,1,17,12,2,1,33
Kansas,Rush Center,221,18,66,68,14,15,181
Kansas,Mount Hope,784,39,198,219,70,24,550
Kansas,Eastborough,762,7,25,123,176,208,539
Kansas,Garden Plain,779,36,151,155,123,34,499
Kansas,Goodland,4515,195,892,1273,435,143,2938
Kansas,Bartlett,60,6,23,15,1,0,45
Kansas,Girard,2721,161,564,598,236,140,1699
Kansas,Neodesha,2074,203,509,525,119,61,1417
Kansas,Buffalo,298,15,64,85,15,1,180
Kansas,Fredonia,2314,252,500,585,201,71,1609
Kansas,Sylvia,246,25,46,55,4,4,134
Kansas,Kirwin,155,3,72,22,17,8,122
Kansas,South Hutchinson,2494,277,658,722,156,62,1875
Kansas,Abbyville,80,0,25,33,3,0,61
Kansas,Auburn,1181,42,262,282,187,14,787
Kansas,McCracken,202,30,44,63,12,7,156
Kansas,Netawaka,174,8,53,40,11,3,115
Kansas,Carbondale,1371,68,356,287,77,18,806
Kansas,Moscow,225,40,55,32,19,3,149
Kansas,Osage City,2821,223,860,642,251,90,2066
Kansas,Mission Hills,3580,8,55,195,1145,1020,2423
Kansas,Galena,2924,296,759,728,151,125,2059
Kansas,Haviland,727,39,81,128,86,61,395
Kansas,WaKeeney,1988,98,466,612,190,67,1433
Kansas,Eskridge,555,44,189,147,33,6,419
Kansas,McFarland,358,22,118,51,29,5,225
Kansas,Bogue,344,18,50,44,48,8,168
Kansas,Hudson,98,11,26,20,13,4,74
Kansas,Chanute,9119,631,1904,2254,770,354,5913
Kansas,Lyons,3608,260,754,987,343,116,2460
Kansas,Hazelton,150,28,30,33,1,2,94
Kansas,Highland,1069,10,95,121,64,32,322
Kansas,Alexander,82,6,18,24,4,5,57
Kansas,Spivey,39,1,15,14,2,2,34
Kansas,Ogden,1745,65,384,411,98,18,976
Kansas,Randolph,160,3,40,40,18,10,111
Kansas,Maple Hill,648,12,158,123,53,52,398
Kansas,Glade,15,1,8,4,2,0,15
Kansas,Yates Center,1309,96,387,392,88,27,990
Kansas,Grenola,184,18,61,42,7,13,141
Kansas,Plevna,76,6,19,35,4,0,64
Kansas,Topeka,126877,8335,27279,25386,15364,8845,85209
Kansas,Mullinville,226,13,37,78,12,0,140
Kansas,Ness City,1512,115,341,322,192,70,1040
Kansas,Mayetta,301,22,80,68,9,7,186
Kansas,Delia,168,6,45,40,14,0,105
Kansas,Culver,112,12,52,17,4,1,86
Kansas,Mahaska,66,5,26,11,6,2,50
Kansas,Whiting,193,11,55,39,19,5,129
Kansas,Lyndon,1043,50,171,229,131,43,624
Kansas,Altamont,1047,41,197,234,111,41,624
Kansas,Morrowville,148,13,42,21,7,0,83
Kansas,Caney,1838,177,411,577,137,17,1319
Kansas,Liberty,91,7,25,25,4,0,61
Kansas,Wilmore,34,0,17,16,0,0,33
Kansas,Preston,167,14,20,49,13,4,100
Kansas,Republic,110,2,27,45,2,9,85
Kansas,Windom,110,10,22,20,10,2,64
Kansas,Howard,684,52,201,148,47,59,507
Kansas,Silver Lake,1514,21,280,308,203,116,928
Kansas,Uniontown,311,12,33,81,33,20,179
Kansas,Bushong,10,2,5,3,0,0,10
Kansas,Hartford,377,28,91,68,34,4,225
Kansas,Reading,201,15,51,48,7,6,127
Kansas,Clayton,63,8,15,20,2,0,45
Kansas,Everest,283,7,103,79,27,5,221
Kansas,Fairview,359,24,95,86,23,4,232
Kansas,St. Francis,1428,77,276,389,205,52,999
Kansas,Kanopolis,491,66,147,105,46,8,372
Kansas,Seneca,1990,120,653,457,179,81,1490
Kansas,Goddard,4319,248,684,932,533,222,2619
Kansas,Waterville,743,30,157,205,78,27,497
Kansas,Marysville,3289,189,929,682,271,192,2263
Kansas,Waldo,62,17,14,14,2,4,51
Kansas,Grinnell,283,12,95,80,30,8,225
Kansas,Syracuse,1808,283,401,242,134,44,1104
Kansas,Olmitz,110,21,26,29,4,3,83
Kansas,Hoisington,2589,208,471,573,199,101,1552
Kansas,Victoria,975,32,235,233,131,50,681
Kansas,Augusta,9358,470,1576,2411,794,495,5746
Kansas,Park City,7885,445,1251,1856,842,526,4920
Kansas,Cassoday,136,4,35,47,13,2,101
Kansas,Lorraine,182,4,39,47,8,18,116
Kansas,Rozel,119,4,35,40,4,4,87
Kansas,Satanta,1083,190,106,242,75,36,649
Kansas,Edna,367,15,92,95,43,19,264
Kansas,Manchester,140,11,56,17,4,9,97
Kansas,Cherokee,873,20,184,190,65,50,509
Kansas,Pittsburg,20280,1160,2754,3311,2000,1284,10509
Kansas,Mound Valley,351,39,87,107,12,9,254
Kansas,Kanorado,220,77,53,31,7,1,169
Kansas,Potwin,553,40,110,106,25,6,287
Kansas,Holyrood,500,16,121,143,48,15,343
Kansas,Isabel,104,5,48,19,2,0,74
Kansas,Johnson City,1229,180,310,260,86,14,850
Kansas,Belvue,384,14,41,88,9,0,152
Kansas,St. Marys,2653,63,430,578,211,100,1382
Kansas,Easton,288,42,82,64,16,10,214
Kansas,Smith Center,1527,92,397,438,164,77,1168
Kansas,Belleville,1852,82,536,513,163,120,1414
Kansas,Courtland,315,25,64,76,43,17,225
Kansas,Narka,124,5,33,17,13,0,68
Kansas,Grandview Plaza,1438,100,245,269,67,20,701
Kansas,Turon,365,34,54,123,12,1,224
Kansas,Lindsborg,3309,116,415,658,518,247,1954
Kansas,Colony,511,17,104,133,28,14,296
Kansas,Virgil,37,9,11,4,5,0,29
Kansas,Lone Elm,14,3,6,3,1,1,14
Kansas,Englewood,77,0,26,13,0,0,39
Kansas,West Mineral,126,14,32,25,4,6,81
Kansas,Haven,1195,36,232,347,78,31,724
Kansas,Willowbrook,88,5,2,14,31,17,69
Kansas,Smolan,178,8,45,52,14,10,129
Kansas,Solomon,1171,59,243,251,80,39,672
Kansas,Galva,1066,95,259,272,98,37,761
Kansas,McPherson,13041,463,2106,3195,1884,797,8445
Kansas,Frontenac,3424,87,633,750,571,306,2347
Kansas,Colwich,1159,12,197,227,209,67,712
Kansas,Kechi,2643,58,415,578,405,254,1710
Kansas,Protection,379,45,89,94,39,4,271
Kansas,Attica,749,29,198,145,46,15,433
Kansas,Climax,40,4,12,9,2,0,27
Kansas,Glasco,514,21,147,142,56,7,373
Kansas,Hollenberg,22,7,8,7,0,0,22
Kansas,Dearing,603,69,129,123,34,19,374
Kansas,Tyro,195,14,51,38,11,2,116
Kansas,Byers,30,0,9,14,0,0,23
Kansas,Columbus,3113,310,709,744,286,129,2178
Kansas,Scammon,591,68,119,127,49,15,378
Kansas,Mapleton,90,18,11,12,3,1,45
Kansas,Humboldt,1793,111,366,561,95,92,1225
Kansas,Edmond,121,0,57,10,7,0,74
Kansas,Damar,161,16,29,40,11,3,99
Kansas,Jetmore,857,74,116,241,112,52,595
Kansas,Mound City,1019,23,276,254,125,41,719
Kansas,Manter,308,9,64,75,37,0,185
Kansas,Oakley,1965,97,452,604,180,51,1384
Kansas,Hill City,1559,79,437,362,211,61,1150
Kansas,Morland,131,7,26,32,30,14,109
Kansas,Erie,1210,58,287,343,45,61,794
Kansas,Alden,114,9,18,37,7,4,75
Kansas,Herington,2163,196,531,615,158,104,1604
Kansas,Leawood,34570,71,1470,4214,9829,8526,24110
Kansas,Roeland Park,6796,127,795,1373,1784,952,5031
Kansas,Dwight,197,31,69,36,5,13,154
Kansas,Atwood,1104,44,286,317,97,61,805
Kansas,Andale,901,30,120,176,113,53,492
Kansas,Muscotah,176,5,51,43,6,2,107
Kansas,Oaklawn-Sunview,3144,485,1041,340,89,21,1976
Kansas,Garnett,3251,149,980,702,261,215,2307
Kansas,Kincaid,111,8,23,32,5,0,68
Kansas,Westphalia,161,15,59,21,10,2,107
Kansas,St. John,1269,61,232,360,155,66,874
Kansas,Geneseo,234,17,74,54,13,6,164
Kansas,Parker,484,31,76,106,35,1,249
Kansas,Bazine,339,38,96,88,21,1,244
Kansas,Wilson,730,28,170,193,69,35,495
Kansas,New Strawn,437,7,80,117,91,17,312
Kansas,Towanda,1292,35,205,392,85,41,758
Kansas,Whitewater,789,42,139,172,68,59,480
Kansas,Phillipsburg,2655,183,625,647,200,90,1745
Kansas,Alma,953,55,216,283,63,68,685
Kansas,Paola,5585,171,1300,1353,431,387,3642
Kansas,Kiowa,937,62,245,231,70,62,670
Kansas,Sharon,166,12,68,41,6,2,129
Kansas,Burlington,2587,137,620,670,213,94,1734
Kansas,Hanston,304,24,43,65,36,8,176
Kansas,Beverly,133,6,39,42,1,2,90
Kansas,Leonardville,486,24,155,124,45,25,373
Kansas,Troy,937,64,216,234,69,16,599
Kansas,Viola,92,4,26,22,10,4,66
Kansas,Langdon,36,6,14,2,7,2,31
Kansas,Mankato,870,44,227,223,77,33,604
Kansas,Esbon,126,5,27,59,8,4,103
Kansas,Valley Center,6747,322,987,1479,1314,535,4637
Kansas,Elkhart,1689,160,373,427,165,40,1165
Kansas,Independence,8847,598,1711,2342,677,455,5783
Kansas,Wichita,389563,30483,66040,79636,48086,27336,251581
Kansas,Princeton,242,20,46,69,18,10,163
Kansas,Pomona,1158,80,417,221,38,27,783
Kansas,Hutchinson,41146,3670,7744,10835,3717,2070,28036
Kansas,Buhler,1188,35,182,382,176,59,834
Kansas,Greensburg,910,70,166,226,106,43,611
Kansas,Weir,624,73,154,119,39,24,409
Kansas,Moline,381,27,88,118,23,12,268
Kansas,Coldwater,892,40,206,258,49,25,578
Kansas,Haysville,11298,572,2457,2637,818,359,6843
Kansas,Sedgwick,1432,64,242,413,120,87,926
Kentucky,Bremen,226,38,86,26,4,5,159
Kentucky,St. Regis Park,1336,11,191,287,293,254,1036
Kentucky,Pioneer Village,2872,255,1004,649,243,80,2231
Kentucky,Augusta,1119,100,341,172,81,56,750
Kentucky,Falmouth,2915,520,951,287,62,85,1905
Kentucky,Fort Knox,8965,168,590,2318,753,791,4620
Kentucky,Gamaliel,303,36,105,51,11,10,213
Kentucky,Goshen,960,27,87,189,203,104,610
Kentucky,Buckhorn,115,10,26,10,5,7,58
Kentucky,Pikeville,6967,711,1134,1140,590,768,4343
Kentucky,Newport,15152,2122,3492,2339,1790,983,10726
Kentucky,Worthington Hills,1494,86,224,315,264,128,1017
Kentucky,Woodland Hills,723,10,98,146,142,105,501
Kentucky,Phelps,750,266,127,169,0,49,611
Kentucky,Kuttawa,678,40,209,122,66,58,495
Kentucky,Brandenburg,2850,294,696,456,227,166,1839
Kentucky,Clay,1030,134,333,234,32,13,746
Kentucky,Wheatcroft,130,38,60,9,0,0,107
Kentucky,Hyden,443,107,82,77,46,60,372
Kentucky,Windy Hills,2297,25,196,387,712,524,1844
Kentucky,Calvert City,2509,199,593,627,177,77,1673
Kentucky,Tompkinsville,2731,571,668,474,83,106,1902
Kentucky,Lebanon,5621,1055,1402,1022,327,270,4076
Kentucky,Raywick,139,24,55,23,3,1,106
Kentucky,Coal Run Village,1534,178,348,372,160,75,1133
Kentucky,La Grange,8735,592,1735,1811,917,482,5537
Kentucky,River Bluff,471,2,40,118,121,48,329
Kentucky,Lakeview Heights,304,8,31,49,34,97,219
Kentucky,Ravenna,673,85,192,114,54,19,464
Kentucky,Crestview Hills,3281,90,557,705,506,427,2285
Kentucky,Erlanger,18776,1262,4250,3787,1883,1448,12630
Kentucky,Ekron,333,31,109,62,9,0,211
Kentucky,Princeton,6157,374,2084,851,337,449,4095
Kentucky,Claryville,2581,130,536,491,352,152,1661
Kentucky,Mentor,312,10,103,50,41,9,213
Kentucky,Clinton,1368,238,353,195,64,61,911
Kentucky,Edgewood,8723,172,1034,1763,1890,1348,6207
Kentucky,Fort Mitchell,8237,326,1202,1390,1342,955,5215
Kentucky,Irvington,1268,209,418,227,30,19,903
Kentucky,Perryville,1009,103,343,140,65,22,673
Kentucky,Clay City,1059,235,284,173,28,14,734
Kentucky,Brodhead,1527,304,391,246,66,12,1019
Kentucky,Alexandria,9211,400,2001,1734,1345,646,6126
Kentucky,Jeffersonville,1912,239,607,359,85,20,1310
Kentucky,Owenton,1616,249,572,202,41,25,1089
Kentucky,Beattyville,1375,261,336,224,92,35,948
Kentucky,Warfield,350,40,75,58,6,3,182
Kentucky,Berea,15188,1260,2515,2532,1590,981,8878
Kentucky,Eddyville,2565,312,720,661,166,83,1942
Kentucky,Science Hill,553,85,152,125,31,26,419
Kentucky,Gratz,90,15,25,4,0,1,45
Kentucky,McRoberts,893,184,289,113,19,16,621
Kentucky,Woodlawn Park,864,21,142,164,221,141,689
Kentucky,Westwood,670,8,54,90,180,96,428
Kentucky,Seneca Gardens,662,2,7,62,201,217,489
Kentucky,Fleming-Neon,599,171,104,109,40,48,472
Kentucky,Rolling Hills,909,41,162,240,145,57,645
Kentucky,Bellevue,5828,235,1257,1148,1143,518,4301
Kentucky,Hunters Hollow,269,19,90,76,3,5,193
Kentucky,Hillview,8987,706,3146,1682,346,110,5990
Kentucky,Salyersville,1772,449,367,338,66,64,1284
Kentucky,Fredonia,628,44,184,97,22,12,359
Kentucky,Sardis,93,18,35,19,2,2,76
Kentucky,Indian Hills,2965,38,91,244,849,907,2129
Kentucky,Mockingbird Valley,155,2,4,14,49,50,119
Kentucky,Old Brownsboro Place,394,1,28,51,114,100,294
Kentucky,Highland Heights,7136,335,1124,1136,653,358,3606
Kentucky,Annville,1110,270,245,218,14,69,816
Kentucky,Manor Creek,322,0,18,45,65,82,210
Kentucky,Lexington-Fayette urban,318734,18841,41328,57520,50134,38438,206261
Kentucky,Bancroft,469,4,48,87,85,115,339
Kentucky,South Wallins,583,114,200,56,8,46,424
Kentucky,Hodgenville,3213,498,709,645,66,143,2061
Kentucky,Upton,699,97,218,121,25,16,477
Kentucky,Bellemeade,814,2,105,204,188,160,659
Kentucky,Bellewood,302,2,20,36,96,74,228
Kentucky,Crossgate,241,2,7,37,77,50,173
Kentucky,Audubon Park,1352,25,204,277,256,268,1030
Kentucky,Goose Creek,267,0,41,75,68,38,222
Kentucky,Fincastle,868,35,152,241,119,60,607
Kentucky,Hurstbourne Acres,1891,81,164,324,518,424,1511
Kentucky,Parkway Village,644,26,146,119,135,72,498
Kentucky,St. Matthews,18147,707,2239,3851,4165,3016,13978
Kentucky,Strathmoor Manor,367,4,8,52,96,98,258
Kentucky,Watterson Park,1082,109,303,188,99,66,765
Kentucky,Wellington,438,4,34,62,124,113,337
Kentucky,Norbourne Estates,430,2,29,38,118,130,317
Kentucky,Benham,527,76,99,142,27,34,378
Kentucky,Wingo,728,54,189,107,59,12,421
Kentucky,Wheelwright,645,124,151,205,5,10,495
Kentucky,Booneville,143,1,28,26,20,26,101
Kentucky,Pewee Valley,1568,41,217,320,284,244,1106
Kentucky,Greenville,4323,536,1252,742,332,240,3102
Kentucky,Central City,5822,745,1867,977,153,250,3992
Kentucky,West Liberty,3369,641,1063,625,175,222,2726
Kentucky,Benton,4460,270,1075,1036,267,504,3152
Kentucky,Vanceburg,1400,375,364,191,24,33,987
Kentucky,St. Charles,334,64,94,45,5,0,208
Kentucky,Nebo,184,8,52,35,15,2,112
Kentucky,Madisonville,19138,1571,4871,3751,1536,1052,12781
Kentucky,Nicholasville,29977,3322,6855,5481,2706,1356,19720
Kentucky,Sonora,709,42,146,144,20,34,386
Kentucky,Westwood,4509,267,1223,1259,494,200,3443
Kentucky,Jeffersontown,28178,1245,4964,6143,4321,3296,19969
Kentucky,Milton,693,96,182,141,30,40,489
Kentucky,Greensburg,2214,411,650,357,126,67,1611
Kentucky,Plum Springs,464,62,105,100,44,15,326
Kentucky,East Bernstadt,876,147,204,142,70,33,596
Kentucky,Blackey,150,35,37,10,20,1,103
Kentucky,Oakland,240,25,78,51,25,12,191
Kentucky,Sanders,233,63,90,19,6,0,178
Kentucky,North Middletown,747,113,235,100,26,8,482
Kentucky,Ashland,20822,1579,4396,5094,1916,1481,14466
Kentucky,Owensboro,59188,4542,13316,12698,5495,3406,39457
Kentucky,Warsaw,1861,324,580,251,101,28,1284
Kentucky,South Shore,982,172,252,168,47,12,651
Kentucky,Anchorage,2281,3,58,175,568,601,1405
Kentucky,Vine Grove,5969,271,1248,1522,580,283,3904
Kentucky,Harlan,1452,256,374,268,118,73,1089
Kentucky,Forest Hills,437,7,58,112,81,44,302
Kentucky,Belleview,308,64,22,52,27,20,185
Kentucky,Hickory Hill,117,1,27,27,22,18,95
Kentucky,Beechmont,755,107,216,99,6,0,428
Kentucky,Beech Grove,415,58,92,108,13,41,312
Kentucky,Bandana,355,0,75,133,27,51,286
Kentucky,Auxier,892,97,291,124,69,48,629
Kentucky,Artemus,531,86,126,82,7,20,321
Kentucky,Louisville/Jefferson County metro government (balance),617032,46702,120464,130001,72136,50161,419464
Kentucky,Middlesborough,9583,2177,2369,1453,337,290,6626
Kentucky,Heritage Creek,1069,122,337,279,59,11,808
Kentucky,Woodburn,365,41,112,71,21,10,255
Kentucky,Meadow Vale,733,12,112,159,188,98,569
Kentucky,Worthville,178,18,57,29,2,3,109
Kentucky,Liberty,1970,442,468,337,82,116,1445
Kentucky,Dry Ridge,2465,172,701,369,84,47,1373
Kentucky,Wurtland,1385,179,389,385,79,31,1063
Kentucky,Horse Cave,2376,460,547,389,89,70,1555
Kentucky,Eminence,2546,345,648,457,112,78,1640
Kentucky,Briarwood,514,16,61,143,104,48,372
Kentucky,Douglass Hills,5702,179,556,1368,1222,605,3930
Kentucky,Druid Hills,399,2,17,41,120,86,266
Kentucky,Glenview,455,0,17,56,114,162,349
Kentucky,Glenview Manor,266,0,22,41,73,39,175
Kentucky,Hills and Dales,182,1,9,28,63,37,138
Kentucky,Hollow Creek,765,19,194,183,124,53,573
Kentucky,Hollyvilla,477,45,157,94,16,0,312
Kentucky,Meadowview Estates,425,11,71,118,82,26,308
Kentucky,Kingsley,406,1,43,70,100,98,312
Kentucky,Trenton,445,34,93,144,40,27,338
Kentucky,Richlawn,387,7,26,66,124,88,311
Kentucky,Drakesboro,474,116,118,60,13,7,314
Kentucky,Greenup,1268,120,339,355,92,32,938
Kentucky,Guthrie,1340,213,394,273,20,20,920
Kentucky,Raceland,2661,219,751,586,229,133,1918
Kentucky,West Point,907,91,327,173,11,21,623
Kentucky,Munfordville,1688,302,522,295,62,49,1230
Kentucky,Lincolnshire,170,1,30,28,46,19,124
Kentucky,Providence,3050,454,841,473,102,99,1969
Kentucky,Crestwood,4914,243,518,736,958,536,2991
Kentucky,Wayland,313,68,70,61,19,9,227
Kentucky,Allen,191,24,52,23,13,0,112
Kentucky,Marion,2935,346,899,607,162,76,2090
Kentucky,Dycusburg,78,43,25,0,0,0,68
Kentucky,Ghent,362,40,106,74,6,8,234
Kentucky,Catlettsburg,1931,263,516,446,66,83,1374
Kentucky,Dixon,1069,167,305,223,45,30,770
Kentucky,Mount Olivet,499,65,56,59,54,19,253
Kentucky,Hazard,5170,616,894,1226,453,502,3691
Kentucky,Prestonsburg,3645,575,620,563,284,213,2255
Kentucky,Buckner,5465,550,1054,1272,527,493,3896
Kentucky,Flemingsburg,2837,454,723,511,204,114,2006
Kentucky,Burkesville,1733,322,519,313,72,32,1258
Kentucky,Elizabethtown,29474,1984,4868,6788,2926,2555,19121
Kentucky,Bellefonte,856,24,76,218,158,198,674
Kentucky,Worthington,1579,95,481,479,93,73,1221
Kentucky,Radcliff,22693,1456,4368,5766,1845,1117,14552
Kentucky,Cumberland,2039,441,421,337,91,66,1356
Kentucky,Campbellsburg,961,72,255,226,29,39,621
Kentucky,Creekside,295,5,39,58,73,44,219
Kentucky,New Castle,1094,196,317,174,62,42,791
Kentucky,Barbourmeade,1416,18,56,245,355,283,957
Kentucky,Brownsboro Farm,664,14,57,101,163,134,469
Kentucky,Sparta,332,51,85,52,3,7,198
Kentucky,Eubank,397,38,83,80,9,5,215
Kentucky,Millersburg,718,126,184,135,57,20,522
Kentucky,Paris,9874,1024,2348,2120,684,476,6652
Kentucky,Hazel,391,51,107,59,38,22,277
Kentucky,Whitesville,499,42,163,102,23,13,343
Kentucky,Camargo,1399,195,387,236,75,7,900
Kentucky,Fountain Run,193,41,53,26,4,9,133
Kentucky,Williamstown,3924,445,1102,618,108,185,2458
Kentucky,Poplar Hills,415,60,91,61,8,27,247
Kentucky,Norwood,450,3,53,60,116,88,320
Kentucky,Northfield,1142,23,66,204,346,186,825
Kentucky,Murray Hill,596,7,83,109,173,122,494
Kentucky,Meadowbrook Farm,140,7,18,24,30,15,94
Kentucky,Maryhill Estates,212,0,10,13,49,56,128
Kentucky,Hurstbourne,4383,102,377,607,1183,1081,3350
Kentucky,Graymoor-Devondale,2959,84,355,598,786,398,2221
Kentucky,Moorland,460,13,144,120,65,27,369
Kentucky,Middletown,7865,176,875,2090,1571,1023,5735
Kentucky,Houston Acres,469,11,60,125,99,55,350
Kentucky,Coldstream,1394,25,198,310,202,125,860
Kentucky,Brownsboro Village,359,2,17,77,116,105,317
Kentucky,Broeck Pointe,326,9,26,46,67,67,215
Kentucky,Beechwood Village,1338,35,121,254,329,223,962
Kentucky,Riverwood,483,4,7,48,131,150,340
Kentucky,London,8020,1037,2464,1541,479,294,5815
Kentucky,Rolling Fields,714,0,6,52,225,177,460
Kentucky,Ten Broeck,129,6,12,36,23,28,105
Kentucky,Inez,870,185,205,145,53,47,635
Kentucky,Bradfordsville,248,37,106,28,8,2,181
Kentucky,North Corbin,2211,436,630,332,99,27,1524
Kentucky,West Buechel,1501,168,321,279,161,78,1007
Kentucky,Spring Valley,778,3,41,130,185,155,514
Kentucky,Plantation,896,19,107,194,140,114,574
Kentucky,Lyndon,11427,673,1324,2776,2308,1220,8301
Kentucky,Blaine,55,33,19,3,0,0,55
Kentucky,Mount Sterling,7180,545,1920,1278,629,355,4727
Kentucky,Germantown,72,12,21,17,4,0,54
Kentucky,Dover,283,38,103,46,8,6,201
Kentucky,Loretto,670,65,228,109,20,6,428
Kentucky,Concord,9,1,7,1,0,0,9
Kentucky,Whitesburg,2335,256,450,505,284,190,1685
Kentucky,Jenkins,2358,368,508,390,60,81,1407
Kentucky,Thornhill,273,0,6,29,52,68,155
Kentucky,Muldraugh,1066,140,330,192,28,39,729
Kentucky,Mount Vernon,2702,471,582,463,206,105,1827
Kentucky,Fairview,144,11,72,23,15,4,125
Kentucky,Hardinsburg,2357,229,728,506,83,120,1666
Kentucky,Beaver Dam,3560,363,883,692,84,301,2323
Kentucky,Hartford,2722,310,681,562,217,126,1896
Kentucky,Russell Springs,2550,568,631,281,118,68,1666
Kentucky,Waverly,375,19,87,120,9,8,243
Kentucky,Barlow,571,72,181,110,20,17,400
Kentucky,La Center,894,118,290,184,46,20,658
Kentucky,Harrodsburg,8403,1211,2242,1410,580,333,5776
Kentucky,Bloomfield,860,165,256,133,31,15,600
Kentucky,Glasgow,14370,1976,4072,2443,1157,578,10226
Kentucky,Ledbetter,1770,56,488,449,133,47,1173
Kentucky,Hustonville,530,48,168,100,17,19,352
Kentucky,Maysville,8797,901,2117,1992,535,580,6125
Kentucky,Richmond,34566,2164,4565,5698,3565,2410,18402
Kentucky,Ferguson,936,110,220,235,70,48,683
Kentucky,Orchard Grass Hills,1862,50,242,351,245,198,1086
Kentucky,Louisa,2947,511,795,440,108,144,1998
Kentucky,Carlisle,2323,274,708,348,51,72,1453
Kentucky,Sturgis,1771,185,499,441,56,34,1215
Kentucky,Leitchfield,6784,919,2141,1124,285,196,4665
Kentucky,Hindman,568,74,108,80,66,40,368
Kentucky,Brooksville,666,101,137,103,27,58,426
Kentucky,Lebanon Junction,2046,233,763,361,108,30,1495
Kentucky,Cold Spring,6319,206,1358,1119,1290,774,4747
Kentucky,Hickman,2318,424,687,430,77,56,1674
Kentucky,Earlington,1458,182,410,294,75,38,999
Kentucky,Whitley City,1694,361,481,249,132,0,1223
Kentucky,Manchester,1440,319,363,259,75,97,1113
Kentucky,Irvine,2230,379,615,424,166,39,1623
Kentucky,Crofton,508,85,178,85,13,10,371
Kentucky,Winchester,18413,2132,4373,3797,1602,589,12493
Kentucky,Lancaster,3832,691,907,578,119,132,2427
Kentucky,Cynthiana,6348,884,1801,1251,274,225,4435
Kentucky,Robards,514,22,153,139,18,26,358
Kentucky,Rockport,225,40,74,35,5,6,160
Kentucky,Columbia,4722,627,956,768,207,234,2792
Kentucky,South Carrollton,217,60,80,16,1,1,158
Kentucky,Powderly,917,134,311,193,26,31,695
Kentucky,Mayfield,9940,1336,2313,1762,642,439,6492
Kentucky,Carrollton,3849,586,985,832,175,33,2611
Kentucky,Prestonville,99,27,16,20,0,0,63
Kentucky,Martin,517,89,97,96,13,22,317
Kentucky,Fort Campbell North,13882,163,967,2287,701,184,4302
Kentucky,LaFayette,180,22,47,42,6,5,122
Kentucky,Scottsville,4412,704,1185,981,181,81,3132
Kentucky,Kevil,624,74,128,210,19,28,459
Kentucky,Burgin,1087,104,298,228,52,22,704
Kentucky,Bardstown,13042,993,2813,2854,809,648,8117
Kentucky,Burlington,17069,771,3730,3365,2127,949,10942
Kentucky,Florence,31940,1978,6667,7924,3512,1944,22025
Kentucky,Sadieville,357,30,68,85,38,13,234
Kentucky,Shelbyville,15660,1919,3005,3266,1159,1007,10356
Kentucky,Caneyville,647,96,198,116,25,13,448
Kentucky,Clarkson,995,128,263,187,51,5,634
Kentucky,Pineville,1808,392,470,305,85,74,1326
Kentucky,Ewing,252,37,70,46,12,4,169
Kentucky,Woodlawn,205,16,46,34,32,16,144
Kentucky,Wilder,3083,145,672,549,587,322,2275
Kentucky,Pine Knot,1350,267,357,233,25,54,936
Kentucky,Lawrenceburg,11272,782,2776,2498,823,434,7313
Kentucky,Stanford,3673,496,1102,702,239,172,2711
Kentucky,Slaughters,261,37,87,56,2,4,186
Kentucky,Butler,706,113,216,162,22,6,519
Kentucky,Elkton,2291,291,541,472,57,82,1443
Kentucky,Sebree,1362,223,345,181,48,35,832
Kentucky,Hopkinsville,31483,3212,6460,7079,1851,1897,20499
Kentucky,Owingsville,2052,258,475,299,110,104,1246
Kentucky,Pippa Passes,631,2,0,11,21,52,86
Kentucky,Brooks,2575,320,842,685,112,0,1959
Kentucky,Fox Chase,528,33,156,137,57,37,420
Kentucky,Hebron Estates,1080,114,403,291,71,15,894
Kentucky,California,133,10,41,25,4,3,83
Kentucky,Southgate,3859,143,748,1073,501,200,2665
Kentucky,Bardwell,743,81,162,181,45,24,493
Kentucky,Wilmore,6299,182,551,728,989,757,3207
Kentucky,Vicco,319,83,78,34,20,3,218
Kentucky,Oneida,339,0,76,42,67,16,201
Kentucky,Garrison,550,47,212,88,39,22,408
Kentucky,Corydon,838,82,272,115,31,21,521
Kentucky,Adairville,947,160,281,105,34,12,592
Kentucky,Morehead,7674,422,594,1054,372,697,3139
Kentucky,Auburn,1293,177,317,259,78,50,881
Kentucky,Lewisburg,783,86,250,137,45,21,539
Kentucky,Russellville,7008,892,2001,1356,425,266,4940
Kentucky,Park City,635,52,182,135,36,11,416
Kentucky,Junction City,2080,255,735,435,79,11,1515
Kentucky,Hendron,4821,259,831,1267,574,349,3280
Kentucky,Reidland,4467,158,1057,1266,445,258,3184
Kentucky,Oakbrook,9301,374,1542,2424,1369,800,6509
Kentucky,Salem,674,97,213,161,28,20,519
Kentucky,Livermore,1304,143,395,280,45,7,870
Kentucky,Covington,40552,4442,8998,8178,4390,2277,28285
Kentucky,Crescent Springs,4035,181,559,662,615,476,2493
Kentucky,Villa Hills,7410,155,988,1667,1491,1103,5404
Kentucky,Nortonville,879,157,246,164,23,42,632
Kentucky,Stearns,1052,118,311,180,32,37,678
Kentucky,Stamping Ground,847,85,213,180,36,23,537
Kentucky,Franklin,8762,1062,2633,1370,550,205,5820
Kentucky,Corinth,233,54,70,25,1,3,153
Kentucky,Campbellsville,11413,1087,2549,1534,1058,665,6893
Kentucky,Island,515,38,157,107,11,9,322
Kentucky,Paducah,24879,2232,5551,5354,2922,1645,17704
Kentucky,Pleasureville,1016,128,308,153,37,2,628
Kentucky,Albany,2293,464,564,495,106,74,1703
Kentucky,Rochester,287,25,85,45,10,11,176
Kentucky,Blandville,103,29,39,8,0,9,85
Kentucky,Independence,27183,1784,5204,5451,3561,1446,17446
Kentucky,Kenton Vale,123,24,23,38,5,11,101
Kentucky,McHenry,417,77,96,48,16,7,244
Kentucky,Morganfield,3463,268,1243,683,141,110,2445
Kentucky,Corbin,7194,685,1654,1657,419,412,4827
Kentucky,Lakeside Park,2749,40,352,696,590,373,2051
Kentucky,Ludlow,4515,398,1103,965,359,236,3061
Kentucky,Ryland Heights,1106,131,267,276,46,23,743
Kentucky,Hanson,733,164,134,121,61,38,518
Kentucky,Cloverport,908,110,324,179,21,22,656
Kentucky,Woodbury,42,1,17,8,5,5,36
Kentucky,Sandy Hook,714,155,160,117,39,17,488
Kentucky,Henderson,28800,3064,7095,6490,2051,1429,20129
Kentucky,Simpsonville,2786,152,409,501,413,216,1691
Kentucky,Campton,544,95,159,98,13,25,390
Kentucky,Shepherdsville,12117,1086,2917,2469,809,345,7626
Kentucky,Fort Thomas,16313,577,1871,3065,3531,2163,11207
Kentucky,Brownsville,832,135,213,189,39,34,610
Kentucky,Fulton,2522,331,618,430,137,57,1573
Kentucky,Dawson Springs,2690,322,882,488,128,35,1855
Kentucky,Arlington,376,103,91,78,13,2,287
Kentucky,Mackville,252,11,59,27,32,14,143
Kentucky,Springfield,2982,305,733,519,148,183,1888
Kentucky,Willisburg,380,44,111,72,21,11,259
Kentucky,Williamsburg,5269,436,678,468,482,377,2441
Kentucky,Morgantown,2627,578,709,355,104,75,1821
Kentucky,Bromley,944,113,218,217,48,11,607
Kentucky,Frenchburg,776,82,222,110,31,41,486
Kentucky,Carrsville,36,5,16,9,2,0,32
Kentucky,Massac,4888,106,564,1383,515,478,3046
Kentucky,Georgetown,32902,1939,6347,6637,3451,2156,20530
Kentucky,Fancy Farm,601,33,139,107,55,35,369
Kentucky,Fairview,294,40,29,39,0,0,108
Kentucky,Ezel,153,37,31,47,0,0,115
Kentucky,Emlyn,448,15,185,48,41,67,356
Kentucky,Elizaville,151,22,49,22,38,0,131
Kentucky,Dwale,142,0,22,82,0,15,119
Kentucky,Doe Valley,1877,100,265,535,266,215,1381
Kentucky,Dexter,319,22,114,78,25,10,249
Kentucky,Crayne,174,0,75,52,0,0,127
Kentucky,Coldiron,202,36,62,14,4,3,119
Kentucky,Diablock,318,89,69,62,0,41,261
Kentucky,Chaplin,314,39,159,27,9,7,241
Kentucky,Farley,4398,538,1288,931,139,78,2974
Kentucky,Cerulean,283,7,63,128,0,33,231
Kentucky,Cayce,69,0,5,19,17,0,41
Kentucky,Cawood,497,165,109,42,0,0,316
Kentucky,Cannonsburg,719,18,65,99,37,70,289
Kentucky,Burna,229,11,96,15,11,0,133
Kentucky,Buffalo,379,31,126,76,0,6,239
Kentucky,Boston,113,22,32,51,0,0,105
Kentucky,Smithland,270,57,63,66,15,10,211
Kentucky,Crab Orchard,960,152,316,121,17,14,620
Kentucky,Calhoun,883,115,219,215,41,21,611
Kentucky,Sacramento,476,58,152,76,10,10,306
Kentucky,Smiths Grove,764,85,236,119,63,36,539
Kentucky,Betsy Layne,727,44,161,163,45,29,442
Kentucky,Cecilia,667,90,134,90,28,14,356
Kentucky,Fort Wright,5724,74,799,1220,1229,841,4163
Kentucky,Farmers,38,0,0,38,0,0,38
Kentucky,Flat Lick,1316,335,319,170,22,0,846
Kentucky,Midway,1749,80,254,282,289,200,1105
Kentucky,Onton,39,0,26,6,7,0,39
Kentucky,Edmonton,1676,346,536,322,88,38,1330
Kentucky,New Hope,144,48,62,12,0,0,122
Kentucky,Millstone,49,0,31,18,0,0,49
Kentucky,Mays Lick,291,18,92,95,0,8,213
Kentucky,Mayking,365,10,109,83,34,0,236
Kentucky,Marrowbone,126,8,69,17,0,0,94
Kentucky,Manitou,341,0,72,53,28,0,153
Kentucky,Magnolia,590,57,131,113,0,37,338
Kentucky,Maceo,330,9,167,68,0,0,244
Kentucky,McCarr,93,23,30,30,0,0,83
Kentucky,Farmington,161,21,0,62,18,9,110
Kentucky,Lowes,26,0,26,0,0,0,26
Kentucky,Kenvir,375,68,15,135,0,18,236
Kentucky,Jeff,193,28,102,7,21,0,158
Kentucky,Hiseville,195,32,121,8,0,0,161
Kentucky,High Bridge,306,116,87,76,0,0,279
Kentucky,Hebron,6160,112,1118,1572,664,315,3781
Kentucky,Hazel Green,84,24,43,8,0,9,84
Kentucky,Hardyville,407,41,69,33,0,66,209
Kentucky,Gracey,76,0,29,14,0,0,43
Kentucky,Gilbertsville,539,145,163,96,0,42,446
Kentucky,Union,5815,112,697,1101,1073,708,3691
Kentucky,Freeburn,281,47,137,27,0,0,211
Kentucky,Francisville,9401,52,1050,1706,1852,1208,5868
Kentucky,Lovelaceville,17,0,17,0,0,0,17
Kentucky,Elsmere,8570,817,1636,2120,652,282,5507
Kentucky,White Plains,812,102,300,127,67,19,615
Kentucky,Taylor Mill,6746,299,1131,1625,859,510,4424
Kentucky,Silver Grove,1450,124,374,278,83,88,947
Kentucky,Green Spring,738,4,41,130,193,155,523
Kentucky,Grayson,4015,330,996,658,276,152,2412
Kentucky,Olive Hill,1715,269,368,369,97,87,1190
Kentucky,Glenview Hills,367,0,15,37,111,89,252
Kentucky,Langdon Place,901,28,83,190,206,145,652
Kentucky,Somerset,11376,1698,2760,2292,691,409,7850
Kentucky,Lynnview,1043,72,310,236,98,22,738
Kentucky,Shively,15741,1576,4414,3726,861,494,11071
Kentucky,Wildwood,264,1,33,45,69,45,193
Kentucky,Monterey,133,11,39,52,16,2,120
Kentucky,Burnside,1087,124,251,164,110,92,741
Kentucky,Jamestown,2052,345,531,425,94,41,1436
Kentucky,Wickliffe,813,150,217,171,27,22,587
Kentucky,Hawesville,990,117,232,214,37,35,635
Kentucky,Fordsville,617,85,167,158,3,7,420
Kentucky,Masonville,1231,26,302,270,75,63,736
Kentucky,Jackson,2022,348,461,425,157,126,1517
Kentucky,Versailles,9192,1022,1766,1773,1006,519,6086
Kentucky,Monticello,6088,1143,1317,983,410,287,4140
Kentucky,Glencoe,347,58,91,43,4,1,197
Kentucky,Bowling Green,65731,5116,8995,10572,6446,4477,35606
Kentucky,Cambridge,165,6,16,46,29,22,119
Kentucky,Blue Ridge Manor,827,18,104,165,237,119,643
Kentucky,McKee,1060,262,260,89,13,12,636
Kentucky,Melbourne,441,56,108,81,21,64,330
Kentucky,Lynch,613,62,177,178,46,15,478
Kentucky,Dayton,5422,618,1446,1075,437,293,3869
Kentucky,Barbourville,3119,466,551,393,197,307,1914
Kentucky,Elkhorn City,1064,259,295,110,41,59,764
Kentucky,Stanton,2646,441,808,356,105,143,1853
Kentucky,Livingston,126,20,47,14,1,0,82
Kentucky,Oak Grove,7411,329,1001,1697,495,120,3642
Kentucky,Paintsville,4134,528,1045,933,242,279,3027
Kentucky,Cadiz,2608,274,642,668,134,119,1837
Kentucky,Crestview,461,19,90,89,69,29,296
Kentucky,Park Hills,2983,171,384,656,499,308,2018
Kentucky,Berry,352,36,117,54,15,14,236
Kentucky,Breckinridge Center,2363,60,305,168,0,0,533
Kentucky,Hardin,544,58,151,64,19,7,299
Kentucky,Murray,19037,1169,2677,2720,1839,1564,9969
Kentucky,Mortons Gap,1241,188,421,206,73,5,893
Kentucky,Prospect,4876,34,263,619,1308,1470,3694
Kentucky,Taylorsville,1547,262,426,341,37,27,1093
Kentucky,Columbus,256,42,71,39,1,1,154
Kentucky,Uniontown,754,129,279,166,0,9,583
Kentucky,Walton,4281,139,872,1085,286,247,2629
Kentucky,Frankfort,27582,2313,5434,5640,3888,2072,19347
Kentucky,Lewisport,1877,174,547,350,88,74,1233
Kentucky,Smithfield,132,25,45,14,2,1,87
Kentucky,Bedford,698,88,191,104,35,2,420
Kentucky,Bonnieville,236,43,70,16,12,4,145
Kentucky,Mount Washington,14433,843,3216,3398,1256,674,9387
Kentucky,Salt Lick,411,59,76,54,47,17,253
Kentucky,Danville,16685,1370,3373,3265,1138,1375,10521
Kentucky,Loyall,657,112,155,124,26,42,459
Kentucky,Crittenden,3861,279,1085,736,265,81,2446
Kentucky,Russell,3311,87,580,838,512,308,2325
Kentucky,Tolu,60,4,20,4,0,0,28
Kentucky,Symsonia,549,18,95,178,0,35,326
Kentucky,Summersville,583,33,175,116,28,21,373
Kentucky,Verona,1502,122,507,232,100,74,1035
Kentucky,Summer Shade,207,16,85,57,0,10,168
Kentucky,Spottsville,406,18,60,58,167,15,318
Kentucky,South Williamson,533,90,245,23,25,72,455
Kentucky,Sedalia,444,57,140,102,11,7,317
Kentucky,Salvisa,286,22,38,85,10,5,160
Kentucky,Rosine,136,53,46,16,0,0,115
Kentucky,Evarts,691,146,212,72,24,6,460
Kentucky,Rabbit Hash,426,0,76,116,44,23,259
Kentucky,Pryorsburg,308,28,97,21,11,0,157
Kentucky,Pleasant View,527,74,163,99,13,48,397
Kentucky,Plano,1015,18,137,183,223,126,687
Kentucky,Petersburg,551,147,145,33,50,10,385
Kentucky,Payne Gap,340,66,91,59,0,36,252
Kentucky,Pathfork,432,98,99,78,14,9,298
Kentucky,Pembroke,852,48,180,239,72,21,560
Kentucky,Fairfield,86,7,47,12,4,7,77
Kentucky,New Haven,609,71,176,147,15,20,429
Kentucky,Cave City,2772,299,760,437,39,61,1596
Kentucky,Grand Rivers,336,45,93,92,40,35,305
Kentucky,Sharpsburg,466,84,112,89,24,13,322
Kentucky,Centertown,471,41,145,91,17,5,299
Kentucky,Virgie,129,28,58,0,0,10,96
Kentucky,Westport,271,45,71,78,20,11,225
Kentucky,Rockholds,289,27,198,0,0,36,261
Kentucky,Water Valley,217,53,90,40,2,1,186
Kentucky,Flatwoods,7186,442,1923,2098,574,330,5367
Kentucky,Wallins Creek,411,47,110,129,2,0,288
Kentucky,Strathmoor Village,679,8,69,90,154,177,498
Kentucky,Spring Mill,269,3,44,63,57,26,193
Kentucky,South Park View,2,0,2,0,0,0,2
Kentucky,Utica,487,0,100,114,0,22,236
Kentucky,Rineyville,2793,98,546,570,312,268,1794
Kentucky,Poole,186,12,72,34,0,0,118
Kentucky,McKinney,135,0,48,72,0,0,120
Kentucky,McDowell,635,216,139,57,10,9,431
Kentucky,Ironville,918,24,240,213,43,29,549
Kentucky,Hickory,272,46,74,33,8,0,161
Kentucky,Sycamore,150,2,32,39,22,25,120
Kentucky,Coxton,154,8,93,24,0,11,136
Kentucky,Cunningham,292,11,95,60,35,18,219
Kentucky,Allensville,207,29,74,28,9,0,140
Kentucky,Elk Creek,1600,45,337,317,275,141,1115
Kentucky,Maytown,294,29,105,38,0,13,185
Kentucky,Ages,457,107,73,90,0,0,270
Kentucky,Anthoston,273,27,91,21,6,28,173
Kentucky,Dunmor,278,41,83,55,10,0,189
Kentucky,Belfry,313,59,95,56,0,44,254
Kentucky,Big Clifty,337,56,58,66,29,0,209
Kentucky,Cleaton,159,73,42,8,0,0,123
Kentucky,Combs,299,46,64,113,0,0,223
Kentucky,Arjay,502,136,131,11,0,0,278
Louisiana,Jordan Hill,87,0,45,5,0,0,50
Louisiana,Fifth Ward,738,125,212,122,28,4,491
Louisiana,Hester,361,0,120,62,23,29,234
Louisiana,Hayes,1106,102,368,0,56,135,661
Louisiana,Grand Point,2996,150,746,802,162,79,1939
Louisiana,Gloster,161,0,0,0,0,110,110
Louisiana,Glencoe,230,33,59,133,0,0,225
Louisiana,Gillis,403,87,82,64,0,51,284
Louisiana,Frierson,225,0,77,31,0,0,108
Louisiana,Fort Jesup,278,38,126,12,28,12,216
Louisiana,Jeanerette,5410,810,1626,724,145,160,3465
Louisiana,Dubach,1083,122,371,106,81,31,711
Louisiana,Varnado,460,75,137,52,25,18,307
Louisiana,New Iberia,29992,4510,7965,3913,2215,757,19360
Louisiana,Arnaudville,1330,176,394,120,41,21,752
Louisiana,Port Sulphur,2175,325,405,306,10,22,1068
Louisiana,Belle Chasse,13490,793,2931,2825,1578,668,8795
Louisiana,Heflin,224,2,61,49,17,5,134
Louisiana,Chalmette,23602,2563,5322,5081,1405,543,14914
Louisiana,Eunice,10407,1690,2667,1465,343,258,6423
Louisiana,Morse,938,171,282,126,23,8,610
Louisiana,Pioneer,202,10,52,52,30,1,145
Louisiana,Joyce,148,30,81,0,0,0,111
Louisiana,Dulac,1504,563,395,206,0,0,1164
Louisiana,Kraemer,826,207,323,79,0,9,618
Louisiana,Carencro,8775,1213,2133,1431,708,243,5728
Louisiana,Lafourche Crossing,2270,216,572,267,292,143,1490
Louisiana,Cotton Valley,1039,222,279,137,16,27,681
Louisiana,Lillie,218,8,55,58,36,5,162
Louisiana,Arabi,4501,410,1031,1181,428,105,3155
Louisiana,Leesville,6055,704,1365,1332,352,169,3922
Louisiana,Hornbeck,561,44,164,115,30,12,365
Louisiana,Fort Polk North,2425,25,273,378,175,44,895
Louisiana,Sibley,1333,186,347,266,131,24,954
Louisiana,East Hodge,266,37,101,42,11,15,206
Louisiana,Downsville,92,2,19,33,21,8,83
Louisiana,Violet,5424,710,1555,1114,182,58,3619
Louisiana,Rosepine,1971,201,478,410,193,30,1312
Louisiana,Doyline,777,48,242,153,33,14,490
Louisiana,Fort Polk South,9233,146,928,2018,472,263,3827
Louisiana,Abbeville,12286,1966,3122,1619,483,372,7562
Louisiana,Farmerville,3815,426,969,581,226,87,2289
Louisiana,Labadieville,2092,280,639,338,90,116,1463
Louisiana,Bossier City,67935,5009,12697,15198,6828,3819,43551
Louisiana,Haughton,3390,267,607,925,229,34,2062
Louisiana,Palmetto,133,24,32,20,10,1,87
Louisiana,Springhill,4980,748,1643,968,444,13,3816
Louisiana,Quitman,273,14,48,76,16,7,161
Louisiana,Reeves,244,34,60,51,4,6,155
Louisiana,Simpson,591,51,157,127,32,7,374
Louisiana,New Llano,2528,238,552,524,200,64,1578
Louisiana,Clayton,569,100,149,72,11,8,340
Louisiana,Norco,2917,153,903,683,212,71,2022
Louisiana,Albany,1194,43,359,218,109,73,802
Louisiana,Vinton,3343,543,790,687,243,38,2301
Louisiana,Sulphur,20241,1767,4643,4547,1739,615,13311
Louisiana,Hahnville,3430,366,903,682,322,118,2391
Louisiana,Tallulah,6929,976,1826,1109,396,257,4564
Louisiana,Richmond,568,95,122,120,67,31,435
Louisiana,Dry Prong,502,44,106,115,25,16,306
Louisiana,Port Vincent,612,61,188,188,71,2,510
Louisiana,French Settlement,1133,103,284,234,74,31,726
Louisiana,Delcambre,2267,328,587,283,140,35,1373
Louisiana,Oil City,1113,173,287,200,43,24,727
Louisiana,Lafayette,126515,10002,21984,21436,20933,10166,84521
Louisiana,Rodessa,214,35,52,53,7,1,148
Louisiana,Welsh,3234,385,852,597,207,68,2109
Louisiana,Barataria,979,174,360,118,73,17,742
Louisiana,Wilson,501,59,163,48,35,5,310
Louisiana,Estherwood,895,126,229,131,56,2,544
Louisiana,Kinder,2909,312,575,388,190,69,1534
Louisiana,Oberlin,1660,194,529,202,83,27,1035
Louisiana,Converse,389,51,107,62,19,7,246
Louisiana,Noble,258,32,83,41,19,2,177
Louisiana,Zwolle,1960,225,551,268,96,34,1174
Louisiana,Hodge,404,33,145,96,30,8,312
Louisiana,North Hodge,467,54,122,81,13,0,270
Louisiana,New Orleans,389648,38030,63015,72498,57944,43176,274663
Louisiana,Marion,999,125,268,140,77,25,635
Louisiana,Estelle,17099,2647,3999,2953,1667,516,11782
Louisiana,Bernice,1616,188,572,219,46,30,1055
Louisiana,Elton,1370,241,395,163,50,42,891
Louisiana,Shongaloo,142,18,37,23,16,5,99
Louisiana,Ruston,22055,1148,2255,2383,2220,1775,9781
Louisiana,Houma,33520,3705,8313,5739,3252,1226,22235
Louisiana,Cameron,209,58,57,27,8,9,159
Louisiana,Maringouin,932,100,258,181,74,45,658
Louisiana,Choudrant,1252,44,229,160,228,137,798
Louisiana,Vienna,503,33,56,104,99,51,343
Louisiana,Melville,1172,284,377,37,43,0,741
Louisiana,Opelousas,16399,2933,3970,2097,952,482,10434
Louisiana,Bayou Cane,20829,2632,4902,3824,1841,481,13680
Louisiana,Schriever,6407,727,1892,1048,347,353,4367
Louisiana,Eros,192,56,45,30,4,1,136
Louisiana,Jonesboro,4560,995,1319,549,156,51,3070
Louisiana,Poydras,2668,659,772,214,132,8,1785
Louisiana,Dubberly,239,27,78,51,13,18,187
Louisiana,Minden,12442,1304,3261,2103,906,570,8144
Louisiana,Bonita,241,46,73,20,7,11,157
Louisiana,Lacassine,366,43,62,23,36,0,164
Louisiana,Dixie Inn,257,8,86,60,13,2,169
Louisiana,Ringgold,1601,198,437,229,67,24,955
Louisiana,Prospect,445,0,136,68,46,23,273
Louisiana,Reddell,1041,70,208,133,0,35,446
Louisiana,Roanoke,349,36,103,120,38,18,315
Louisiana,Rock Hill,135,14,52,34,12,0,112
Louisiana,Romeville,195,40,14,19,8,0,81
Louisiana,St. James,788,108,236,149,78,6,577
Louisiana,Presquille,1595,172,481,204,251,14,1122
Louisiana,St. Maurice,392,50,97,91,44,0,282
Louisiana,Belcher,306,32,46,56,40,22,196
Louisiana,Duson,1780,346,445,245,34,7,1077
Louisiana,Bayou Corne,18,18,0,0,0,0,18
Louisiana,Welcome,932,119,115,195,62,43,534
Louisiana,Watson,1193,111,431,215,137,16,910
Louisiana,Wallace Ridge,867,49,191,213,91,39,583
Louisiana,Singer,363,0,117,39,46,0,202
Louisiana,Prairieville,31721,1821,5173,5917,5075,2212,20198
Louisiana,Point Place,498,22,72,183,41,13,331
Louisiana,Pointe a la Hache,217,34,78,23,7,0,142
Louisiana,Lakeshore,1918,73,500,476,196,107,1352
Louisiana,Lakeview,1467,77,265,382,87,85,896
Louisiana,Lawtell,1441,157,465,256,55,0,933
Louisiana,Lemannville,1078,280,289,139,62,6,776
Louisiana,Lockport Heights,1683,90,574,197,106,37,1004
Louisiana,Longville,639,39,142,17,0,0,198
Louisiana,Milton,2330,32,472,588,383,165,1640
Louisiana,Oretta,352,80,84,57,54,0,275
Louisiana,Minorca,1703,382,611,252,44,37,1326
Louisiana,Monterey,462,46,198,65,42,0,351
Louisiana,Moonshine,224,79,36,29,9,0,153
Louisiana,Ossun,1870,214,379,454,97,57,1201
Louisiana,Paulina,1085,32,285,147,144,55,663
Louisiana,Pitkin,803,113,216,72,38,77,516
Louisiana,Pleasure Bend,234,56,79,39,0,0,174
Louisiana,Vienna Bend,1228,84,188,404,33,44,753
Louisiana,Ventress,784,109,287,193,65,15,669
Louisiana,Union,611,93,217,110,24,5,449
Louisiana,Triumph,493,75,105,30,33,0,243
Louisiana,Jena,3390,500,911,541,368,71,2391
Louisiana,Roseland,1072,259,241,164,24,20,708
Louisiana,Elizabeth,489,55,115,57,50,11,288
Louisiana,Many,2757,291,858,359,244,75,1827
Louisiana,Fisher,292,46,76,64,8,9,203
Louisiana,Rayne,8075,1188,2054,1613,300,131,5286
Louisiana,Moss Bluff,12034,581,2876,3049,1231,417,8154
Louisiana,Haynesville,2599,264,784,441,140,67,1696
Louisiana,Ferriday,3326,517,714,386,361,201,2179
Louisiana,Westlake,4661,472,1410,721,288,123,3014
Louisiana,Norwood,276,20,69,51,43,19,202
Louisiana,Jackson,4952,1518,1539,640,197,63,3957
Louisiana,Marksville,5476,946,1308,912,302,188,3656
Louisiana,Chataignier,247,49,65,29,14,7,164
Louisiana,Saline,620,60,136,58,27,102,383
Louisiana,Thibodaux,14515,1883,2589,2059,1654,873,9058
Louisiana,Gonzales,10677,1054,2378,2564,710,638,7344
Louisiana,Montz,2219,208,332,426,318,66,1350
Louisiana,Atlanta,139,14,41,32,4,2,93
Louisiana,Sicily Island,452,80,150,35,9,11,285
Louisiana,Venice,245,38,50,23,23,20,154
Louisiana,Jonesville,1889,331,487,238,101,51,1208
Louisiana,Siracusaville,597,39,210,124,0,0,373
Louisiana,Sorrel,559,139,267,57,0,0,463
Louisiana,Spokane,266,9,48,144,58,0,259
Louisiana,Starks,364,85,142,64,21,0,312
Louisiana,Start,1035,78,313,159,104,38,692
Louisiana,Sugartown,69,15,12,0,0,0,27
Louisiana,Luling,13614,697,2911,2977,1952,424,8961
Louisiana,Basile,1713,480,409,139,31,4,1063
Louisiana,Church Point,4511,625,1639,817,100,34,3215
Louisiana,Pleasant Hill,562,50,178,107,29,14,378
Louisiana,Bogalusa,11793,1702,3068,1760,544,149,7223
Louisiana,Grayson,531,89,125,95,29,7,345
Louisiana,Tangipahoa,651,85,155,92,25,12,369
Louisiana,Boutte,2952,339,719,579,163,102,1902
Louisiana,Franklinton,3774,779,1112,646,239,171,2947
Louisiana,Denham Springs,9991,1160,2098,2052,720,509,6539
Louisiana,Cut Off,5897,1091,2146,781,205,197,4420
Louisiana,Grand Cane,286,32,56,31,70,25,214
Louisiana,Westminster,2819,27,286,513,723,467,2016
Louisiana,Lydia,544,57,267,137,0,0,461
Louisiana,Montegut,2084,455,479,124,123,33,1214
Louisiana,Leonville,990,147,389,63,6,24,629
Louisiana,Raceland,10686,1892,3137,1379,677,295,7380
Louisiana,Grand Coteau,808,115,255,75,59,23,527
Louisiana,Port Barre,1774,321,485,186,53,4,1049
Louisiana,Baskin,252,38,91,26,9,3,167
Louisiana,Red Chute,6468,451,1443,1584,750,369,4597
Louisiana,Plain Dealing,926,86,303,211,100,26,726
Louisiana,Livingston,2095,161,584,385,209,69,1408
Louisiana,Hosston,269,42,108,26,8,3,187
Louisiana,Grosse Tete,818,97,240,151,66,12,566
Louisiana,Waterproof,701,124,201,106,23,19,473
Louisiana,Paradis,1759,157,455,150,131,32,925
Louisiana,St. Rose,7665,528,1690,1891,650,134,4893
Louisiana,Jefferson,10341,1172,2707,2216,1283,782,8160
Louisiana,Jean Lafitte,1971,445,380,302,130,15,1272
Louisiana,Bridge City,6894,1070,1731,1337,295,33,4466
Louisiana,Avondale,4989,853,1531,581,164,64,3193
Louisiana,Mooringsport,569,103,159,121,36,3,422
Louisiana,Newellton,1386,221,358,128,30,9,746
Louisiana,Scott,8761,827,1965,1643,1345,284,6064
Louisiana,Golden Meadow,2023,514,576,235,92,28,1445
Louisiana,Chackbay,5573,619,1411,1038,393,150,3611
Louisiana,Mansfield,4820,908,1164,697,180,158,3107
Louisiana,Midway,1245,160,313,132,17,0,622
Louisiana,Lisbon,132,20,33,19,10,11,93
Louisiana,Dodson,398,44,85,35,12,5,181
Louisiana,Keachi,275,47,88,31,28,8,202
Louisiana,Ponchatoula,7131,639,1664,1305,829,126,4563
Louisiana,Bastrop,10521,1543,2391,1558,519,90,6101
Louisiana,Shreveport,193785,17054,41699,38231,19241,12288,128513
Louisiana,Vivian,3599,486,965,561,253,51,2316
Louisiana,Jennings,10047,1528,2401,1597,642,261,6429
Louisiana,Mound,3,0,0,1,2,0,3
Louisiana,Bienville,206,29,80,35,3,11,158
Louisiana,Ville Platte,7196,1424,1896,777,354,106,4557
Louisiana,Gibsland,626,69,192,185,27,5,478
Louisiana,Mount Lebanon,27,4,8,8,4,0,24
Louisiana,Turkey Creek,461,54,165,62,6,0,287
Louisiana,Cottonport,1704,361,279,271,106,38,1055
Louisiana,Morganza,826,100,244,117,35,8,504
Louisiana,Arcadia,2804,466,595,473,197,90,1821
Louisiana,Castor,332,52,68,40,35,2,197
Louisiana,Richwood,5013,1307,1604,513,76,29,3529
Louisiana,Parks,799,54,210,139,105,34,542
Louisiana,South Vacherie,3565,339,1210,553,221,126,2449
Louisiana,Sorrento,1809,164,530,347,159,14,1214
Louisiana,Merryville,1342,221,397,199,15,31,863
Louisiana,Gilbert,428,91,129,81,35,13,349
Louisiana,Lafitte,990,172,337,133,13,7,662
Louisiana,Benton,2402,95,606,565,146,75,1487
Louisiana,Tullos,437,53,132,48,9,7,249
Louisiana,Grand Isle,757,135,281,102,32,20,570
Louisiana,Gretna,17797,2280,4227,3827,1713,772,12819
Louisiana,Harahan,9309,489,1984,2196,1464,739,6872
Louisiana,Harvey,20712,2830,4983,3668,1773,665,13919
Louisiana,Lecompte,926,143,282,207,38,33,703
Louisiana,Pineville,14313,1149,2965,2325,1295,715,8449
Louisiana,Charenton,1688,182,715,277,86,24,1284
Louisiana,Covington,10133,938,1530,1649,1849,917,6883
Louisiana,Lake Charles,76267,7064,14324,15313,8676,5039,50416
Louisiana,Laplace,29147,2502,7032,6507,2228,1186,19455
Louisiana,Carlyss,4953,305,1367,963,435,86,3156
Louisiana,Walker,6250,598,1445,1386,487,224,4140
Louisiana,Ama,1366,66,392,227,93,37,815
Louisiana,Taft,63,22,23,0,18,0,63
Louisiana,Kentwood,2288,371,722,241,71,23,1428
Louisiana,Napoleonville,662,113,155,111,10,19,408
Louisiana,Plaquemine,6726,704,1591,1038,507,236,4076
Louisiana,Ashland,237,32,63,54,28,3,180
Louisiana,Claiborne,11435,357,2240,2283,2118,639,7637
Louisiana,Washington,904,190,279,71,69,26,635
Louisiana,Empire,1060,309,204,187,51,11,762
Louisiana,Ridgecrest,929,106,248,135,18,12,519
Louisiana,Shenandoah,20192,674,2285,4237,4479,1916,13591
Louisiana,Inniswold,6777,208,782,1422,1162,803,4377
Louisiana,Baker,13557,877,3487,2983,1065,509,8921
Louisiana,Angie,300,34,83,26,36,14,193
Louisiana,Woodworth,1281,96,279,242,183,111,911
Louisiana,Provencal,544,98,123,115,13,22,371
Louisiana,Goldonna,368,41,114,76,26,1,258
Louisiana,River Ridge,13241,762,2724,2789,2202,1328,9805
Louisiana,Stanley,154,23,55,14,8,3,103
Louisiana,Monticello,4479,251,1094,919,652,250,3166
Louisiana,Baton Rouge,225362,16295,37341,37258,26088,18818,135800
Louisiana,Forest Hill,685,124,172,83,42,6,427
Louisiana,Gardere,10841,955,1724,1893,1307,377,6256
Louisiana,Oak Hills Place,9015,98,812,1345,2342,1746,6343
Louisiana,Old Jefferson,8065,160,1215,1838,1429,415,5057
Louisiana,Collinston,293,51,72,55,1,4,183
Louisiana,Springfield,479,50,148,82,28,29,337
Louisiana,Destrehan,10933,317,2294,2206,2234,847,7898
Louisiana,Timberlane,10192,1077,2288,2168,784,286,6603
Louisiana,Westwego,8499,1514,2423,1463,476,94,5970
Louisiana,Abita Springs,2511,107,386,650,433,206,1782
Louisiana,Slidell,27769,1921,5825,6272,3106,1505,18629
Louisiana,Hall Summit,342,52,92,71,32,9,256
Louisiana,Rayville,3612,374,956,641,81,96,2148
Louisiana,Montpelier,343,64,96,46,9,13,228
Louisiana,Greenwood,3199,287,810,945,487,143,2672
Louisiana,Oak Ridge,94,14,11,20,20,12,77
Louisiana,Stonewall,2544,144,631,483,311,112,1681
Louisiana,South Mansfield,351,47,140,30,15,8,240
Louisiana,Zachary,17056,646,3035,3078,2036,1472,10267
Louisiana,Loreauville,856,134,278,71,38,14,535
Louisiana,Donaldsonville,8090,1361,2076,1038,674,174,5323
Louisiana,Calvin,215,14,43,37,18,8,120
Louisiana,Gray,5893,671,1212,973,382,104,3342
Louisiana,Pearl River,2556,289,719,467,141,53,1669
Louisiana,Franklin,7097,787,2476,912,268,166,4609
Louisiana,Berwick,4660,791,1284,669,311,143,3198
Louisiana,Ball,3994,359,832,774,388,72,2425
Louisiana,Robeline,106,23,27,34,6,1,91
Louisiana,Clarence,269,13,88,63,7,4,175
Louisiana,Woodmere,10458,854,2220,2606,839,422,6941
Louisiana,Terrytown,24244,3167,5312,4178,1917,560,15134
Louisiana,Metairie,143481,9567,29387,29001,24705,13301,105961
Louisiana,Longstreet,109,9,24,59,2,0,94
Louisiana,Gueydan,1266,304,371,137,75,27,914
Louisiana,St. Martinville,6014,975,1641,1129,255,118,4118
Louisiana,Kaplan,4549,802,1140,710,234,62,2948
Louisiana,North Vacherie,2071,176,659,354,193,69,1451
Louisiana,West Monroe,12756,1488,3058,2583,1072,563,8764
Louisiana,New Roads,4616,749,1017,786,518,112,3182
Louisiana,Boyce,1319,126,433,220,63,30,872
Louisiana,Mansura,1759,285,432,367,61,40,1185
Louisiana,Clinton,1815,103,549,248,138,60,1098
Louisiana,Natalbany,2388,253,514,327,299,77,1470
Louisiana,Hammond,20444,1689,3371,3068,1975,1218,11321
Louisiana,Bayou Gauche,2031,159,438,334,248,105,1284
Louisiana,DeQuincy,3125,514,925,353,186,119,2097
Louisiana,Homer,2942,378,937,453,108,72,1948
Louisiana,Wallace,707,53,212,143,15,21,444
Louisiana,Reserve,9280,1032,2532,1555,539,221,5879
Louisiana,Garyville,1997,171,608,405,101,73,1358
Louisiana,Natchitoches,18080,1506,2839,2887,1095,887,9214
Louisiana,Waggaman,9866,1335,2518,1602,734,203,6392
Louisiana,Gilliam,115,19,25,22,19,8,93
Louisiana,Blanchard,3042,78,724,798,380,90,2070
Louisiana,Lockport,2489,451,831,317,83,30,1712
Louisiana,Olla,1701,191,400,321,144,33,1089
Louisiana,Gramercy,3396,266,988,809,200,16,2279
Louisiana,Plaucheville,244,34,40,51,14,16,155
Louisiana,White Castle,1970,247,686,253,81,30,1297
Louisiana,Iowa,3229,391,650,647,249,71,2008
Louisiana,Cankton,741,50,217,93,43,9,412
Louisiana,Patterson,6012,868,1829,943,339,144,4123
Louisiana,Glenmora,1300,162,322,148,59,15,706
Louisiana,Winnsboro,4690,778,954,656,82,138,2608
Louisiana,Eastwood,4910,169,747,1060,663,327,2966
Louisiana,Supreme,984,121,140,78,28,22,389
Louisiana,Columbia,406,52,172,68,25,23,340
Louisiana,Lacombe,8503,915,1750,2152,845,665,6327
Louisiana,Maurice,1424,218,339,277,136,70,1040
Louisiana,Swartz,4661,145,1085,1290,361,238,3119
Louisiana,Clarks,912,302,310,91,8,7,718
Louisiana,Moreauville,981,142,264,238,67,28,739
Louisiana,Bunkie,4001,634,935,691,179,39,2478
Louisiana,Lucky,238,58,66,24,11,3,162
Louisiana,Mandeville,12252,673,1503,1930,3021,1384,8511
Louisiana,Cecilia,1987,243,626,225,135,72,1301
Louisiana,Port Allen,5051,605,1425,934,636,162,3762
Louisiana,Edgefield,300,25,51,81,27,12,196
Louisiana,Folsom,847,101,209,159,43,19,531
Louisiana,Logansport,1878,193,422,370,75,13,1073
Louisiana,St. Francisville,1829,102,389,384,252,102,1229
Louisiana,Martin,560,26,224,98,41,20,409
Louisiana,Colfax,2456,220,614,461,117,20,1432
Louisiana,Wisner,722,213,163,93,24,43,536
Louisiana,Village St. George,6900,376,806,1327,1575,811,4895
Louisiana,Pollock,469,27,114,87,20,6,254
Louisiana,Merrydale,8808,571,2276,1777,635,403,5662
Louisiana,Lutcher,3302,361,1190,524,249,147,2471
Louisiana,Bryceland,65,8,25,11,3,7,54
Louisiana,Oak Grove,1740,373,486,254,90,44,1247
Louisiana,Sarepta,825,66,197,231,37,14,545
Louisiana,Cullen,1049,264,275,138,29,14,720
Louisiana,Meraux,7296,553,1814,1537,518,114,4536
Louisiana,Sun,335,69,101,74,4,0,248
Louisiana,Baldwin,2522,290,926,249,112,44,1621
Louisiana,Amelia,1647,369,522,101,36,31,1059
Louisiana,McNary,178,16,54,27,28,2,127
Louisiana,Cheneyville,623,140,151,112,56,0,459
Louisiana,Bordelonville,640,91,177,83,5,22,378
Louisiana,Boothville,626,229,128,87,12,0,456
Louisiana,Belmont,325,15,78,92,30,0,215
Louisiana,Bayou L'Ourse,1564,285,435,241,55,13,1029
Louisiana,Bayou Goula,442,31,168,34,44,0,277
Louisiana,Bayou Country Club,1298,60,221,286,242,219,1028
Louisiana,Bayou Blue,11682,1641,3330,1969,647,182,7769
Louisiana,Bawcomville,2592,554,870,431,51,0,1906
Louisiana,Banks Springs,1378,145,325,110,60,45,685
Louisiana,Youngsville,12753,647,1937,2164,2771,677,8196
Louisiana,Central,28577,1600,7258,5911,3653,1222,19644
Louisiana,Broussard,11412,716,2357,2100,1744,954,7871
Louisiana,DeRidder,11050,1058,2667,2177,1091,525,7518
Louisiana,Killian,1375,127,373,325,138,73,1036
Louisiana,Simsboro,959,76,240,220,42,43,621
Louisiana,Bourg,2591,279,543,577,205,3,1607
Louisiana,Mermentau,740,136,221,90,15,31,493
Louisiana,Branch,207,23,95,0,0,0,118
Louisiana,Buras,907,214,217,91,7,58,587
Louisiana,Henderson,2280,607,517,189,46,0,1359
Louisiana,Simmesport,1727,366,434,160,29,20,1009
Louisiana,Evergreen,302,98,89,62,3,4,256
Louisiana,Winnfield,4502,481,1282,702,442,138,3045
Louisiana,Sikes,209,41,53,14,3,3,114
Louisiana,Amite City,4393,500,1289,1008,397,123,3317
Louisiana,Erwinville,2168,294,689,405,62,82,1532
Louisiana,Egan,573,101,151,111,66,0,429
Louisiana,Crescent,460,121,179,133,0,10,443
Louisiana,Convent,455,47,135,49,55,12,298
Louisiana,Choctaw,731,301,147,97,18,25,588
Louisiana,Center Point,458,48,107,61,93,10,319
Louisiana,Catahoula,1193,109,393,125,91,41,759
Louisiana,Calhoun,520,0,84,96,100,87,367
Louisiana,Cade,1967,207,427,298,161,48,1141
Louisiana,Brownsville,3857,509,1259,655,94,64,2581
Louisiana,Georgetown,497,29,108,43,20,3,203
Louisiana,Creola,225,23,32,35,3,2,95
Louisiana,Hackberry,1421,169,315,337,89,24,934
Louisiana,Breaux Bridge,8299,892,2010,1299,680,277,5158
Louisiana,Paincourtville,909,88,309,156,28,34,615
Louisiana,Madisonville,792,14,113,148,179,72,526
Louisiana,Forest,286,49,74,78,6,5,212
Louisiana,Edgard,2053,152,444,507,203,88,1394
Louisiana,Chatham,680,144,149,72,22,19,406
Louisiana,Brusly,2739,60,773,440,342,117,1732
Louisiana,Crowley,12960,2717,2788,1600,755,387,8247
Louisiana,Anacoco,1161,65,343,194,66,57,725
Louisiana,Mamou,3197,603,697,390,61,12,1763
Louisiana,Florien,619,69,175,98,24,23,389
Louisiana,Elmwood,5525,125,644,1201,1036,944,3950
Louisiana,Sunset,2926,285,714,446,207,106,1758
Louisiana,Brownfields,5092,331,1668,1066,472,236,3773
Louisiana,Rosedale,869,78,217,168,78,37,578
Louisiana,Deville,1159,155,388,195,88,12,838
Louisiana,Powhatan,273,42,87,8,4,3,144
Louisiana,Mathews,2649,262,859,349,137,74,1681
Louisiana,Delta,260,30,60,42,9,0,141
Louisiana,Lake Providence,2930,478,723,353,205,30,1789
Louisiana,Chauvin,2579,784,723,295,24,29,1855
Louisiana,Krotz Springs,934,255,236,104,13,0,608
Louisiana,St. Joseph,854,130,245,130,29,10,544
Louisiana,Fenton,310,45,98,54,16,0,213
Louisiana,Hessmer,880,91,262,169,59,10,591
Louisiana,Iota,1798,257,387,347,96,26,1113
Louisiana,Prien,7976,567,1395,1573,1229,560,5324
Louisiana,Killona,714,76,202,73,19,0,370
Louisiana,Junction City,560,12,215,39,25,1,292
Louisiana,Erath,2047,354,518,262,144,33,1311
Louisiana,Kenner,66910,6862,14320,12976,7823,3471,45452
Louisiana,Natchez,597,101,132,161,4,17,415
Louisiana,Addis,4952,351,1257,796,391,155,2950
Louisiana,Grambling,5187,154,385,744,489,486,2258
Louisiana,St. Gabriel,7200,1491,2008,1322,504,168,5493
Louisiana,Bayou Vista,4567,599,1767,423,209,76,3074
Louisiana,Mer Rouge,504,43,195,79,38,12,367
Louisiana,Sterlington,2495,226,492,480,187,79,1464
Louisiana,Monroe,48663,4602,9187,7602,5223,2842,29456
Louisiana,Pine Prairie,1182,297,315,175,52,17,856
Louisiana,Jamestown,144,20,41,30,27,2,120
Louisiana,Livonia,1393,193,434,208,88,17,940
Louisiana,Fordoche,1046,143,310,127,22,37,639
Louisiana,Eden Isle,7554,394,1741,2148,1154,732,6169
Louisiana,Morgan City,11452,1168,3895,1874,562,264,7763
Louisiana,Alexandria,47539,4902,11297,8174,4424,3362,32159
Louisiana,Campti,1072,122,389,138,43,13,705
Louisiana,Slaughter,1030,77,323,264,47,31,742
Louisiana,Marrero,32088,4830,8046,6131,2039,862,21908
Louisiana,Lake Arthur,2751,570,707,241,137,74,1729
Louisiana,Ida,202,25,83,42,12,8,170
Louisiana,Galliano,7131,1354,2467,778,398,87,5084
Louisiana,Des Allemands,1597,280,624,317,62,41,1324
Louisiana,New Sarpy,1393,154,351,151,61,35,752
Louisiana,Oakdale,7640,1177,2502,1674,447,327,6127
Louisiana,Tickfaw,687,89,196,108,38,10,441
Louisiana,Epps,976,275,338,94,43,4,754
Louisiana,Larose,7529,1412,1888,942,531,171,4944
Louisiana,Independence,1850,221,556,193,98,31,1099
Louisiana,Greensburg,788,119,223,100,43,29,514
Louisiana,Mangham,548,72,147,56,36,30,341
Louisiana,Kilbourne,337,44,121,45,12,26,248
Louisiana,Delhi,2872,346,800,517,204,100,1967
Louisiana,Coushatta,2672,475,598,316,93,44,1526
Louisiana,Spearsville,140,11,35,29,15,2,92
Louisiana,Pierre Part,2319,408,902,393,94,18,1815
Louisiana,Belle Rose,1846,248,526,412,51,79,1316
Louisiana,Urania,1413,430,417,159,55,19,1080
Louisiana,Vidalia,4041,420,922,679,280,137,2438
Louisiana,Athens,361,18,120,91,23,7,259
Louisiana,Harrisonburg,336,32,115,26,37,4,214
Louisiana,Montgomery,643,43,204,187,40,0,474
Maine,Orono,9474,151,320,757,887,1250,3365
Maine,Randolph,1996,208,585,436,192,77,1498
Maine,Houlton,4693,451,1454,1086,411,197,3599
Maine,Bucksport,2654,136,752,801,224,196,2109
Maine,Oxford,1239,70,191,370,177,34,842
Maine,South Paris,2158,83,789,468,157,82,1579
Maine,Bridgton,2198,26,740,445,272,90,1573
Maine,Westbrook,18417,863,4196,4256,2985,1330,13630
Maine,Limestone,1426,131,273,251,79,75,809
Maine,Searsport,1030,87,200,308,131,82,808
Maine,Van Buren,1687,276,535,352,105,53,1321
Maine,Hartland,803,77,254,118,58,20,527
Maine,Pittsfield,2873,230,586,607,238,191,1852
Maine,Wiscasset,1042,133,320,180,106,109,848
Maine,Farmington,3878,100,535,490,455,485,2065
Maine,Farmingdale,2068,123,400,356,348,269,1496
Maine,Clinton,992,70,347,179,161,29,786
Maine,Madison,2502,109,911,651,178,44,1893
Maine,Yarmouth,5608,176,708,574,1536,1096,4090
Maine,Norway,2703,130,737,617,158,167,1809
Maine,Topsham,6103,257,1151,1176,1236,869,4689
Maine,Livermore Falls,1589,138,464,304,125,9,1040
Maine,York Harbor,2542,45,424,477,650,437,2033
Maine,Saco,19342,825,3914,3674,3470,1703,13586
Maine,Kennebunkport,1121,0,79,214,229,269,791
Maine,Milford,2191,35,749,436,158,181,1559
Maine,Gardiner,5667,437,1128,1294,626,377,3862
Maine,Bangor,32098,1785,6447,6839,4551,3171,22793
Maine,Cape Neddick,2316,13,446,628,615,345,2047
Maine,Bowdoinham,632,49,147,193,84,72,545
Maine,Fort Kent,2291,123,655,376,255,172,1581
Maine,Winterport,1195,39,340,202,169,204,954
Maine,Blue Hill,1011,27,256,194,174,80,731
Maine,Blaine,261,8,87,72,17,21,205
Maine,Ashland,528,38,162,116,44,36,396
Maine,East Millinocket,1673,109,509,554,118,39,1329
Maine,Fairfield,3152,430,794,779,228,13,2244
Maine,South Portland,25515,750,3998,5183,4993,3161,18085
Maine,Freeport,1412,31,199,326,297,233,1086
Maine,Fryeburg,1548,101,384,423,91,104,1103
Maine,Bar Harbor,2172,44,250,497,385,249,1425
Maine,Greenville,1075,70,411,242,85,79,887
Maine,Caribou,7749,874,2141,1678,838,316,5847
Maine,South Eliot,3325,110,498,985,529,313,2435
Maine,Waterville,16515,865,3453,3305,1613,1511,10747
Maine,Wilton,1982,97,704,372,218,45,1436
Maine,Woodland,948,35,244,268,101,19,667
Maine,Lincoln,2703,391,1195,297,252,116,2251
Maine,Chisholm,1411,31,551,272,156,86,1096
Maine,Anson,1057,167,237,206,36,33,679
Maine,Mechanic Falls,1894,110,580,452,169,52,1363
Maine,Hallowell,2506,58,351,493,478,409,1789
Maine,North Berwick,1389,123,434,306,94,71,1028
Maine,Brunswick,15244,684,2376,2760,2291,2388,10499
Maine,Kittery Point,1086,80,279,150,321,146,976
Maine,Hampden,3889,182,665,752,900,488,2987
Maine,Unity,321,12,77,47,21,32,189
Maine,Scarborough,4796,248,970,615,1031,713,3577
Maine,Rumford,3771,307,1504,878,463,58,3210
Maine,Lake Arrowhead,2358,86,635,590,237,93,1641
Maine,Madawaska,2633,368,879,561,258,66,2132
Maine,Calais,2998,333,892,649,322,77,2273
Maine,Skowhegan,6434,874,1624,1433,536,205,4672
Maine,Machias,1060,81,331,215,131,48,806
Maine,Portland,66735,3211,8412,12527,15132,9984,49266
Maine,Falmouth Foreside,1544,15,82,236,389,404,1126
Maine,Bingham,763,48,242,192,65,12,559
Maine,Mexico,1626,79,595,500,178,9,1361
Maine,Millinocket,4314,471,1641,1028,325,176,3641
Maine,Berwick,2415,114,421,570,521,117,1743
Maine,Old Orchard Beach,8809,455,2042,2554,1671,809,7531
Maine,Biddeford,21452,1658,5145,4184,2488,1042,14517
Maine,Old Town,7549,312,1553,1667,823,753,5108
Maine,Sanford,21015,1273,5691,4797,2076,789,14626
Maine,Alfred,1034,114,277,191,146,66,794
Maine,Winter Harbor,284,25,68,61,52,17,223
Maine,Washburn,1065,192,276,290,51,25,834
Maine,Steep Falls,1720,1,309,438,282,73,1103
Maine,Standish,255,0,99,65,17,74,255
Maine,Howland,1106,120,337,205,88,15,765
Maine,South Windham,1113,162,402,327,72,0,963
Maine,Newcastle,613,43,80,108,130,132,493
Maine,Naples,515,11,61,183,67,58,380
Maine,Mars Hill,881,137,248,179,53,25,642
Maine,Mapleton,807,36,168,265,98,17,584
Maine,Lubec,321,25,109,88,30,39,291
Maine,Littlejohn Island,30,7,8,8,7,0,30
Maine,Little Falls,982,1,289,165,164,34,653
Maine,Gray,898,92,139,241,229,17,718
Maine,Falmouth,2049,69,145,335,527,506,1582
Maine,Eagle Lake,527,83,170,93,53,23,422
Maine,Damariscotta,1286,86,256,195,152,281,970
Maine,Cousins Island,587,18,44,48,198,136,444
Maine,Castine,828,0,5,65,52,79,201
Maine,Casco,765,59,244,185,107,14,609
Maine,Southwest Harbor,757,11,122,133,157,142,565
Maine,Norridgewock,1283,96,548,133,165,31,973
Maine,Dexter,2287,109,939,427,199,61,1735
Maine,Oakland,2292,129,662,689,231,60,1771
Maine,Cumberland Center,2644,47,281,158,632,582,1700
Maine,Brunswick Station,637,26,86,135,127,47,421
Maine,Rockland,7190,349,1898,1213,1078,573,5111
Maine,Camden,3442,101,608,1015,837,416,2977
Maine,Guilford,743,27,263,197,53,7,547
Maine,Lisbon Falls,4189,81,854,1113,524,141,2713
Maine,Lewiston,36097,3405,8943,7756,3054,1517,24675
Maine,Presque Isle,9162,675,1997,2149,923,559,6303
Maine,Fort Fairfield,1610,188,411,416,182,92,1289
Maine,Kittery,4376,126,657,1108,825,571,3287
Maine,Kennebunk,5809,175,1012,1074,1248,899,4408
Maine,Boothbay Harbor,1131,24,346,190,248,118,926
Maine,Newport,1760,129,527,416,180,75,1327
Maine,Winthrop,2594,115,415,959,320,328,2137
Maine,Winslow,5004,209,1152,1274,524,332,3491
Maine,Eastport,1351,95,431,318,153,73,1070
Maine,Waldoboro,1260,91,436,226,119,106,978
Maine,Bath,8320,347,1685,1844,1085,949,5910
Maine,North Windham,5820,120,950,1504,916,408,3898
Maine,Augusta,18635,1633,4702,3810,2332,986,13463
Maine,Brewer,9123,616,1576,2300,1357,768,6617
Maine,West Kennebunk,1023,5,221,204,209,134,773
Maine,Auburn,23064,1531,5328,4789,2693,1950,16291
Maine,Richmond,1602,107,256,378,353,89,1183
Maine,Milo,2233,116,587,576,147,64,1490
Maine,Thomaston,2018,102,351,568,260,69,1350
Maine,Ellsworth,7960,396,1804,2181,1071,598,6050
Maine,Dixfield,1292,119,423,306,45,30,923
Maine,Gorham,6711,118,963,1026,1301,544,3952
Maine,Belfast,6696,289,1232,1613,1285,768,5187
Maine,Dover-Foxcroft,2496,238,547,619,305,145,1854
Maryland,Rosaryville,10705,421,2005,2361,1732,1248,7767
Maryland,Seat Pleasant,4759,539,1235,1162,210,84,3230
Maryland,Walker Mill,11780,997,2972,2641,949,808,8367
Maryland,Sudlersville,415,46,135,58,44,15,298
Maryland,Princess Anne,3444,250,381,780,300,61,1772
Maryland,Lake Arbor,10456,255,1427,2289,2057,1538,7566
Maryland,Morningside,1238,181,356,221,47,34,839
Maryland,Springdale,2947,224,645,619,371,254,2113
Maryland,Union Bridge,828,88,271,144,53,32,588
Maryland,Prince Frederick,3189,329,755,653,292,117,2146
Maryland,Frenchtown-Rumbly,121,14,67,22,0,0,103
Maryland,Smith Island,193,15,77,22,23,0,137
Maryland,Oakland,1823,227,573,354,131,158,1443
Maryland,Elkridge,20519,833,2370,3026,4040,2940,13209
Maryland,Ellicott City,72247,1991,6158,8683,14730,17580,49142
Maryland,Bel Air South,48269,1633,7633,9544,8548,5860,33218
Maryland,Fallston,8836,384,1347,1642,1583,1171,6127
Maryland,Havre de Grace,13555,682,2459,2626,2165,1946,9878
Maryland,Carney,29743,1462,5455,6760,4676,3368,21721
Maryland,Garrison,8388,310,1062,1707,1596,1270,5945
Maryland,Hampstead,6340,248,1430,1079,1152,445,4354
Maryland,Milford Mill,29974,1291,6436,6161,4237,1940,20065
Maryland,Chance,482,24,150,132,20,40,366
Maryland,White Marsh,9455,349,1694,1950,1768,1045,6806
Maryland,Church Creek,105,6,33,21,9,6,75
Maryland,Middletown,4553,82,415,729,910,690,2826
Maryland,Mountain Lake Park,2148,192,664,374,196,164,1590
Maryland,Galena,708,35,173,164,86,51,509
Maryland,California,14298,904,2151,2815,2316,1338,9524
Maryland,Golden Beach,2875,186,753,714,237,180,2070
Maryland,Lexington Park,11848,841,1995,2836,1245,399,7316
Maryland,Catonsville,41515,1651,5935,6748,7577,6540,28451
Maryland,Chevy Chase View,997,4,14,37,248,305,608
Maryland,Forest Glen,6589,486,580,830,1519,1410,4825
Maryland,Delmar,3172,340,620,513,461,166,2100
Maryland,Kemp Mill,13838,853,1167,2057,2397,2902,9376
Maryland,Myersville,1838,60,226,314,291,269,1160
Maryland,Stevensville,6973,150,1493,1138,1012,835,4628
Maryland,Barclay,230,49,49,12,13,2,125
Maryland,South Laurel,28048,2221,3640,5033,4644,3367,18905
Maryland,Takoma Park,17622,1189,1901,1854,2921,4300,12165
Maryland,St. Leonard,460,27,83,88,63,45,306
Maryland,Solomons,2113,87,367,482,375,467,1778
Maryland,Adelphi,15751,2534,2351,2486,1900,1436,10707
Maryland,Brentwood,3468,728,485,426,309,270,2218
Maryland,Cheverly,6452,550,647,1179,1265,1032,4673
Maryland,Clinton,40027,1730,8361,9679,4880,3032,27682
Maryland,Glenn Dale,14191,655,1647,2792,2503,2154,9751
Maryland,New Carrollton,12932,1379,2309,2716,1399,816,8619
Maryland,Woodmore,4541,90,426,644,960,1110,3230
Maryland,Centreville,4678,305,698,1208,601,398,3210
Maryland,Colmar Manor,1398,251,235,219,125,74,904
Maryland,Kent Narrows,475,0,101,111,133,121,466
Maryland,Dames Quarter,71,16,11,11,13,13,64
Maryland,Camp Springs,21602,1110,4337,5161,3033,1555,15196
Maryland,Port Deposit,618,98,140,120,58,48,464
Maryland,Potomac Heights,1190,37,492,306,68,39,942
Maryland,Frederick,70166,5083,10406,13092,10437,8347,47365
Maryland,Friendsville,573,41,206,94,25,28,394
Maryland,Hyattsville,18209,2214,2742,3035,2086,2284,12361
Maryland,Preston,847,37,215,173,71,37,533
Maryland,Fairmount Heights,1789,310,487,434,67,16,1314
Maryland,Forestville,11719,818,3096,2732,976,608,8230
Maryland,Fort Washington,24183,1429,3814,5451,4371,3298,18363
Maryland,Friendly,9793,805,2046,2273,1328,757,7209
Maryland,Mount Rainier,8110,1267,1356,1534,893,690,5740
Maryland,North Brentwood,755,156,139,116,74,24,509
Maryland,Kensington,2269,50,160,174,491,673,1548
Maryland,Martin's Additions,983,10,2,77,207,359,655
Maryland,Montgomery Village,33798,2948,3919,5852,5216,4196,22131
Maryland,Denton,4406,385,1113,911,252,180,2841
Maryland,Mardela Springs,461,2,136,108,23,25,294
Maryland,Salisbury,32536,2552,5218,5474,2769,1952,17965
Maryland,Brookview,45,2,17,5,5,5,34
Maryland,Hurlock,2327,294,581,446,143,76,1540
Maryland,Mount Airy,9395,243,1439,1786,1518,1086,6072
Maryland,Thurmont,6563,401,1580,1441,651,450,4523
Maryland,Grantsville,664,72,256,161,43,30,562
Maryland,Woodlawn CDP (Baltimore County),38951,3251,7830,7693,5559,3499,27832
Maryland,Brookeville,165,2,23,26,41,36,128
Maryland,Chevy Chase Village,1943,21,21,68,349,860,1319
Maryland,Gaithersburg,67529,5661,6908,8923,12237,12178,45907
Maryland,North Kensington,9347,486,791,1353,1693,2121,6444
Maryland,Travilah,11633,217,480,789,2309,4288,8083
Maryland,Washington Grove,568,27,34,59,116,189,425
Maryland,Pittsville,1433,129,447,287,76,19,958
Maryland,Lochearn,26271,1615,5352,6308,3946,2036,19257
Maryland,Mays Chapel,12303,150,1001,1517,3551,2478,8697
Maryland,Overlea,12384,780,3169,2759,1444,989,9141
Maryland,Reisterstown,26933,1884,4516,5483,4301,2395,18579
Maryland,Rosedale,19336,1689,4633,4021,2054,1102,13499
Maryland,Cabin John,2085,14,23,188,402,823,1450
Maryland,Clarksburg,23548,712,1417,2385,5118,4753,14385
Maryland,Garrett Park,1010,17,27,79,202,371,696
Maryland,Glen Echo,325,2,12,9,72,106,201
Maryland,North Bethesda,50262,2038,3241,5432,11801,14413,36925
Maryland,Potomac,45824,700,1986,3442,9586,16168,31882
Maryland,Coral Hills,9460,1029,2617,1789,596,303,6334
Maryland,Lusby,1994,164,292,418,209,216,1299
Maryland,Upper Marlboro,689,27,137,132,109,88,493
Maryland,Calverton,18076,1238,2349,3061,3692,3275,13615
Maryland,Glenarden,6170,303,1133,1249,871,378,3934
Maryland,Goldsboro,246,44,88,13,9,4,158
Maryland,Henderson,153,60,21,9,0,0,90
Maryland,North Laurel,24621,820,2932,3820,4451,3591,15614
Maryland,Braddock Heights,3258,178,473,595,639,421,2306
Maryland,Burkittsville,140,3,27,19,29,23,101
Maryland,Loch Lynn Heights,499,43,197,60,34,5,339
Maryland,Chevy Chase Section Five,668,5,5,26,117,263,416
Maryland,Edgemere,8633,713,2234,2279,637,497,6360
Maryland,Perry Hall,28129,1465,5245,4895,5600,3015,20220
Maryland,Aspen Hill,52807,5113,7410,7529,7991,6756,34799
Maryland,Darnestown,6424,167,320,733,1467,1760,4447
Maryland,Poolesville,5170,138,402,900,1024,714,3178
Maryland,Redland,16978,1491,1882,2311,3189,2754,11627
Maryland,Silver Spring,79750,7593,7688,9113,13334,17381,55109
Maryland,Edmonston,1354,326,192,171,90,59,838
Maryland,North Beach,2594,134,431,679,272,277,1793
Maryland,Chillum,35798,7454,6497,5205,3191,1532,23879
Maryland,Cottage City,1269,206,268,265,120,47,906
Maryland,Forest Heights,2573,207,585,571,198,92,1653
Maryland,Cloverly,15062,627,1641,2115,2822,3500,10705
Maryland,Germantown,90844,4902,9012,15833,15614,13802,59163
Maryland,Somerset,1136,0,6,55,200,511,772
Maryland,South Kensington,8769,197,389,725,2111,2592,6014
Maryland,Accokeek,11895,479,2096,2188,1946,1622,8331
Maryland,Brandywine,9761,239,2061,2135,1406,859,6700
Maryland,Middle River,25346,2569,6830,4576,1962,1078,17015
Maryland,Damascus,15094,635,1871,2704,2873,1941,10024
Maryland,Bethesda,62448,796,1804,3803,13081,24869,44353
Maryland,Riverdale Park,7219,1720,844,642,846,594,4646
Maryland,Langley Park,19278,7355,2339,1042,806,275,11817
Maryland,Berwyn Heights,3257,437,437,603,474,435,2386
Maryland,Cape St. Claire,8928,166,997,1811,1693,1330,5997
Maryland,Aberdeen,15701,1432,3304,3742,1350,975,10803
Maryland,Aberdeen Proving Ground,2723,27,298,411,296,265,1297
Maryland,Riverside,5839,242,883,1331,1004,481,3941
Maryland,Arbutus,20259,1479,4593,4201,2556,1557,14386
Maryland,Cockeysville,22071,1407,2915,4044,4311,2860,15537
Maryland,Rossville,15392,1265,2665,3318,1917,1547,10712
Maryland,Ashton-Sandy Spring,6136,100,638,983,1364,1016,4101
Maryland,Arnold,23518,566,2435,4371,4916,3883,16171
Maryland,Brooklyn Park,15036,1886,4273,2914,944,441,10458
Maryland,Deale,4905,151,981,1071,824,488,3515
Maryland,Brunswick,6193,314,1286,1135,950,399,4084
Maryland,La Plata,9252,577,1543,1998,960,938,6016
Maryland,East New Market,453,13,100,97,31,49,290
Maryland,Galestown,82,4,18,35,9,4,70
Maryland,New Market,1295,31,152,204,256,130,773
Maryland,Rosemont,336,19,105,47,55,30,256
Maryland,Kitzmiller,265,49,98,39,12,8,206
Maryland,Parole,16232,554,2033,3106,3947,4001,13641
Maryland,Maryland City,17736,897,2751,3021,2601,2507,11777
Maryland,Naval Academy,5834,4,27,110,69,59,269
Maryland,Odenton,41846,1590,5497,8020,7634,6212,28953
Maryland,Eldersburg,31454,1486,4740,5574,6335,3632,21767
Maryland,Hillandale,6223,794,639,858,1176,1143,4610
Maryland,Annapolis,39147,3550,5118,5860,7166,5795,27489
Maryland,Crofton,28379,552,2490,4534,6526,4890,18992
Maryland,Easton,16551,1461,3168,3333,2156,1648,11766
Maryland,Fort Ritchie,123,4,30,4,5,0,43
Maryland,Sykesville,3944,184,554,531,1017,416,2702
Maryland,Pasadena,28338,1450,5823,5929,4213,2054,19469
Maryland,Leonardtown,3678,222,695,524,380,561,2382
Maryland,Grasonville,3556,183,894,542,488,258,2365
Maryland,Kingstown,1944,164,394,344,266,208,1376
Maryland,Templeville,161,53,18,0,5,0,76
Maryland,Queen Anne,253,14,53,75,16,10,168
Maryland,Linthicum,10895,627,2355,2147,1642,1036,7807
Maryland,Mayo,8171,174,1651,1487,1509,840,5661
Maryland,Riviera Beach,12577,741,3338,3166,1257,495,8997
Maryland,Funkstown,811,93,265,196,72,36,662
Maryland,Williamsport,2264,251,714,411,164,68,1608
Maryland,Bel Air North,31582,1044,4980,6605,5020,3649,21298
Maryland,Edgewood,26219,1434,5415,6218,1820,1608,16495
Maryland,Bowleys Quarters,6519,278,1496,1860,562,616,4812
Maryland,Essex,40480,4664,10535,7938,2884,1033,27054
Maryland,Hampton,4725,47,360,603,954,1551,3515
Maryland,Deal Island,371,42,167,78,65,12,364
Maryland,Ferndale,17455,1427,4142,4044,1497,577,11687
Maryland,Fort Meade,10297,153,667,2183,1492,675,5170
Maryland,Cordova,655,60,222,102,13,25,422
Maryland,Trappe,1210,95,350,243,85,89,862
Maryland,Pocomoke City,4082,384,1045,603,422,197,2651
Maryland,La Vale,3421,189,802,1070,345,436,2842
Maryland,Perryville,4395,83,1175,920,462,478,3118
Maryland,Walkersville,6095,501,957,1344,767,655,4224
Maryland,Vienna,351,23,81,121,37,20,282
Maryland,Ballenger Creek,19889,820,2989,4153,3233,2117,13312
Maryland,Emmitsburg,3058,135,727,556,395,222,2035
Maryland,Jessup,8359,1769,2820,2043,356,125,7113
Maryland,Glen Burnie,69813,6288,15807,14481,7067,3994,47637
Maryland,Woodlawn CDP (Prince George's County),7405,1759,1336,1045,379,218,4737
Maryland,Severna Park,38576,951,3744,5502,8774,6914,25885
Maryland,Taneytown,6774,642,1875,1008,732,318,4575
Maryland,Parkville,31633,1802,6928,6649,3798,2247,21424
Maryland,Towson,58347,1482,4391,6380,11169,11688,35110
Maryland,Brookmont,3633,54,89,101,557,1671,2472
Maryland,Chevy Chase,2965,13,53,71,615,1251,2003
Maryland,Chevy Chase,9611,69,360,548,2130,3650,6757
Maryland,Chevy Chase Section Three,722,0,17,31,153,295,496
Maryland,Hagerstown,40186,4528,9656,7745,2605,1553,26087
Maryland,Riva,4027,72,472,714,947,605,2810
Maryland,Tilghman Island,819,129,185,158,92,110,674
Maryland,Fountainhead-Orchard Hills,5823,284,758,1487,1127,568,4224
Maryland,Hancock,1481,133,546,269,54,44,1046
Maryland,Robinwood,8123,437,1241,1594,1201,921,5394
Maryland,Berlin,4606,249,785,1026,765,305,3130
Maryland,Snow Hill,2143,195,531,348,149,126,1349
Maryland,Stockton,139,23,9,50,12,17,111
Maryland,Cumberland,19845,1243,5428,4045,1437,1060,13213
Maryland,Midland,688,13,270,135,28,30,476
Maryland,Cecilton,884,135,344,100,38,45,662
Maryland,Rising Sun,2812,225,642,502,170,104,1643
Maryland,Bryans Road,7325,289,1946,1416,882,483,5016
Maryland,Cambridge,12401,1108,3371,2292,1128,554,8453
Maryland,Lonaconing,1194,83,360,234,59,90,826
Maryland,Westernport,2018,187,537,383,72,77,1256
Maryland,Elkton,15675,1650,3674,2665,1199,841,10029
Maryland,Bowie,58368,1990,8029,11021,11112,9492,41644
Maryland,Willards,856,99,227,142,59,24,551
Maryland,Marydel,337,120,60,29,9,7,225
Maryland,Kingsville,4404,132,873,935,798,601,3339
Maryland,New Windsor,1341,76,428,235,148,59,946
Maryland,Indian Head,3819,74,806,712,328,257,2177
Maryland,Girdletree,100,14,28,24,7,0,73
Maryland,St. Michaels,1057,64,206,280,243,98,891
Maryland,Highfield-Cascade,805,60,305,142,78,5,590
Maryland,Mount Aetna,675,0,164,180,95,83,522
Maryland,Mount Lena,640,38,166,127,29,44,404
Maryland,Paramount-Long Meadow,2981,118,414,701,482,358,2073
Maryland,San Mar,168,40,78,28,4,0,150
Maryland,Ocean City,6990,580,1716,1777,1215,685,5973
Maryland,Ocean Pines,12246,548,2447,3222,2215,1509,9941
Maryland,North East,3624,491,875,610,382,105,2463
Maryland,Hughesville,2105,136,532,629,254,92,1643
Maryland,Waldorf,74587,2922,13982,17038,8321,5922,48185
Maryland,Bel Air,10068,505,1768,2208,1652,1196,7329
Maryland,Jarrettsville,2992,167,541,576,500,253,2037
Maryland,Joppatowne,12560,760,2553,2724,2059,887,8983
Maryland,Crownsville,1569,105,218,329,388,195,1235
Maryland,Highland Beach,87,2,5,15,14,35,71
Maryland,Lake Shore,20260,788,4185,4659,2688,1559,13879
Maryland,Boonsboro,3500,176,732,800,358,274,2340
Maryland,Severn,50052,2274,7460,9806,9125,5381,34046
Maryland,Shady Side,5839,354,1453,990,769,448,4014
Maryland,Manchester,4836,225,895,1039,486,448,3093
Maryland,Cavetown,1117,166,278,267,82,32,825
Maryland,Clear Spring,460,61,152,77,7,8,305
Maryland,Halfway,10784,675,2867,2195,1006,906,7649
Maryland,Rohrersville,150,0,63,38,33,0,134
Maryland,St. James,3100,161,692,614,384,132,1983
Maryland,Wilson-Conococheague,2330,359,803,380,165,31,1738
Maryland,Chesapeake City,763,23,195,199,135,51,603
Maryland,Charlestown,1391,128,264,323,165,96,976
Maryland,Algonquin,1257,84,361,289,210,107,1051
Maryland,Parsonsburg,421,72,54,96,36,0,258
Maryland,Jefferson,2155,65,330,371,485,214,1465
Maryland,Indian Springs,38,0,26,12,0,0,38
Maryland,Ilchester,26647,875,2092,3094,5458,5473,16992
Maryland,Hutton,183,57,29,18,0,20,124
Maryland,Highland,1066,13,24,118,342,265,762
Maryland,Greensburg,340,20,156,32,37,11,256
Maryland,Jennings,281,90,57,28,16,0,191
Maryland,Grahamtown,285,0,116,55,59,12,242
Maryland,Glenmont,16389,1773,2423,2278,2644,2057,11175
Maryland,Glassmanor,17628,2372,4103,3548,832,728,11583
Maryland,Gilmore,227,9,73,77,0,0,159
Maryland,Georgetown,79,12,45,0,0,0,57
Maryland,Garretts Mill,468,13,138,50,68,70,339
Maryland,Gapland,128,0,15,20,32,20,87
Maryland,Gorman,40,21,19,0,0,0,40
Maryland,Gambrills,2829,130,482,555,433,426,2026
Maryland,Jesterville,216,0,89,29,22,16,156
Maryland,Kemps Mill,32,0,32,0,0,0,32
Maryland,McCoole,700,23,265,193,16,0,497
Maryland,Lutherville,6773,171,818,999,1223,1535,4746
Maryland,Long Beach,2015,117,534,418,307,89,1465
Maryland,Little Orleans,28,0,28,0,0,0,28
Maryland,Linganore,8978,106,718,1595,1914,1642,5975
Maryland,Libertytown,983,46,253,141,159,43,642
Maryland,Jugtown,302,11,80,33,69,25,218
Maryland,Leisure World,9321,519,1798,2641,1778,2130,8866
Maryland,Lansdowne,8571,1110,2486,1058,449,233,5336
Maryland,Lanham,10301,1128,1859,1739,1199,683,6608
Maryland,Landover,22041,2644,5291,4001,1444,822,14202
Maryland,Konterra,2853,162,271,655,584,499,2171
Maryland,Klondike,114,11,17,10,29,0,67
Maryland,Kennedyville,445,20,152,29,65,40,306
Maryland,Layhill,4836,268,721,733,863,922,3507
Maryland,Madison,195,0,66,43,26,23,158
Maryland,Galesville,558,56,161,115,103,51,486
Maryland,Friendship Heights Village,5225,49,61,330,1279,2467,4186
Maryland,Drum Point,2692,162,534,693,226,307,1922
Maryland,Downsville,331,24,215,27,0,12,278
Maryland,Detmold,192,9,43,38,9,21,120
Maryland,Derwood,1992,151,115,222,423,674,1585
Maryland,Dawson,68,0,59,0,0,9,68
Maryland,Darlington,442,34,101,61,100,104,400
Maryland,Eakles Mill,0,0,0,0,0,0,0
Maryland,Dargan,166,0,14,81,14,0,109
Maryland,Croom,2490,225,563,565,409,281,2043
Maryland,Cresaptown,5977,980,2282,1275,281,274,5092
Maryland,Crellin,86,33,38,15,0,0,86
Maryland,Corriganville,525,77,138,122,17,10,364
Maryland,Cobb Island,831,45,290,108,57,41,541
Maryland,Clarysville,43,43,0,0,0,0,43
Maryland,Danville,283,16,103,70,0,0,189
Maryland,Fulton,4429,11,459,383,722,1375,2950
Maryland,Eckhart Mines,801,13,376,121,34,14,558
Maryland,Elliott,37,0,21,4,12,0,37
Maryland,Friendship,232,22,60,19,37,27,165
Maryland,Franklin,201,62,96,31,12,0,201
Maryland,Four Corners,8566,527,608,1003,1810,1900,5848
Maryland,Flintstone,152,13,31,33,0,0,77
Maryland,Fishing Creek,248,19,99,38,51,10,217
Maryland,Finzel,659,15,244,107,32,43,441
Maryland,Edesville,195,78,77,0,0,0,155
Maryland,Fairwood,6084,99,294,803,1448,1372,4016
Maryland,Fairplay,558,16,133,200,20,45,414
Maryland,Fairlee,470,73,59,59,55,0,246
Maryland,Ernstville,14,0,0,0,7,7,14
Maryland,Ellerslie,405,16,170,51,21,18,276
Maryland,Edgewater,9689,826,2137,1921,1424,992,7300
Maryland,Edgemont,255,0,57,105,20,31,213
Maryland,Fairview,27,14,13,0,0,0,27
Maryland,Mapleville,254,0,94,62,0,32,188
Maryland,Marlboro Meadows,3487,182,721,844,434,313,2494
Maryland,Marlboro Village,9803,418,1901,2187,1184,870,6560
Maryland,Point of Rocks,1940,57,293,221,424,213,1208
Maryland,Pomfret,683,34,173,207,48,0,462
Maryland,Pondsville,73,21,26,0,0,0,47
Maryland,Potomac Park,848,33,187,285,48,49,602
Maryland,Powellville,78,9,23,37,0,0,69
Maryland,Pylesville,1178,15,215,171,188,79,668
Maryland,Pleasant Grove,438,55,94,107,68,9,333
Maryland,Quantico,192,0,19,17,31,33,100
Maryland,Rawlings,464,36,155,112,34,16,353
Maryland,Reid,44,0,11,0,11,0,22
Maryland,Ringgold,168,14,69,26,10,32,151
Maryland,Rock Point,103,30,8,42,0,0,80
Maryland,Sabillasville,312,43,80,80,12,9,224
Maryland,St. George Island,584,94,123,46,87,12,362
Maryland,Queen Anne,870,29,176,206,134,185,730
Maryland,Sandy Hook,101,0,41,26,0,0,67
Maryland,Piney Point,838,45,218,174,139,116,692
Maryland,Peppermill Village,4628,383,1085,899,615,303,3285
Maryland,Middleburg,19,0,0,19,0,0,19
Maryland,Midlothian,371,18,166,61,22,12,279
Maryland,Monrovia,379,0,21,184,52,44,301
Maryland,Mount Briar,241,16,55,91,20,16,198
Maryland,Mount Savage,798,67,232,278,35,19,631
Maryland,Nanticoke,311,0,100,73,38,44,255
Maryland,Pinesburg,261,12,137,70,17,0,236
Maryland,Nanticoke Acres,20,0,0,20,0,0,20
Maryland,National Harbor,4322,236,695,989,620,648,3188
Maryland,Nikep,19,0,0,19,0,0,19
Maryland,Ocean,0,0,0,0,0,0,0
Maryland,Oldtown,41,0,10,23,0,8,41
Maryland,Oxon Hill,17720,1697,3839,3985,2028,1392,12941
Maryland,Pecktonville,344,30,167,16,12,0,225
Maryland,National,125,0,23,12,15,15,65
Maryland,Savage,6671,268,1108,1391,1029,999,4795
Maryland,Seabrook,18345,1652,3362,3441,2315,1372,12142
Maryland,Shaft,361,7,130,72,51,20,280
Maryland,Woodland,22,9,13,0,0,0,22
Maryland,Wheaton,50459,7516,7069,6922,6650,5733,33890
Maryland,Whitehaven,83,0,30,15,12,0,57
Maryland,Williston,110,0,22,51,23,14,110
Maryland,Worton,53,13,0,21,0,0,34
Maryland,Yarrowsburg,294,0,141,61,44,0,246
Maryland,Westphalia,9040,440,1451,1840,1260,1223,6214
Maryland,Zihlman,315,13,90,74,24,15,216
Maryland,Dunkirk,2449,82,445,572,399,218,1716
Maryland,Huntingtown,3609,44,635,731,416,471,2297
Maryland,Melwood,3656,317,691,855,341,426,2630
Maryland,Scaggsville,9430,340,986,1395,1875,1775,6371
Maryland,Queensland,1823,109,216,271,342,415,1353
Maryland,Mechanicsville,1765,156,399,180,206,140,1081
Maryland,Bensville,13247,354,2279,2734,2230,1451,9048
Maryland,West Denton,116,31,3,0,0,0,34
Maryland,Waterview,18,9,0,9,0,0,18
Maryland,Vale Summit,125,0,85,11,0,0,96
Maryland,Silver Hill,4921,333,1131,1068,514,213,3259
Maryland,Spencerville,2218,59,259,271,430,347,1366
Maryland,Spring Gap,45,17,19,0,0,0,36
Maryland,Spring Ridge,5859,92,665,895,1143,934,3729
Maryland,Suitland,24444,1768,6163,5913,1774,797,16415
Maryland,Summerfield,13781,706,2706,2900,1676,1177,9165
Maryland,Swanton,68,0,29,11,28,0,68
Maryland,Tall Timbers,390,0,12,67,88,164,331
Maryland,Taylors Island,196,10,44,33,22,36,145
Maryland,Tilghmanton,814,82,382,69,15,0,548
Maryland,Timonium,10140,338,1315,1700,2422,1880,7655
Maryland,Tolchester,400,38,169,67,23,33,330
Maryland,Trego-Rohrersville Station,121,0,46,43,0,0,89
Maryland,Tyaskin,170,0,57,53,0,22,132
Maryland,Urbana,11788,204,768,1261,2295,2263,6791
Maryland,Choptank,201,0,43,46,31,0,120
Maryland,Moscow,232,14,131,35,0,0,180
Maryland,Chesapeake Ranch Estates,9732,242,2295,2138,1023,494,6192
Maryland,Cedarville,546,92,173,150,38,10,463
Maryland,Randallstown,34897,1515,6201,8107,5305,3817,24945
Maryland,Barnesville,140,0,22,24,36,21,103
Maryland,Burtonsville,10604,659,1059,1605,1936,1462,6721
Maryland,Fairland,24831,1219,2825,5090,4402,3311,16847
Maryland,North Chevy Chase,558,2,17,40,116,223,398
Maryland,Hillsboro,130,19,40,26,15,2,102
Maryland,Sharptown,815,54,278,147,54,32,565
Maryland,Bladensburg,9397,1096,2238,1770,512,292,5908
Maryland,Landover Hills,1833,372,279,302,143,41,1137
Maryland,Marlow Heights,5869,449,1507,1617,353,216,4142
Maryland,Marlton,9216,223,1436,1991,1597,1079,6326
Maryland,Temple Hills,7864,483,1738,1941,858,336,5356
Maryland,Chester,4573,267,782,1250,766,443,3508
Maryland,Charlton,245,19,66,76,8,0,169
Maryland,Fairmount,318,5,113,56,25,0,199
Maryland,Laurel,25834,1809,3600,4573,4356,3453,17791
Maryland,Hillcrest Heights,16185,1165,4069,3929,1181,841,11185
Maryland,Largo,11604,554,1781,3062,1797,1306,8500
Maryland,West Laurel,4292,202,665,816,773,664,3120
Maryland,Millington,600,110,140,100,38,15,403
Maryland,Queenstown,553,45,116,93,74,84,412
Maryland,Crisfield,2593,388,797,323,113,104,1725
Maryland,Eden,826,148,191,96,31,35,501
Maryland,Mount Vernon,917,24,291,269,38,55,677
Maryland,West Pocomoke,301,35,107,34,77,19,272
Maryland,Owings Mills,34477,1912,4031,5683,6782,4233,22641
Maryland,Dundalk,62768,8500,18024,11410,3517,1945,43396
Maryland,Fruitland,5204,361,932,755,475,379,2902
Maryland,Baltimore,614700,64129,126763,101071,69243,63372,424578
Maryland,District Heights,5975,603,1372,1327,258,350,3910
Maryland,Eagle Harbor,32,1,4,18,0,1,24
Maryland,Oxford,586,3,40,135,167,140,485
Maryland,Keedysville,1154,13,221,292,156,92,774
Maryland,Smithsburg,2964,112,554,689,328,191,1874
Maryland,Newark,297,13,130,56,46,0,245
Maryland,West Ocean City,4319,279,1109,806,728,344,3266
Maryland,Whaleyville,108,34,21,24,0,0,79
Maryland,Woodsboro,1077,85,204,226,134,111,760
Maryland,Accident,244,15,64,45,20,22,166
Maryland,Deer Park,459,30,152,134,5,11,332
Maryland,Leitersburg,434,30,120,140,40,6,336
Maryland,Federalsburg,2665,371,609,357,80,94,1511
Maryland,Chesapeake Beach,5922,201,1013,1315,653,612,3794
Maryland,Eldorado,41,4,17,6,1,0,28
Maryland,Betterton,385,12,79,51,76,34,252
Maryland,Westminster,18553,1475,3097,3036,2576,1305,11489
Maryland,Frostburg,8626,281,1390,1137,417,708,3933
Maryland,Port Tobacco Village,4,0,0,0,3,1,4
Maryland,Olney,35280,1362,2452,5258,7431,7608,24111
Maryland,North Potomac,24148,361,1249,1911,5032,7764,16317
Maryland,Rock Hall,1361,85,355,265,150,110,965
Maryland,Secretary,439,36,172,67,33,14,322
Maryland,Perryman,2712,399,625,580,204,79,1887
Maryland,Columbia,103663,3154,8953,14893,22477,22038,71515
Maryland,Pleasant Hills,3765,140,732,563,769,459,2663
Maryland,Sharpsburg,806,48,256,186,62,37,589
Maryland,Greensboro,2476,293,627,359,112,37,1428
Maryland,Church Hill,838,73,188,143,94,52,550
Maryland,Owings,2569,56,301,549,448,252,1606
Maryland,Bakersville,52,23,0,7,0,0,30
Maryland,Baltimore Highlands,7959,1043,2270,1012,466,222,5013
Maryland,Barrelville,47,9,24,2,0,0,35
Maryland,Bartonsville,1712,144,238,263,269,166,1080
Maryland,Beaver Creek,356,0,42,49,68,82,241
Maryland,Bel Air,1524,48,385,243,217,80,973
Maryland,Benedict,358,0,205,108,45,0,358
Maryland,Bier,149,13,66,56,0,0,135
Maryland,Big Pool,56,0,32,0,8,0,40
Maryland,Big Spring,90,6,14,12,12,11,55
Maryland,Bishopville,766,85,162,141,130,0,518
Maryland,Ridgely,1558,172,384,312,107,59,1034
Maryland,Bloomington,216,18,142,15,8,8,191
Maryland,Bowling Green,1198,37,344,352,77,38,848
Maryland,Bowmans Addition,568,0,181,140,61,12,394
Maryland,Breathedsville,103,0,42,40,0,0,82
Maryland,Brock Hall,11664,269,1239,2337,2081,2026,7952
Maryland,Broomes Island,329,12,109,119,0,24,264
Maryland,Brownsville,41,0,13,12,0,0,25
Maryland,Bryantown,644,10,195,72,116,81,474
Maryland,Buckeystown,1318,51,198,244,248,328,1069
Maryland,Butlertown,362,18,84,97,12,24,235
Maryland,Calvert Beach,972,52,175,171,105,51,554
Maryland,Carlos,80,0,51,0,0,0,51
Maryland,Cearfoss,106,0,89,0,0,0,89
Maryland,Bagtown,279,0,99,104,25,9,237
Maryland,Baden,1712,139,472,385,237,131,1364
Maryland,Bivalve,387,18,102,106,0,0,226
Maryland,Aquasco,825,137,238,205,96,12,688
Maryland,Arden on the Severn,1953,38,364,421,283,327,1433
Maryland,Andrews AFB,2964,8,192,623,333,223,1379
Maryland,Beltsville,17589,1919,2694,3077,2582,1452,11724
Maryland,Capitol Heights,4512,562,1028,907,303,173,2973
Maryland,College Park,32183,2108,2063,2460,2802,2995,12428
Maryland,East Riverdale,15467,3580,2533,1611,870,468,9062
Maryland,Kettering,13637,415,2265,3343,2287,1969,10279
Maryland,Mitchellville,11215,301,1447,2561,1906,1553,7768
Maryland,White Oak,19010,1768,2491,2820,3136,2519,12734
Maryland,Pikesville,33387,911,3595,4271,7786,7648,24211
Maryland,Colesville,13894,915,1326,2414,2710,2901,10266
Maryland,Rockville,67062,3396,4923,8579,13140,17372,47410
Maryland,Maugansville,3122,315,740,575,259,169,2058
Maryland,Mercersville,115,15,15,25,16,18,89
Maryland,Luke,109,8,30,31,3,2,74
Maryland,Barton,433,22,160,91,5,6,284
Maryland,Annapolis Neck,11590,232,935,1868,3564,2336,8935
Maryland,Allen,384,0,0,108,100,40,248
Maryland,Charlotte Hall,2026,247,553,305,98,55,1258
Maryland,Chewsville,394,9,130,68,40,21,268
Maryland,Herald Harbor,2615,64,221,587,660,325,1857
Maryland,Antietam,76,0,43,9,17,0,69
Maryland,University Park,2641,68,143,187,565,881,1844
Maryland,Greenbelt,23203,1601,2540,3924,3806,3666,15537
Maryland,Laytonsville,367,16,45,53,78,66,258
Maryland,Chestertown,5113,453,656,760,660,662,3191
Maryland,Hebron,1218,74,286,230,107,64,761
Maryland,Adamstown,2263,11,262,400,337,390,1400
Massachusetts,Hudson,15508,1203,3282,2523,2589,1818,11415
Massachusetts,Littleton Common,3402,63,645,507,626,572,2413
Massachusetts,Reading,25100,541,2782,3404,5776,5179,17682
Massachusetts,East Brookfield,1124,77,258,253,125,80,793
Massachusetts,Mashpee Neck,988,9,115,219,220,111,674
Massachusetts,Oxford,5662,263,1517,1235,811,297,4123
Massachusetts,North Falmouth,2698,30,438,417,726,625,2236
Massachusetts,Woods Hole,883,15,63,67,322,265,732
Massachusetts,Millers Falls,1239,95,348,285,93,60,881
Massachusetts,Townsend,1372,92,338,315,95,72,912
Massachusetts,Fiskdale,3166,54,521,619,629,331,2154
Massachusetts,Holyoke,40376,5662,7953,6849,3773,2471,26708
Massachusetts,Yarmouth Port,5045,123,729,1187,1287,953,4279
Massachusetts,Waltham,62979,3308,8651,8112,12339,10084,42494
Massachusetts,Somerville,80434,5436,8769,7268,20021,18201,59695
Massachusetts,Shirley,1782,53,778,342,240,31,1444
Massachusetts,Hopkinton,2844,170,414,347,637,391,1959
Massachusetts,Boston,679413,63572,93672,83135,123615,103092,467086
Massachusetts,West Dennis,2179,111,479,504,471,313,1878
Massachusetts,Falmouth,3508,223,648,687,795,703,3056
Massachusetts,Medford,57771,3127,8863,7896,11084,11164,42134
Massachusetts,East Pepperell,1592,61,352,472,219,171,1275
Massachusetts,Sandwich,2866,91,355,574,731,501,2252
Massachusetts,North Plymouth,3787,317,1051,803,462,134,2767
Massachusetts,Hanscom AFB,2048,1,105,315,265,298,984
Massachusetts,Woburn,40298,1721,7423,6957,7920,5130,29151
Massachusetts,Edgartown,422,14,124,165,49,44,396
Massachusetts,Chelsea,39852,7938,8783,4961,2916,1674,26272
Massachusetts,Monument Beach,2984,68,717,749,448,333,2315
Massachusetts,Holbrook,11036,366,2302,2994,1175,811,7648
Massachusetts,Norwood,29201,1131,4757,5340,6621,3549,21398
Massachusetts,East Falmouth,5782,560,1155,1254,634,812,4415
Massachusetts,Harwich Center,1511,14,243,250,435,232,1174
Massachusetts,Monomoscoy Island,112,8,23,17,8,31,87
Massachusetts,Seabrook,445,0,75,91,162,72,400
Massachusetts,Seconsett Island,17,0,0,17,0,0,17
Massachusetts,West Chatham,1272,60,177,239,241,291,1008
Massachusetts,South Deerfield,1859,65,181,447,240,433,1366
Massachusetts,Holland,1365,85,294,360,147,132,1018
Massachusetts,Mansfield Center,7892,116,1219,1529,1383,1443,5690
Massachusetts,Bellingham,4652,137,963,1251,571,474,3396
Massachusetts,Arlington,45147,1115,4039,4442,10137,13444,33177
Massachusetts,Middleborough Center,7333,305,1918,1664,1011,439,5337
Massachusetts,Marlborough,39776,2064,7779,7220,6873,4744,28680
Massachusetts,White Island Shores,2322,106,960,354,111,73,1604
Massachusetts,Ayer,2604,18,430,494,673,354,1969
Massachusetts,Belmont,26043,637,1786,2437,4390,8691,17941
Massachusetts,Cochituate,6942,93,270,547,1792,1984,4686
Massachusetts,Maynard,10600,338,1550,1847,2083,2027,7845
Massachusetts,Newton,88660,1591,5165,6262,16997,27929,57944
Massachusetts,Stoneham,22144,981,4163,4151,4414,3061,16770
Massachusetts,West Concord,7402,477,1072,761,1412,1900,5622
Massachusetts,Norton Center,2879,34,240,216,251,201,942
Massachusetts,Acushnet Center,3136,272,1036,565,235,132,2240
Massachusetts,Monson Center,1811,65,512,459,187,145,1368
Massachusetts,Amherst Center,20253,230,535,516,1038,1537,3856
Massachusetts,Winchester,22677,253,1705,1704,4526,6941,15129
Massachusetts,Hull,10424,299,2064,2268,2334,1439,8404
Massachusetts,Dennis Port,3373,75,839,780,472,315,2481
Massachusetts,Northwest Harwich,4033,115,713,959,709,581,3077
Massachusetts,Foxborough,5912,556,877,1136,1098,841,4508
Massachusetts,South Yarmouth,11624,467,2999,2899,1469,1092,8926
Massachusetts,Pepperell,2573,180,603,488,354,130,1755
Massachusetts,Shelburne Falls,1756,155,297,438,310,224,1424
Massachusetts,Burlington,27059,797,4023,4015,6019,4686,19540
Massachusetts,Dennis,2360,139,418,483,460,619,2119
Massachusetts,Webster,11769,1387,3015,2381,1048,420,8251
Massachusetts,Andover,9217,215,520,1050,1960,2265,6010
Massachusetts,Ocean Grove,2963,184,900,732,169,171,2156
Massachusetts,Needham,30735,458,2149,2362,6188,9093,20250
Massachusetts,Quincy,94121,8301,16951,14691,19815,12429,72187
Massachusetts,Abington,16330,582,3021,3524,3118,1199,11444
Massachusetts,Kingston,6205,161,1269,1059,1215,631,4335
Massachusetts,Mattapoisett Center,3594,40,523,756,719,593,2631
Massachusetts,South Duxbury,3613,29,222,292,1007,840,2390
Massachusetts,Wareham Center,3690,224,859,1060,179,238,2560
Massachusetts,Cambridge,115665,3802,6806,7041,22356,38012,78017
Massachusetts,Pinehurst,7275,434,1677,1448,1053,541,5153
Massachusetts,Bourne,1169,0,245,239,205,236,925
Massachusetts,Buzzards Bay,3431,156,948,611,514,265,2494
Massachusetts,Belchertown,2841,179,525,542,319,458,2023
Massachusetts,Salem,43302,2811,7892,7333,7425,4826,30287
Massachusetts,Haverhill,63280,4505,12999,12901,8765,4221,43391
Massachusetts,Agawam Town,28744,1576,6322,6636,4511,2683,21728
Massachusetts,Orange,3837,276,1252,797,342,157,2824
Massachusetts,Weymouth Town,56384,2793,11558,11879,10280,4815,41325
Massachusetts,Bliss Corner,5137,899,1309,832,548,574,4162
Massachusetts,North Eastham,1548,43,257,340,285,354,1279
Massachusetts,Chatham,1480,41,174,284,583,193,1275
Massachusetts,South Ashburnham,917,43,145,259,131,55,633
Massachusetts,East Douglas,2908,74,651,580,554,99,1958
Massachusetts,Topsfield,3362,76,254,381,716,785,2212
Massachusetts,Fall River,89339,16715,20683,15650,6417,2982,62447
Massachusetts,Swampscott,14755,318,1866,2311,3136,2738,10369
Massachusetts,Peabody,52865,3859,12302,9782,8650,4313,38906
Massachusetts,Marblehead,20488,325,1278,2749,5717,4742,14811
Massachusetts,Wakefield,26960,1362,4078,4341,6234,4120,20135
Massachusetts,Lowell,111249,14234,24342,16437,9645,6785,71443
Massachusetts,Everett,45856,5781,10640,7804,3995,2182,30402
Massachusetts,Onset,824,65,195,283,86,14,643
Massachusetts,North Pembroke,3255,60,567,450,849,278,2204
Massachusetts,Warren,812,0,382,175,51,33,641
Massachusetts,North Brookfield,2269,131,732,367,204,146,1580
Massachusetts,Gardner,20555,1681,5445,4840,1798,1004,14768
Massachusetts,Newburyport,17990,387,2007,2766,4614,3801,13575
Massachusetts,Framingham,71649,4919,12210,9910,14131,10243,51413
Massachusetts,Winthrop Town,18535,728,4525,3747,3365,1862,14227
Massachusetts,Longmeadow,15830,448,1485,1869,3458,3672,10932
Massachusetts,North Seekonk,2534,160,572,539,536,166,1973
Massachusetts,North Westport,4515,719,787,932,648,274,3360
Massachusetts,South Amherst,5527,120,305,454,727,697,2303
Massachusetts,Amesbury Town,17378,749,3231,3273,3078,2032,12363
Massachusetts,Blandford,310,29,92,51,40,46,258
Massachusetts,Braintree Town,37207,1534,6901,6613,7050,4311,26409
Massachusetts,Brookfield,752,43,158,228,117,59,605
Massachusetts,Cheshire,628,32,79,158,106,0,375
Massachusetts,Chester,795,57,261,183,56,27,584
Massachusetts,Deerfield,677,8,9,44,233,94,388
Massachusetts,Devens,1913,56,486,587,284,200,1613
Massachusetts,Easthampton Town,16023,623,3718,3692,2822,1748,12603
Massachusetts,Franklin Town,33022,598,4005,4783,7085,4991,21462
Massachusetts,Greenfield Town,17468,994,3673,4014,2544,1830,13055
Massachusetts,Barnstable Town,44314,1919,9165,9823,7233,5360,33500
Massachusetts,Huntington,654,55,155,226,52,22,510
Massachusetts,Methuen Town,50019,4204,10162,9941,6000,3730,34037
Massachusetts,Palmer Town,12251,686,3135,2969,1662,559,9011
Massachusetts,Petersham,249,0,52,62,30,56,200
Massachusetts,Russell,428,13,165,109,26,27,340
Massachusetts,Siasconset,96,0,17,18,26,24,85
Massachusetts,Southbridge Town,16894,2161,4083,3529,1274,664,11711
Massachusetts,Southfield,0,0,0,0,0,0,0
Massachusetts,The Pinehills,1350,18,120,256,540,361,1295
Massachusetts,Watertown Town,35103,1419,4335,4145,8769,8777,27445
Massachusetts,West Springfield Town,28666,2148,5058,6021,3737,2752,19716
Massachusetts,Harwich Port,1739,23,273,378,442,424,1540
Massachusetts,Madaket,276,0,65,47,127,31,270
Massachusetts,Williamstown,4446,102,142,232,344,725,1545
Massachusetts,Upton,2529,65,502,438,577,277,1859
Massachusetts,Brookline,59234,1211,2104,3287,12323,21606,40531
Massachusetts,Lexington,33480,388,1625,2058,6449,12466,22986
Massachusetts,Malden,61094,5907,12508,9415,9409,6480,43719
Massachusetts,Melrose,28116,961,3228,4251,6213,5639,20292
Massachusetts,Lenox,1998,65,453,330,500,296,1644
Massachusetts,Beverly,41731,1636,6497,6556,8739,5658,29086
Massachusetts,Lynn,93617,13451,19999,16354,8004,3338,61146
Massachusetts,Lynnfield,12847,202,1521,1979,2770,2247,8719
Massachusetts,Rockport,5245,108,878,940,1315,943,4184
Massachusetts,Barre,1068,18,289,253,75,223,858
Massachusetts,Leominster,41579,4054,8027,8433,5838,2897,29249
Massachusetts,Worcester,185195,18693,35851,30054,22310,14128,121036
Massachusetts,Wilmington,23658,734,4647,4024,4063,3038,16506
Massachusetts,Pittsfield,43058,3141,9544,9889,5470,3370,31414
Massachusetts,Housatonic,656,71,162,138,96,28,495
Massachusetts,Lee,1841,159,324,525,162,209,1379
Massachusetts,Granby,1318,105,264,211,331,171,1082
Massachusetts,Athol,8412,787,2318,1781,659,266,5811
Massachusetts,Boxford,2744,65,226,493,637,467,1888
Massachusetts,Gloucester,30049,2093,6117,5843,5428,3624,23105
Massachusetts,Saugus,28158,1648,7852,5444,3988,1890,20822
Massachusetts,Northborough,6171,241,690,1004,1347,1061,4343
Massachusetts,Rutland,2121,21,570,442,448,153,1634
Massachusetts,Westborough,3986,89,628,529,1010,624,2880
Massachusetts,Marion Center,1070,18,208,139,286,165,816
Massachusetts,West Brookfield,1330,111,482,170,250,36,1049
Massachusetts,Hanson,1640,23,432,336,238,169,1198
Massachusetts,Dover,2533,18,135,201,407,839,1600
Massachusetts,Vineyard Haven,1887,137,421,373,191,259,1381
Massachusetts,Revere,53966,6938,15770,8254,5381,2922,39265
Massachusetts,South Dennis,3684,127,1026,873,607,283,2916
Massachusetts,North Amherst,6891,98,246,333,522,1171,2370
Massachusetts,Ware,5907,459,1720,1224,572,237,4212
Massachusetts,Millis-Clicquot,4350,116,652,732,849,584,2933
Massachusetts,Wellesley,29201,307,948,1442,5654,7888,16239
Massachusetts,Marshfield Hills,2337,87,107,493,624,351,1662
Massachusetts,Groton,1147,85,68,240,144,245,782
Massachusetts,Plymouth,7122,410,1873,1591,986,617,5477
Massachusetts,Forestdale,4403,94,796,1389,551,330,3160
Massachusetts,Popponesset,184,0,8,24,109,17,158
Massachusetts,Popponesset Island,8,0,0,0,0,8,8
Massachusetts,Provincetown,2628,154,407,678,664,522,2425
Massachusetts,Sagamore,3673,50,645,1002,615,341,2653
Massachusetts,West Falmouth,1835,0,70,328,398,387,1183
Massachusetts,West Yarmouth,5271,340,1064,1332,866,573,4175
Massachusetts,Northfield,1237,45,201,245,160,295,946
Massachusetts,Westfield,41599,2545,7670,7800,5691,3087,26793
Massachusetts,Attleboro,44548,3285,9016,9026,7035,3160,31522
Massachusetts,Duxbury,1668,24,9,232,425,510,1200
Massachusetts,New Bedford,95117,16177,22120,15394,7409,3659,64759
Massachusetts,Nantucket,8034,338,1142,1531,1518,1245,5774
Massachusetts,Bridgewater,9255,145,921,1163,827,491,3547
Massachusetts,Green Harbor-Cedar Crest,2565,153,506,567,537,208,1971
Massachusetts,North Adams,13089,1458,3084,2033,1334,869,8778
Massachusetts,North Scituate,4804,63,308,645,1344,905,3265
Massachusetts,Sharon,5655,68,290,627,1151,1506,3642
Massachusetts,Walpole,6401,317,1033,1094,1272,714,4430
Massachusetts,Brockton,95426,11303,21056,18455,8031,3438,62283
Massachusetts,Marshfield,4976,108,555,881,1312,387,3243
Massachusetts,Weweantic,1880,73,607,344,199,117,1340
Massachusetts,Brewster,1757,0,250,367,605,373,1595
Massachusetts,East Dennis,2366,66,458,522,579,455,2080
Massachusetts,East Harwich,4859,120,797,1009,1070,882,3878
Massachusetts,East Sandwich,3478,49,353,663,924,694,2683
Massachusetts,New Seabury,774,0,83,170,250,188,691
Massachusetts,Pocasset,3069,41,568,914,572,383,2478
Massachusetts,Raynham Center,4522,199,693,992,663,584,3131
Massachusetts,Randolph,33924,3430,7191,6956,4464,2085,24126
Massachusetts,Somerset,18207,1585,4315,4451,2513,1074,13938
Massachusetts,Northampton,28568,1228,3231,3614,4901,6146,19120
Massachusetts,Turners Falls,4100,304,993,935,479,311,3022
Massachusetts,Medfield,6776,106,482,796,1619,1374,4377
Massachusetts,Milton,27568,843,2382,3667,5477,5281,17650
Massachusetts,Hingham,6290,68,328,593,1580,1356,3925
Massachusetts,Chicopee,55661,5892,13111,12822,4646,2654,39125
Massachusetts,Springfield,154596,21539,29905,26055,10969,6798,95266
Massachusetts,Teaticket,1597,22,332,352,315,283,1304
Massachusetts,Smith Mills,4717,500,1220,820,607,361,3508
Massachusetts,Dedham,25377,1044,3906,4112,5061,4498,18621
Massachusetts,Orleans,1867,38,420,524,360,298,1640
Massachusetts,Wilbraham,3385,252,451,483,564,678,2428
Massachusetts,Taunton,56963,6264,13012,12000,6074,2538,39888
Massachusetts,North Lakeville,2936,161,650,577,425,344,2157
Massachusetts,Hatfield,1352,8,440,327,222,114,1111
Massachusetts,Cordaville,2905,38,262,267,597,630,1794
Massachusetts,Salisbury,4927,193,1223,959,1053,478,3906
Massachusetts,Fitchburg,40737,4512,9089,7218,3727,1816,26362
Massachusetts,Hopedale,3488,127,491,796,868,267,2549
Massachusetts,Rowley,1628,18,450,276,310,194,1248
Massachusetts,Lunenburg,2023,78,449,428,383,143,1481
Massachusetts,Essex,1376,9,159,261,276,303,1008
Massachusetts,Spencer,5705,522,1857,1456,454,147,4436
Massachusetts,Danvers,27631,1102,4918,5573,5133,3302,20028
Massachusetts,Sturbridge,2169,2,238,503,537,233,1513
Massachusetts,Winchendon,3662,355,1093,630,325,240,2643
Massachusetts,Whitinsville,6941,325,1365,1547,1046,319,4602
Massachusetts,South Lancaster,1588,99,248,357,486,141,1331
Massachusetts,Milford,25656,1880,4908,4740,3933,2324,17785
Massachusetts,Nahant,3495,80,569,604,857,723,2833
Massachusetts,Lawrence,79841,16183,15497,11986,3551,1551,48768
Massachusetts,Ipswich,4384,175,854,684,848,696,3257
Massachusetts,Great Barrington,2492,146,718,336,205,456,1861
Massachusetts,Adams,5572,410,1754,1088,539,387,4178
Massachusetts,West Wareham,2173,306,643,566,205,72,1792
Massachusetts,Scituate,5482,237,766,1298,992,803,4096
Massachusetts,Ocean Bluff-Brant Rock,5190,99,801,1364,875,564,3703
Massachusetts,Clinton,7181,569,1601,1358,1140,352,5020
Massachusetts,Baldwinville,1894,131,475,393,221,108,1328
Michigan,Central Lake,969,46,268,284,85,53,736
Michigan,Bridgeport,6443,829,1878,1402,465,144,4718
Michigan,Ellsworth,357,25,97,91,32,8,253
Michigan,Sault Ste. Marie,13712,825,2422,2976,1537,626,8386
Michigan,Pellston,822,28,241,197,49,22,537
Michigan,Brooklyn,1160,105,302,245,116,60,828
Michigan,Grosse Pointe,5218,103,239,698,1385,1140,3565
Michigan,Durand,3317,373,958,916,149,71,2467
Michigan,Mendon,918,43,159,268,48,60,578
Michigan,Vandercook Lake,4781,147,1074,1317,370,137,3045
Michigan,Garden City,26809,2263,7321,7202,1536,617,18939
Michigan,Grosse Pointe Park,11207,115,684,1783,2574,2857,8013
Michigan,Clawson,12029,449,2225,3083,2240,1292,9289
Michigan,Farmington Hills,81482,2972,8849,15946,17440,14710,59917
Michigan,Schoolcraft,1357,35,329,322,176,54,916
Michigan,Colon,1243,143,286,247,77,36,789
Michigan,Evart,1587,117,585,270,55,56,1083
Michigan,Bronson,2378,256,724,428,64,37,1509
Michigan,Grass Lake,1227,27,258,311,137,60,793
Michigan,Dowling,353,11,105,140,7,3,266
Michigan,Rose City,586,97,130,168,19,6,420
Michigan,Caberfae,30,1,7,4,6,0,18
Michigan,Carp Lake,410,39,119,91,47,27,323
Michigan,Cedar,95,0,8,7,22,8,45
Michigan,Chums Corner,1150,0,266,143,191,119,719
Michigan,Conway,205,19,22,98,12,4,155
Michigan,Copper Harbor,71,1,8,30,14,14,67
Michigan,Cross Village,87,1,21,28,18,4,72
Michigan,Crystal Downs Country Club,82,0,2,8,41,31,82
Michigan,Brutus,132,11,27,25,7,12,82
Michigan,Crystal Mountain,64,0,2,22,11,24,59
Michigan,Dollar Bay,955,21,187,167,108,27,510
Michigan,Howard City,1643,142,457,288,95,14,996
Michigan,Eagle Harbor,100,4,9,19,44,17,93
Michigan,Eagle River,84,1,15,37,13,9,75
Michigan,Eastport,207,16,43,78,28,8,173
Michigan,Filer City,81,0,55,17,0,0,72
Michigan,Fostoria,606,67,159,186,18,0,430
Michigan,Glen Arbor,133,0,14,36,67,11,128
Michigan,Delton,915,83,154,351,77,68,733
Michigan,Brethren,441,55,132,60,27,7,281
Michigan,Boon,235,11,78,49,5,6,149
Michigan,Bendon,186,6,73,23,22,7,131
Michigan,Skidway Lake,3426,584,896,723,71,69,2343
Michigan,West Branch,2256,275,672,544,135,84,1710
Michigan,Comstock Park,10374,641,1803,2625,1465,399,6933
Michigan,Cutlerville,16623,1320,3920,3304,1696,757,10997
Michigan,East Grand Rapids,11642,139,319,1146,3110,2847,7561
Michigan,DeWitt,4667,123,547,886,915,700,3171
Michigan,Lake Isabella,2112,88,395,553,292,235,1563
Michigan,Douglas,953,77,200,138,232,148,795
Michigan,Chelsea,5295,169,586,1193,1088,720,3756
Michigan,Advance,323,6,45,137,37,73,298
Michigan,Alba,332,6,137,83,7,0,233
Michigan,Alden,92,12,29,14,14,16,85
Michigan,Amasa,262,19,84,70,17,0,190
Michigan,Arcadia,271,20,61,97,39,18,235
Michigan,Attica,740,64,231,205,41,9,550
Michigan,Bath,2213,62,419,578,370,187,1616
Michigan,Bay Port,434,46,162,71,41,32,352
Michigan,Bay View,226,0,21,57,23,72,173
Michigan,Bear Lake,396,43,114,96,43,22,318
Michigan,Tustin,237,30,73,43,20,6,172
Michigan,Coleman,1406,134,430,249,67,41,921
Michigan,Fairgrove,572,16,141,169,33,6,365
Michigan,Frankfort,1108,83,334,257,185,133,992
Michigan,Three Oaks,1463,58,358,382,134,81,1013
Michigan,Zilwaukee,1650,65,418,464,71,52,1070
Michigan,Baraga,2306,314,963,337,79,15,1708
Michigan,McBride,193,19,62,33,9,0,123
Michigan,Harper Woods,13959,981,2810,3347,1231,932,9301
Michigan,Southfield,73392,4130,10085,18805,11223,8977,53220
Michigan,Gladwin,2883,182,709,689,197,132,1909
Michigan,Metamora,630,29,106,187,60,30,412
Michigan,White Pigeon,1449,94,407,345,69,19,934
Michigan,Sterling,606,52,161,170,20,14,417
Michigan,Traverse City,15474,380,2183,3760,3086,2054,11463
Michigan,Clarksville,417,16,103,101,46,17,283
Michigan,Ionia,11187,1207,3508,2043,705,256,7719
Michigan,Mount Pleasant,25691,922,2166,2842,2323,2452,10705
Michigan,Shepherd,1492,62,362,376,196,100,1096
Michigan,Canadian Lakes,2925,75,668,849,545,397,2534
Michigan,Madison Heights,30226,3106,6816,6793,3371,1532,21618
Michigan,Britton,643,32,186,148,48,9,423
Michigan,Clayton,339,41,104,55,6,5,211
Michigan,Prescott,192,18,74,34,13,3,142
Michigan,Level Park-Oak Park,3769,157,926,1274,243,164,2764
Michigan,Algonac,4040,257,1155,1084,341,133,2970
Michigan,Lincoln,364,25,103,93,12,12,245
Michigan,Grawn,1225,144,130,183,36,23,516
Michigan,Sterling Heights,132470,12532,26272,28165,17184,9269,93422
Michigan,Onaway,782,74,253,196,30,2,555
Michigan,Berrien Springs,1590,104,247,308,212,150,1021
Michigan,Niles,11265,1053,2513,2455,652,343,7016
Michigan,Boyne Falls,423,32,107,94,30,19,282
Michigan,Charlevoix,2364,94,437,611,420,214,1776
Michigan,Watervliet,1663,135,430,404,94,39,1102
Michigan,Indian River,1879,138,468,503,307,184,1600
Michigan,Onsted,1005,42,190,308,71,50,661
Michigan,Wolverine,247,12,86,55,7,5,165
Michigan,Wayland,4190,258,884,930,423,148,2643
Michigan,Crystal Falls,1701,135,471,391,136,62,1195
Michigan,Westwood,9280,159,907,1859,1835,1087,5847
Michigan,Caledonia,1657,24,255,350,268,101,998
Michigan,Cedar Springs,3651,328,960,706,343,55,2392
Michigan,Sparta,4332,278,1157,1010,340,123,2908
Michigan,Walker,24768,944,4347,5877,3858,1550,16576
Michigan,Yale,2010,173,536,490,82,61,1342
Michigan,Carney,202,30,54,45,18,0,147
Michigan,Otsego,3976,420,986,868,250,223,2747
Michigan,Ironwood,4999,285,1397,1299,593,237,3811
Michigan,Alpena,10086,578,2299,2996,855,468,7196
Michigan,Fennville,1949,234,457,339,72,21,1123
Michigan,Woodland Beach,2049,43,602,392,124,18,1179
Michigan,Farwell,853,122,258,166,28,23,597
Michigan,Breedsville,177,23,69,33,9,0,134
Michigan,Hartford,2605,388,647,432,68,25,1560
Michigan,South Haven,4341,257,845,1078,637,546,3363
Michigan,Pearl Beach,2996,270,759,977,233,263,2502
Michigan,Newaygo,1928,137,444,425,109,34,1149
Michigan,Byron Center,6710,319,972,1254,1201,469,4215
Michigan,Forest Hills,27947,412,2103,3995,7125,5148,18783
Michigan,Richmond,5874,350,1328,1465,512,194,3849
Michigan,St. Clair,5350,230,1095,1455,552,430,3762
Michigan,Powers,441,45,164,120,31,7,367
Michigan,Center Line,8303,834,2019,2148,497,292,5790
Michigan,Romeo,3916,453,693,850,616,274,2886
Michigan,Robin Glen-Indiantown,835,68,211,196,49,6,530
Michigan,Au Gres,830,81,308,211,42,34,676
Michigan,Omer,322,26,99,91,4,6,226
Michigan,Beaverton,1438,114,370,316,42,45,887
Michigan,Breckenridge,1243,71,385,252,72,37,817
Michigan,Houghton,7934,110,578,551,711,850,2800
Michigan,Three Rivers,7680,475,1912,1616,401,194,4598
Michigan,Otter Lake,380,44,88,103,7,18,260
Michigan,Flint,97161,9299,21946,22795,5096,2285,61421
Michigan,Hopkins,756,22,157,152,61,12,404
Michigan,Albion,8324,686,1740,1393,389,381,4589
Michigan,Beecher,9128,1186,1887,1953,314,176,5516
Michigan,Burton,28754,2388,6696,7156,2219,896,19355
Michigan,Pleasant Ridge,2389,33,98,398,708,598,1835
Michigan,Gaylord,3667,186,887,832,404,164,2473
Michigan,Nashville,1728,199,423,383,86,34,1125
Michigan,Edwardsburg,1200,87,268,214,82,23,674
Michigan,Marcellus,1171,70,303,253,82,31,739
Michigan,Ossineke,926,58,262,244,54,54,672
Michigan,Vandalia,398,46,87,85,5,8,231
Michigan,Mason,8447,343,1535,2110,1178,651,5817
Michigan,Stony Point,1695,96,305,608,78,113,1200
Michigan,Brown City,1192,123,326,257,52,25,783
Michigan,Fruitport,1361,20,298,382,120,94,914
Michigan,Montague,2493,70,633,647,248,103,1701
Michigan,Ravenna,1238,64,340,288,119,31,842
Michigan,Roosevelt Park,3806,131,788,983,560,144,2606
Michigan,Wolverine Lake,4582,256,763,1111,944,299,3373
Michigan,Fenton,11336,502,2473,2830,1358,1000,8163
Michigan,Lake Linden,1078,72,252,239,110,60,733
Michigan,Hardwood Acres,423,0,60,45,121,15,241
Michigan,Port Huron,29175,2175,6788,7277,1893,1060,19193
Michigan,Henderson,327,40,63,85,20,24,232
Michigan,Manchester,2037,64,373,561,335,166,1499
Michigan,Ypsilanti,20939,783,1338,3516,2201,1790,9628
Michigan,Ecorse,9372,1416,2381,1883,415,153,6248
Michigan,Hamtramck,21941,3780,4541,2553,1023,533,12430
Michigan,Beverly Hills,10440,93,681,1332,2755,2493,7354
Michigan,Birmingham,21066,243,980,2296,5540,5837,14896
Michigan,Lake Orion,3131,98,540,778,603,317,2336
Michigan,Milford,6484,150,874,1393,1316,732,4465
Michigan,Novi,59625,1674,5554,8893,13331,11265,40717
Michigan,Oxford,3553,61,554,870,571,342,2398
Michigan,Kingston,405,32,128,79,19,17,275
Michigan,Middleville,3397,72,871,653,342,89,2027
Michigan,Dowagiac,5779,709,1022,1660,257,111,3759
Michigan,Litchfield,1291,95,335,317,62,27,836
Michigan,Reading,1090,110,271,256,51,22,710
Michigan,Waldron,494,43,206,79,21,3,352
Michigan,Hancock,4577,298,1009,641,633,539,3120
Michigan,Williamston,3930,95,480,923,666,450,2614
Michigan,Lambertville,9394,349,1798,2426,1222,775,6570
Michigan,Middletown,799,112,175,285,11,18,601
Michigan,Maybee,667,30,141,153,65,18,407
Michigan,Lennon,541,27,136,129,36,11,339
Michigan,Byron,480,23,142,107,39,10,321
Michigan,Augusta,918,47,222,248,63,44,624
Michigan,South Lyon,11786,616,1728,2595,2288,1054,8281
Michigan,Climax,759,11,177,207,102,25,522
Michigan,Camden,700,70,196,106,15,3,390
Michigan,Laurium,2179,109,370,530,282,132,1423
Michigan,Edgemont Park,2287,33,424,758,313,114,1642
Michigan,Lansing,116699,8079,19576,27411,12613,7273,74952
Michigan,Walled Lake,7193,490,1341,1920,1029,632,5412
Michigan,Goodrich,1941,57,324,430,276,171,1258
Michigan,Lake Fenton,5331,160,928,1284,1122,495,3989
Michigan,Standish,1529,169,401,395,71,45,1081
Michigan,Twining,201,23,52,30,2,0,107
Michigan,Greenville,8394,704,1696,2253,502,272,5427
Michigan,Allegan,5044,302,1217,895,292,206,2912
Michigan,Plainwell,3802,242,844,1092,310,243,2731
Michigan,Marshall,7021,338,1402,1590,1019,742,5091
Michigan,Tekonsha,684,50,220,162,18,12,462
Michigan,Benton Heights,4263,829,638,589,104,67,2227
Michigan,Manistique,2941,284,945,620,198,48,2095
Michigan,Milan,5944,176,1123,1481,689,339,3808
Michigan,Petersburg,1194,44,315,299,68,56,782
Michigan,North Muskegon,3789,56,385,915,879,418,2653
Michigan,Hesperia,889,54,217,257,45,20,593
Michigan,Eaton Rapids,5216,409,1092,1493,256,215,3465
Michigan,Coopersville,4386,200,896,1006,379,134,2615
Michigan,Centreville,1397,100,498,315,66,59,1038
Michigan,Sturgis,10855,1140,2692,2279,373,259,6743
Michigan,Holland,33503,2153,5505,5638,3830,2445,19571
Michigan,Norton Shores,24357,1060,4469,6306,3353,1831,17019
Michigan,Harvey,1612,88,416,203,262,81,1050
Michigan,Leslie,1995,99,457,510,129,56,1251
Michigan,Palmer,486,17,151,137,36,2,343
Michigan,St. Helen,2681,358,1011,616,112,27,2124
Michigan,Forestville,77,12,22,25,1,6,66
Michigan,Okemos,23912,308,1090,2451,4439,6188,14476
Michigan,Detroit Beach,2021,41,680,501,121,75,1418
Michigan,Twin Lake,1751,15,493,538,102,143,1291
Michigan,Spring Lake,2563,73,348,788,462,201,1872
Michigan,Posen,223,18,64,69,10,2,163
Michigan,Westland,82120,6227,19175,20906,8476,3719,58503
Michigan,Lake City,883,50,210,190,49,57,556
Michigan,Marion,798,69,217,182,58,23,549
Michigan,Taylor,61574,5890,17067,14210,3615,1116,41898
Michigan,Riverview,12167,985,3112,3403,1095,479,9074
Michigan,Houghton Lake,3544,270,1297,982,152,55,2756
Michigan,Grand Haven,10974,594,2061,2580,1849,1003,8087
Michigan,Flushing,8012,326,1672,2024,1046,664,5732
Michigan,Akron,444,39,129,112,12,2,294
Michigan,Unionville,513,30,176,119,25,14,364
Michigan,Pentwater,838,43,138,190,182,123,676
Michigan,Shelby,2220,322,436,373,128,55,1314
Michigan,Walkerville,225,15,43,68,8,0,134
Michigan,Marquette,20932,552,2699,3470,3110,1657,11488
Michigan,Hudsonville,7344,302,1450,1313,1095,446,4606
Michigan,Rockwood,3202,153,855,970,196,268,2442
Michigan,Essexville,3357,241,672,857,367,241,2378
Michigan,Woodhaven,12551,584,2775,3672,1468,762,9261
Michigan,Lexington,984,75,252,284,149,86,846
Michigan,Marlette,1874,168,493,383,102,40,1186
Michigan,Whitehall,2730,206,546,807,379,95,2033
Michigan,Copemish,153,13,61,31,15,2,122
Michigan,Custer,281,12,74,69,17,7,179
Michigan,Ishpeming,6482,236,1835,1484,865,230,4650
Michigan,Negaunee,4563,148,903,1056,699,224,3030
Michigan,West Ishpeming,2837,65,792,705,499,137,2198
Michigan,Ferrysburg,3003,140,587,827,536,239,2329
Michigan,Wyandotte,25138,1666,6460,7295,2076,1182,18679
Michigan,Daggett,215,10,58,60,17,5,150
Michigan,St. Clair Shores,59781,3293,13224,17113,7473,3662,44765
Michigan,Lowell,4060,222,936,1068,381,266,2873
Michigan,Pilgrim,27,0,0,0,12,15,27
Michigan,Ponshewaing,54,0,27,13,8,6,54
Michigan,Presque Isle Harbor,590,21,96,247,104,71,539
Michigan,Rapid City,1465,125,419,403,74,58,1079
Michigan,St. James,162,14,45,33,21,20,133
Michigan,Sand Lake,1553,136,532,461,89,46,1264
Michigan,Snover,460,65,141,76,22,3,307
Michigan,South Boardman,557,22,158,162,17,10,369
Michigan,Stronach,182,9,51,55,7,0,122
Michigan,Village of Grosse Pointe Shores,2860,35,265,465,561,835,2161
Michigan,Vineyard Lake,694,66,248,184,53,29,580
Michigan,Wacousta,1637,9,253,410,312,185,1169
Michigan,Walloon Lake,274,16,28,94,72,42,252
Michigan,Watersmeet,459,12,166,128,31,3,340
Michigan,Wedgewood,221,0,26,50,49,44,169
Michigan,Wellston,244,36,66,57,14,0,173
Michigan,White Pine,434,38,126,138,47,11,360
Michigan,Zeba,432,52,80,127,12,10,281
Michigan,Dexter,4603,94,424,502,1000,751,2771
Michigan,Parkdale,680,126,207,194,48,3,578
Michigan,Omena,239,0,59,30,30,55,174
Michigan,Oden,299,21,61,108,25,0,215
Michigan,Oak Hill,756,28,171,216,40,13,468
Michigan,Hickory Corners,256,0,147,63,10,0,220
Michigan,Jasper,381,38,73,81,11,13,216
Michigan,Horton Bay,552,11,121,111,93,85,421
Michigan,Interlochen,361,12,135,131,18,5,301
Michigan,Ironton,107,3,25,24,18,4,74
Michigan,Jennings,315,21,134,39,0,5,199
Michigan,K. I. Sawyer,3094,161,670,745,179,66,1821
Michigan,Lake Leelanau,126,0,16,14,57,22,109
Michigan,Lake Victoria,781,56,32,265,197,89,639
Michigan,Ovid,1903,124,462,573,97,34,1290
Michigan,Leland,312,0,15,89,69,92,265
Michigan,Loomis,172,24,85,23,9,0,141
Michigan,Lupton,313,35,75,92,9,8,219
Michigan,Manistee Lake,510,56,133,122,19,10,340
Michigan,Maple City,136,7,41,37,4,15,104
Michigan,Maple Grove,74,0,29,17,0,28,74
Michigan,Marenisco,172,7,63,54,13,4,141
Michigan,Nessen City,65,8,28,11,0,3,50
Michigan,New Troy,738,27,198,104,66,16,411
Michigan,Norwood,172,0,28,30,38,24,120
Michigan,Levering,181,22,67,9,13,0,111
Michigan,Haring,509,50,219,62,24,0,355
Michigan,Bay Shore,748,25,139,221,54,56,495
Michigan,Caseville,711,124,189,197,53,27,590
Michigan,St. Ignace,2257,204,654,519,200,153,1730
Michigan,Eastlake,454,17,204,73,45,8,347
Michigan,Fountain,194,10,55,41,3,1,110
Michigan,Free Soil,87,8,29,33,3,1,74
Michigan,Trowbridge Park,2270,56,519,498,306,153,1532
Michigan,Maple Rapids,633,37,200,155,41,4,437
Michigan,Spring Arbor,2634,81,240,409,395,126,1251
Michigan,Burr Oak,774,93,228,136,27,11,495
Michigan,Fowler,1357,31,354,275,129,55,844
Michigan,Bay City,33463,3111,7371,8505,2634,1118,22739
Michigan,Le Roy,298,10,106,42,17,8,183
Michigan,Reed City,2625,193,785,466,198,117,1759
Michigan,Auburn,1947,83,420,551,264,96,1414
Michigan,Pinconning,1424,131,425,257,78,27,918
Michigan,Gaastra,331,32,115,65,36,12,260
Michigan,Kalamazoo,76040,3920,8098,13782,7913,5904,39617
Michigan,Parchment,1969,121,336,579,213,85,1334
Michigan,Grant,907,81,285,162,54,27,609
Michigan,Kent City,1059,107,236,224,51,15,633
Michigan,Mackinac Island,960,75,129,240,102,132,678
Michigan,Carsonville,517,61,145,94,21,10,331
Michigan,Temperance,8798,325,2154,2116,1264,594,6453
Michigan,South Rockwood,1828,158,392,461,176,106,1293
Michigan,Lakes of the North,866,45,356,218,76,39,734
Michigan,Jonesville,2403,175,495,574,197,112,1553
Michigan,Ontonagon,1551,94,487,442,168,78,1269
Michigan,Constantine,2021,230,583,410,67,36,1326
Michigan,Bancroft,530,24,104,174,22,13,337
Michigan,Morrice,1210,64,265,326,106,34,795
Michigan,Vernon,715,18,205,254,50,7,534
Michigan,Perrinton,621,32,185,109,15,8,349
Michigan,St. Louis,7198,792,2449,1763,208,117,5329
Michigan,Caro,4064,427,1024,1006,321,114,2892
Michigan,Kingsley,1498,77,292,429,118,78,994
Michigan,Beulah,211,14,65,56,38,28,201
Michigan,Port Austin,699,54,186,188,73,55,556
Michigan,Port Hope,217,16,82,64,16,7,185
Michigan,Sebewaing,1510,96,514,413,149,36,1208
Michigan,New Era,439,14,85,99,69,39,306
Michigan,Freeport,472,36,119,113,27,4,299
Michigan,Carleton,2399,146,688,521,133,90,1578
Michigan,Dundee,4133,231,924,1142,458,185,2940
Michigan,Luna Pier,1236,113,298,297,113,98,919
Michigan,Harbor Beach,1943,216,527,374,169,58,1344
Michigan,New Haven,4751,471,727,1199,319,130,2846
Michigan,Stockbridge,1349,93,297,317,145,89,941
Michigan,Eastpointe,32576,2836,7181,8105,2068,1072,21262
Michigan,Rosebush,356,33,95,80,24,21,253
Michigan,Barryton,445,38,154,96,24,6,318
Michigan,Mecosta,478,99,152,55,22,5,333
Michigan,Stanwood,237,20,72,43,11,10,156
Michigan,Bellevue,1338,16,339,380,98,36,869
Michigan,Minden City,166,19,47,45,7,1,119
Michigan,Sandusky,2545,202,751,610,92,115,1770
Michigan,McBain,583,56,231,111,37,17,452
Michigan,Fremont,4060,225,929,976,338,287,2755
Michigan,Kalkaska,2217,247,767,504,124,21,1663
Michigan,Northview,15391,543,3076,3678,2566,1074,10937
Michigan,Menominee,8214,457,2282,1950,814,385,5888
Michigan,Lake Odessa,2154,212,530,453,117,62,1374
Michigan,Muir,664,55,176,148,15,1,395
Michigan,Saranac,1432,120,352,381,72,58,983
Michigan,Clare,3045,149,635,723,366,293,2166
Michigan,Morley,489,58,163,86,17,11,335
Michigan,Hubbardston,328,17,133,62,16,0,228
Michigan,Canada Creek Ranch,297,6,105,104,28,37,280
Michigan,Atlanta,687,62,260,166,33,16,537
Michigan,Cassopolis,1671,195,434,291,77,24,1021
Michigan,Stanton,1391,95,332,379,65,41,912
Michigan,Burt,1001,51,314,198,80,12,655
Michigan,L'Anse,2024,121,558,518,155,79,1431
Michigan,Benzonia,494,41,155,102,40,32,370
Michigan,Elberta,167,10,53,19,11,16,109
Michigan,Lake Ann,208,17,80,62,22,14,195
Michigan,Thompsonville,526,87,142,145,8,0,382
Michigan,Wakefield,1537,106,482,500,137,37,1262
Michigan,Stevensville,1079,56,280,322,180,65,903
Michigan,Hemlock,1286,55,488,304,58,36,941
Michigan,Deerfield,926,53,256,238,48,19,614
Michigan,Morenci,2501,204,599,519,110,54,1486
Michigan,Martin,448,26,129,80,34,35,304
Michigan,Saugatuck,850,28,105,152,182,176,643
Michigan,Homer,1799,86,531,349,123,34,1123
Michigan,Springfield,5208,436,1537,892,366,94,3325
Michigan,Paw Paw Lake,3605,213,808,1038,427,133,2619
Michigan,St. Joseph,8314,308,1179,1734,1727,1438,6386
Michigan,Adrian,20640,2118,4639,3694,1354,781,12586
Michigan,Ithaca,2805,161,602,783,199,128,1873
Michigan,St. Johns,7910,481,1705,2003,890,481,5560
Michigan,Sherwood,410,45,113,99,4,4,265
Michigan,Grand Blanc,7925,208,992,1833,1542,917,5492
Michigan,Allen,262,13,87,57,20,3,180
Michigan,Hubbell,929,34,279,172,106,49,640
Michigan,South Range,658,41,173,124,57,59,454
Michigan,Estral Beach,358,36,78,120,37,9,280
Michigan,Monroe,19947,1544,4512,4767,1511,1085,13419
Michigan,South Monroe,6176,625,1578,1461,396,377,4437
Michigan,West Monroe,3339,429,838,535,291,90,2183
Michigan,Eagle,139,0,29,51,7,2,89
Michigan,Escanaba,12298,666,2447,3697,1345,640,8795
Michigan,Gladstone,4794,139,1202,1229,552,142,3264
Michigan,Baldwin,1184,178,349,291,26,10,854
Michigan,Addison,721,32,196,136,49,24,437
Michigan,Vermontville,756,53,188,187,28,12,468
Michigan,Flat Rock,9932,572,2143,2478,906,353,6452
Michigan,Hillman,690,92,255,140,20,41,548
Michigan,Davison,4951,105,1102,1457,531,275,3470
Michigan,Hubbard Lake,859,45,260,234,128,118,785
Michigan,Applegate,290,23,93,47,8,8,179
Michigan,Montgomery,359,26,118,70,1,4,219
Michigan,Bingham Farms,1101,3,75,161,300,342,881
Michigan,De Tour Village,271,24,90,90,21,12,237
Michigan,Alanson,787,42,213,187,57,11,510
Michigan,Petoskey,5707,247,858,1533,1023,653,4314
Michigan,Benton Harbor,9920,1518,2321,1745,274,155,6013
Michigan,Fair Plain,7138,790,1406,2132,405,358,5091
Michigan,Lakewood Club,1172,73,367,323,56,18,837
Michigan,Republic,458,22,170,85,36,11,324
Michigan,Wayne,17063,1628,4258,4343,987,392,11608
Michigan,Garden,181,21,35,50,13,10,129
Michigan,Birch Run,1646,112,391,492,114,56,1165
Michigan,Village of Clarkston,968,6,84,220,195,176,681
Michigan,Chatham,216,23,64,43,16,2,148
Michigan,Hillsdale,8125,545,1449,1321,664,494,4473
Michigan,Lewiston,1177,124,451,258,72,38,943
Michigan,Hersey,309,15,91,61,31,6,204
Michigan,White Cloud,1245,220,394,195,46,21,876
Michigan,Union City,1683,64,463,327,134,29,1017
Michigan,Lapeer,8731,660,2482,2222,516,303,6183
Michigan,Clinton,2428,49,442,563,375,182,1611
Michigan,Vanderbilt,592,76,263,76,19,5,439
Michigan,Rochester Hills,74011,1682,8068,12481,16094,13560,51885
Michigan,Pontiac,60116,7961,11854,12963,3144,1479,37401
Michigan,Hanover,461,15,123,103,22,5,268
Michigan,Springport,812,81,191,183,23,20,498
Michigan,Croswell,2543,331,636,474,104,73,1618
Michigan,Melvin,153,23,50,33,0,3,109
Michigan,Howell,9597,484,2000,2627,1127,559,6797
Michigan,Pinckney,2488,82,424,683,298,134,1621
Michigan,Corunna,3374,274,827,778,219,186,2284
Michigan,Owosso,14604,908,3713,3483,844,417,9365
Michigan,Perry,2156,57,429,626,133,105,1350
Michigan,Whittemore,469,75,135,101,12,6,329
Michigan,Pewamo,469,30,153,96,30,9,318
Michigan,Portland,3920,174,704,921,383,168,2350
Michigan,Mulliken,526,52,122,139,51,2,366
Michigan,Stephenson,866,65,262,194,61,11,593
Michigan,Buckley,837,35,233,163,52,11,494
Michigan,Manton,1171,98,335,275,55,12,775
Michigan,Shorewood-Tower Hills-Harbert,1638,8,352,403,435,242,1440
Michigan,Mio,1848,235,495,448,78,51,1307
Michigan,Dryden,1110,45,286,265,63,35,694
Michigan,Huntington Woods,6340,51,247,686,1348,1928,4260
Michigan,Elk Rapids,1490,70,272,424,239,199,1204
Michigan,Caspian,550,28,236,125,24,14,427
Michigan,Weidman,754,37,234,252,25,18,566
Michigan,Potterville,2672,124,436,736,265,79,1640
Michigan,Sunfield,497,30,91,137,31,0,289
Michigan,Farmington,10590,134,1040,2258,2628,1700,7760
Michigan,Ferndale,20211,759,2613,5372,4619,2687,16050
Michigan,Hazel Park,16592,1913,4183,4005,1276,372,11749
Michigan,Lincoln Park,36883,4886,9607,7659,1529,610,24291
Michigan,Grand Beach,284,3,16,55,100,81,255
Michigan,Lost Lake Woods,344,0,96,114,60,32,302
Michigan,Galien,465,45,144,119,17,7,332
Michigan,Lake Michigan Beach,1234,71,278,308,112,106,875
Michigan,Elsie,1146,62,343,255,54,17,731
Michigan,Clifford,298,32,123,60,7,0,222
Michigan,Norway,2786,53,660,829,574,164,2280
Michigan,Columbiaville,946,63,189,245,57,19,573
Michigan,Turner,142,21,53,15,4,2,95
Michigan,Ashley,551,68,205,131,17,4,425
Michigan,Brighton,7626,401,1278,1729,1484,814,5706
Michigan,Michiana,183,2,5,28,63,69,167
Michigan,Shoreham,968,16,85,227,213,180,721
Michigan,Boyne City,3750,185,696,956,563,296,2696
Michigan,Mayville,920,114,270,210,68,6,668
Michigan,Linden,3882,75,873,862,487,311,2608
Michigan,Montrose,1540,112,366,378,126,52,1034
Michigan,Mount Morris,2887,188,672,695,121,44,1720
Michigan,Millington,1014,62,230,256,77,19,644
Michigan,Vassar,2586,190,657,513,162,73,1595
Michigan,Hart,2303,227,593,480,117,52,1469
Michigan,Muskegon Heights,10735,1078,2430,2294,260,226,6288
Michigan,Owendale,287,25,62,74,8,4,173
Michigan,Wolf Lake,3871,306,1291,1017,82,76,2772
Michigan,Scottville,1235,78,291,300,75,45,789
Michigan,Zeeland,5581,407,1092,1097,522,299,3417
Michigan,Prudenville,1951,92,478,596,159,120,1445
Michigan,Roscommon,1101,80,214,318,80,18,710
Michigan,Millersburg,212,23,42,47,14,9,135
Michigan,Franklin,3332,30,165,387,625,990,2197
Michigan,Lake Angelus,265,0,48,33,78,75,234
Michigan,Leonard,350,15,80,91,42,28,256
Michigan,Bear Lake,177,10,49,52,16,0,127
Michigan,Bloomingdale,624,64,167,111,44,10,396
Michigan,Elkton,808,57,205,195,50,12,519
Michigan,Lakeview,1108,106,300,251,48,37,742
Michigan,Iron Mountain,7406,334,1689,1789,925,431,5168
Michigan,Quinnesec,1017,69,254,251,160,89,823
Michigan,Kinde,538,37,134,116,24,5,316
Michigan,Pigeon,1289,93,305,320,131,52,901
Michigan,Chesaning,2390,116,611,553,188,101,1569
Michigan,Big Rapids,10392,427,969,1354,563,498,3811
Michigan,Olivet,1636,45,181,226,93,50,595
Michigan,Waverly,24546,775,3949,6140,4447,2499,17810
Michigan,Belding,5737,378,1471,1331,361,103,3644
Michigan,Mount Clemens,16358,1775,4010,4026,1271,673,11755
Michigan,Roseville,47603,4357,12105,12402,2930,1107,32901
Michigan,Utica,4945,333,926,1455,632,322,3668
Michigan,Rockford,6186,207,726,1323,1219,554,4029
Michigan,Capac,1928,254,522,382,81,22,1261
Michigan,Emmett,262,15,86,55,13,9,178
Michigan,Fraser,14638,830,3118,4192,1645,760,10545
Michigan,Cadillac,10394,697,2500,2794,936,319,7246
Michigan,Harrietta,175,30,48,29,13,0,120
Michigan,Grand Ledge,7805,248,1370,2136,1052,603,5409
Michigan,Harrisville,396,64,109,105,28,31,337
Michigan,Fowlerville,2874,43,757,816,218,66,1900
Michigan,New Lothrop,681,18,130,213,47,21,429
Michigan,Dansville,641,20,143,153,51,30,397
Michigan,Muskegon,37969,3706,9721,8884,2193,914,25418
Michigan,Almont,2761,241,705,646,193,100,1885
Michigan,Blissfield,3194,195,668,862,358,131,2214
Michigan,East Lansing,48374,619,1162,2472,4475,5964,14692
Michigan,Jenison,17794,582,3521,4260,2481,779,11623
Michigan,Webberville,1224,72,323,288,100,41,824
Michigan,Romulus,23515,1795,5893,5202,1578,659,15127
Michigan,Ludington,8057,386,2011,1960,868,531,5756
Michigan,Warren,135192,12927,32338,31837,11877,4934,93913
Michigan,Beal City,488,8,175,52,59,36,330
Michigan,Mancelona,1486,158,416,258,59,29,920
Michigan,Barton Hills,287,3,9,20,46,148,226
Michigan,Saline,9223,143,1094,1759,1790,1585,6371
Michigan,Quincy,1454,85,442,363,59,27,976
Michigan,Cement City,524,95,145,93,28,12,373
Michigan,Harrison,2159,272,542,554,138,59,1565
Michigan,Reese,1390,47,382,358,115,46,948
Michigan,Rogers City,2693,257,719,631,260,156,2023
Michigan,Michigamme,240,1,52,83,34,17,187
Michigan,New Buffalo,1634,132,316,383,270,174,1275
Michigan,Portage,48421,1394,6728,9967,8666,5675,32430
Michigan,Richland,741,19,74,222,133,102,550
Michigan,South Gull Lake,1158,0,52,245,379,233,909
Michigan,Grandville,15952,877,2641,3752,2168,1220,10658
Michigan,Sand Lake,532,44,141,94,45,11,335
Michigan,Wyoming,75532,7566,15535,16081,7283,2826,49291
Michigan,Marine City,4125,148,1279,1205,213,156,3001
Michigan,Marysville,9739,480,1989,2663,1228,556,6916
Michigan,Harbor Springs,1129,35,171,371,231,125,933
Michigan,Memphis,1173,113,288,334,63,32,830
Michigan,Northport,459,9,61,117,119,82,388
Michigan,Bloomfield Hills,4009,90,317,414,738,1231,2790
Michigan,Sylvan Lake,1798,11,165,414,483,272,1345
Michigan,Otisville,977,73,287,236,52,20,668
Michigan,Munising,2242,160,625,601,185,118,1689
Michigan,Gwinn,2145,45,810,429,241,83,1608
Michigan,Wixom,13870,527,1876,3267,2731,1335,9736
Michigan,Parma,598,24,147,153,48,25,397
Michigan,Au Sable,1324,76,447,347,107,14,991
Michigan,Mackinaw City,855,60,162,246,101,62,631
Michigan,Michigan Center,4741,375,1116,1298,480,167,3436
Michigan,Napoleon,1018,87,235,191,69,0,582
Michigan,Belleville,3898,368,775,855,458,455,2911
Michigan,Dearborn Heights,56089,5264,12348,11671,5056,3016,37355
Michigan,Gibraltar,4529,318,1027,1401,371,196,3313
Michigan,Grosse Pointe Farms,9224,89,490,1109,2424,2089,6201
Michigan,Highland Park,10915,1661,2553,2110,569,309,7202
Michigan,Northville,5971,93,624,731,1531,1460,4439
Michigan,Bangor,1773,228,375,378,60,56,1097
Michigan,Ann Arbor,120641,1945,4864,9537,20417,30071,66834
Michigan,Paw Paw,3398,296,768,898,199,50,2211
Michigan,Beechwood,3450,368,518,601,221,291,1999
Michigan,Berkley,15360,383,1643,3378,3484,2373,11261
Michigan,Allendale,20776,625,1943,2329,1779,831,7507
Michigan,River Rouge,7536,1261,1903,1423,374,77,5038
Michigan,Trenton,18368,858,4309,4888,2084,1425,13564
Michigan,Kentwood,51525,4095,8840,10107,7682,3496,34220
Michigan,Armada,1796,135,466,449,175,68,1293
Michigan,Vicksburg,3172,137,667,898,257,156,2115
Michigan,Grand Rapids,197081,16691,27842,35631,29172,15219,124555
Michigan,Plymouth,9054,157,913,1771,2185,1758,6784
Michigan,Comstock Northwest,6144,192,961,1541,781,589,4064
Michigan,Mattawan,2333,123,423,645,216,54,1461
Michigan,Laingsburg,1273,45,282,338,132,27,824
Michigan,Port Sanilac,604,64,180,137,66,71,518
Michigan,Honor,240,9,69,49,28,15,170
Michigan,Bessemer,1890,25,522,522,198,66,1333
Michigan,Midland,41963,1374,6198,8607,7178,5319,28676
Michigan,Sanford,743,21,177,226,97,71,592
Michigan,Carson City,1097,70,269,281,36,40,696
Michigan,Edmore,1297,79,506,244,61,30,920
Michigan,Pierson,189,25,55,14,0,2,96
Michigan,Lawrence,974,109,243,156,85,22,615
Michigan,Sheridan,656,24,205,142,51,24,446
Michigan,Merrill,720,33,222,164,56,13,488
Michigan,Dearborn,95089,11231,12740,15797,10181,7117,57066
Michigan,Detroit,677155,86677,141444,143081,37798,25463,434463
Michigan,Grosse Pointe Woods,15559,219,1338,2938,3901,2939,11335
Michigan,Inkster,24615,2484,5529,5536,1138,522,15209
Michigan,Gobles,781,68,187,171,51,4,481
Michigan,East Jordan,2341,217,732,493,185,64,1691
Michigan,Cheboygan,4726,473,1387,1044,366,98,3368
Michigan,Frankenmuth,5147,257,962,943,1013,648,3823
Michigan,New Baltimore,12365,537,2026,3254,1661,769,8247
Michigan,Iron River,2856,163,1073,496,218,140,2090
Michigan,Eastwood,5858,259,960,1748,513,219,3699
Michigan,Jackson,32800,3163,6933,6865,2516,1036,20513
Michigan,Tawas City,1795,132,535,441,151,98,1357
Michigan,Mesick,358,44,122,77,19,15,277
Michigan,East Tawas,2732,140,734,799,270,202,2145
Michigan,Oscoda,748,76,151,213,88,80,608
Michigan,Empire,262,4,33,67,35,65,204
Michigan,Greilickville,1717,0,319,404,377,212,1312
Michigan,Suttons Bay,514,20,70,128,107,133,458
Michigan,Lyons,919,69,280,174,39,8,570
Michigan,Charlotte,9091,675,2048,2560,555,343,6181
Michigan,Dimondale,1266,49,169,417,175,81,891
Michigan,Big Bay,183,4,33,57,54,19,167
Michigan,Buchanan,4351,226,1093,1036,496,70,2921
Michigan,Coloma,1658,96,387,372,112,56,1023
Michigan,Whitmore Lake,6771,255,1472,1704,838,359,4628
Michigan,Coldwater,12284,1043,3550,2894,740,293,8520
Michigan,Bellaire,958,73,198,246,111,67,695
Michigan,Grayling,1846,185,561,380,60,63,1249
Michigan,North Branch,944,88,253,270,55,9,675
Michigan,Imlay City,3581,497,763,630,221,59,2170
Michigan,Kingsford,5022,193,1260,1257,524,316,3550
Michigan,Fife Lake,393,22,134,121,19,15,311
Michigan,Decatur,2001,219,537,402,98,40,1296
Michigan,Lawton,1613,139,423,402,120,27,1111
Michigan,Alma,9051,247,1780,2054,564,569,5214
Michigan,Bad Axe,2980,322,694,757,217,128,2118
Michigan,Ubly,789,21,268,176,51,23,539
Michigan,Buena Vista,6351,722,1424,1508,178,148,3980
Michigan,Freeland,7125,252,1419,1831,944,611,5057
Michigan,Concord,1171,50,234,280,78,74,716
Michigan,Saginaw,48997,5819,11558,10274,2366,1215,31232
Michigan,Hudson,2465,129,689,535,122,74,1549
Michigan,Barnes Lake-Millers Lake,1194,84,335,453,40,62,974
Michigan,Manitou Beach-Devils Lake,1730,52,492,526,325,119,1514
Michigan,Baroda,798,68,193,224,59,42,586
Michigan,Bridgman,2534,146,444,716,353,176,1835
Michigan,Brownlee Park,1480,243,528,195,55,7,1028
Michigan,Burlington,282,12,98,56,5,20,191
Michigan,Westphalia,992,57,278,180,111,28,654
Michigan,St. Charles,2086,131,596,521,127,104,1479
Michigan,Deckerville,789,112,271,154,41,21,599
Michigan,Peck,586,39,151,171,28,10,399
Michigan,Allen Park,27353,1550,5925,7485,3015,1785,19760
Michigan,Manistee,6071,226,1346,1706,705,409,4392
Michigan,Onekama,466,11,57,131,60,25,284
Michigan,Ahmeek,96,9,30,16,10,4,69
Michigan,Newberry,1352,122,278,336,132,31,899
Michigan,Rochester,13130,155,1211,2513,2353,2556,8788
Michigan,Troy,83881,2891,8350,12658,17900,17022,58821
Michigan,Clio,2524,270,655,569,294,76,1864
Michigan,Holly,6194,408,1343,1828,495,349,4423
Michigan,Kaleva,475,22,133,142,24,9,330
Michigan,Lathrup Village,4150,103,404,755,919,755,2936
Michigan,Orchard Lake Village,2456,77,189,397,531,607,1801
Michigan,Ortonville,1711,84,289,489,140,62,1064
Michigan,Argentine,2478,84,610,536,290,253,1773
Michigan,Gaines,382,17,99,107,22,7,252
Michigan,Swartz Creek,5531,339,1309,1901,343,228,4120
Michigan,Cass City,2495,198,643,675,206,140,1862
Michigan,Gagetown,279,33,120,57,10,6,226
Michigan,Rothbury,410,69,97,73,27,8,274
Michigan,Oak Park,29849,1527,5025,7755,4027,2031,20365
Michigan,Alpha,146,8,73,11,11,13,116
Michigan,Holt,25536,640,3780,6493,4155,2365,17433
Michigan,Royal Oak,59107,1575,6860,11090,15002,10294,44821
Michigan,Livonia,94567,3956,16111,24501,16638,8840,70046
Michigan,Melvindale,10419,1509,2293,1772,393,296,6263
Michigan,Auburn Hills,23107,1078,3002,4192,3871,2880,15023
Michigan,Oakley,307,30,82,75,17,3,207
Michigan,Tecumseh,8346,345,1936,1860,1161,610,5912
Michigan,Hastings,7284,410,1600,1674,628,391,4703
Michigan,Woodland,494,44,138,89,23,11,305
Michigan,North Adams,528,47,174,111,19,5,356
Michigan,Copper City,222,20,69,41,12,2,144
Michigan,Calumet,748,52,177,165,82,29,505
Michigan,Shields,5993,343,1367,1826,774,253,4563
Michigan,Luther,298,58,90,58,8,0,214
Michigan,Athens,1008,59,265,276,45,24,669
Michigan,Eau Claire,741,52,130,147,36,41,406
Michigan,Galesburg,2120,169,597,473,61,40,1340
Michigan,Southgate,29268,2145,7626,7938,2810,1268,21787
Michigan,Haslett,19721,744,1620,3434,3748,4307,13853
Michigan,Keego Harbor,3196,219,591,894,456,302,2462
Michigan,Battle Creek,51475,3274,12040,11368,5020,2284,33986
Michigan,Casnovia,365,37,63,94,21,8,223
Minnesota,Buckman,283,9,55,49,15,2,130
Minnesota,Kingston,176,2,38,51,9,0,100
Minnesota,Willernie,378,14,117,71,29,16,247
Minnesota,Birchwood Village,936,20,44,151,272,190,677
Minnesota,Hugo,14587,221,2485,3361,2590,1052,9709
Minnesota,Marine on St. Croix,761,12,47,171,200,137,567
Minnesota,Genola,72,2,19,14,1,0,36
Minnesota,Hillman,40,4,5,6,4,0,19
Minnesota,Kinbrae,8,0,3,3,0,0,6
Minnesota,Round Lake,450,47,127,116,13,15,318
Minnesota,Worthington,13148,2575,2377,1947,872,340,8111
Minnesota,Cologne,1825,37,321,426,250,93,1127
Minnesota,Waconia,11981,236,1443,1960,2769,1175,7583
Minnesota,Hokah,617,22,203,128,39,13,405
Minnesota,Truman,1073,95,322,240,70,35,762
Minnesota,Goodview,4105,168,787,1237,476,154,2822
Minnesota,Oronoco,1486,20,152,272,303,185,932
Minnesota,Rochester,113913,4849,14336,22653,19480,15687,77005
Minnesota,Minnesota City,162,13,31,50,10,1,105
Minnesota,Farmington,22714,446,3001,5552,3834,1097,13930
Minnesota,Montevideo,5139,388,1275,1207,525,166,3561
Minnesota,Rice,1556,60,220,509,132,37,958
Minnesota,Apple Valley,51931,1817,7090,11036,10354,4797,35094
Minnesota,Hampton,785,14,136,199,72,21,442
Minnesota,Hendrum,334,12,118,46,35,12,223
Minnesota,Holland,160,18,42,41,2,4,107
Minnesota,Pipestone,4093,419,866,848,504,127,2764
Minnesota,Trosky,91,6,31,19,2,0,58
Minnesota,Vesta,300,17,88,56,27,4,192
Minnesota,Trimont,754,74,188,169,74,14,519
Minnesota,Raymond,744,36,179,204,67,11,497
Minnesota,Houston,1078,54,265,274,97,45,735
Minnesota,Hinckley,1537,117,413,348,75,27,980
Minnesota,Mentor,254,49,77,32,0,7,165
Minnesota,Nielsville,122,12,33,24,2,0,71
Minnesota,Trail,58,8,9,17,5,0,39
Minnesota,Andover,32499,769,4610,7902,5493,2260,21034
Minnesota,Elysian,631,41,184,155,76,46,502
Minnesota,Kinney,138,10,30,51,7,4,102
Minnesota,Meadowlands,119,19,43,23,3,3,91
Minnesota,Holloway,105,4,26,39,17,2,88
Minnesota,Waldorf,227,15,71,39,22,4,151
Minnesota,Waseca,9056,586,2396,2335,672,367,6356
Minnesota,Cedar Mills,62,10,13,10,5,5,43
Minnesota,Isanti,5565,285,1116,1588,358,118,3465
Minnesota,Harding,142,22,41,20,10,7,100
Minnesota,Royalton,1302,93,257,323,135,43,851
Minnesota,Wilmont,407,26,110,127,19,12,294
Minnesota,Alpha,124,6,33,34,13,0,86
Minnesota,Jackson,3225,196,699,815,402,161,2273
Minnesota,Prinsburg,517,38,57,144,83,17,339
Minnesota,Regal,53,2,16,18,2,1,39
Minnesota,Montgomery,2936,190,730,813,125,30,1888
Minnesota,Clinton,401,24,123,105,25,8,285
Minnesota,Hermantown,9621,149,1934,2388,1483,743,6697
Minnesota,Leonidas,48,0,26,14,4,0,44
Minnesota,Orr,269,10,68,74,23,17,192
Minnesota,Northrop,171,3,73,46,10,0,132
Minnesota,Vineland,832,83,176,162,6,25,452
Minnesota,Bruno,87,6,33,20,1,0,60
Minnesota,Pine City,3072,221,818,912,296,173,2420
Minnesota,Crookston,7782,502,1587,1514,834,427,4864
Minnesota,East Grand Forks,8635,330,1663,1964,1110,541,5608
Minnesota,Lyle,454,33,126,120,24,6,309
Minnesota,Arlington,2342,246,611,510,105,88,1560
Minnesota,Gaylord,1877,142,596,363,184,60,1345
Minnesota,New Auburn,545,48,132,92,19,2,293
Minnesota,Maynard,414,41,135,85,23,1,285
Minnesota,Cosmos,513,40,163,174,19,2,398
Minnesota,Dassel,1518,110,348,312,168,49,987
Minnesota,Sauk Rapids,13528,452,2307,3858,1759,582,8958
Minnesota,Lilydale,902,28,113,217,252,244,854
Minnesota,Darwin,328,30,80,80,19,3,212
Minnesota,Wrenshall,477,25,96,144,38,13,316
Minnesota,Leonard,33,2,14,7,3,0,26
Minnesota,Shevlin,155,8,44,52,0,0,104
Minnesota,Burnsville,61283,3184,8865,13443,11338,4793,41623
Minnesota,Mendota,250,23,55,33,46,15,172
Minnesota,Belle Plaine,7029,361,1486,1673,693,331,4544
Minnesota,Vermillion,498,20,141,125,41,24,351
Minnesota,Oak Grove,8582,296,1714,2242,1199,467,5918
Minnesota,St. Francis,7551,391,1722,1955,487,179,4734
Minnesota,Annandale,3349,266,893,680,336,208,2383
Minnesota,Delano,5959,69,878,1177,1227,491,3842
Minnesota,Cook,496,28,163,148,21,34,394
Minnesota,Virginia,8531,415,1972,2625,856,358,6226
Minnesota,Byron,5366,87,512,1296,915,553,3363
Minnesota,Ellendale,777,58,224,151,69,10,512
Minnesota,Breckenridge,3246,172,571,910,503,137,2293
Minnesota,Wolverton,150,4,26,42,25,4,101
Minnesota,Dexter,308,22,109,73,13,10,227
Minnesota,Woodstock,113,14,26,33,6,1,80
Minnesota,Verndale,557,30,111,126,39,25,331
Minnesota,Mounds View,12959,693,2206,3116,1746,878,8639
Minnesota,Fosston,1604,96,406,377,181,93,1153
Minnesota,Shakopee,40418,1950,6148,8281,6631,2361,25371
Minnesota,Anoka,17419,877,3983,4642,1951,785,12238
Minnesota,Babbitt,1460,101,413,487,128,29,1158
Minnesota,Tower,445,13,120,146,56,8,343
Minnesota,Otsego,16189,454,2467,4307,2400,951,10579
Minnesota,Brookston,119,4,47,24,6,1,82
Minnesota,Ely,3398,165,695,954,517,160,2491
Minnesota,Proctor,3059,121,925,769,337,149,2301
Minnesota,Dunnell,187,30,49,42,14,2,137
Minnesota,Welcome,714,52,203,188,49,7,499
Minnesota,Cokato,2714,193,643,584,239,94,1753
Minnesota,Buhl,1052,20,325,296,110,43,794
Minnesota,Chisholm,4934,110,1075,1474,464,99,3222
Minnesota,Duluth,86004,3248,12970,17387,12645,7369,53619
Minnesota,McKinley,172,3,37,61,8,0,109
Minnesota,Winton,122,22,21,35,4,9,91
Minnesota,Underwood,387,22,92,118,46,13,291
Minnesota,Akeley,341,8,153,83,27,0,271
Minnesota,La Salle,72,2,22,21,4,2,51
Minnesota,Claremont,664,70,233,87,12,2,404
Minnesota,The Lakes,630,29,166,185,107,43,530
Minnesota,Eden Prairie,63900,1551,4413,9931,17182,11287,44364
Minnesota,Edina,51136,656,3372,7075,14654,11163,36920
Minnesota,North Mankato,13704,342,2217,3310,2447,1091,9407
Minnesota,Beaver Creek,390,12,87,94,41,5,239
Minnesota,Hills,693,71,171,186,56,15,499
Minnesota,Shoreview,26627,406,2797,5177,6552,4646,19578
Minnesota,Edgerton,1230,141,237,233,157,64,832
Minnesota,Mendota Heights,11284,131,1021,1814,3115,2351,8432
Minnesota,Finlayson,325,28,80,90,17,9,224
Minnesota,Granada,270,11,87,60,9,0,167
Minnesota,Gonvick,295,41,61,61,25,3,191
Minnesota,Miesville,126,0,39,40,13,0,92
Minnesota,New Trier,92,2,19,24,22,0,67
Minnesota,Perley,63,8,19,21,4,0,52
Minnesota,Randolph,452,24,107,114,34,15,294
Minnesota,Beaver Bay,140,2,33,30,52,8,125
Minnesota,Ada,1820,85,491,385,144,71,1176
Minnesota,Jordan,6155,242,1209,1335,555,209,3550
Minnesota,Henriette,93,26,41,11,0,0,78
Minnesota,Kerrick,70,7,14,12,14,2,49
Minnesota,Clara City,1406,147,357,296,152,39,991
Minnesota,Lake Lillian,298,27,73,85,13,7,205
Minnesota,New Prague,7746,249,1420,1605,1181,407,4862
Minnesota,Gilbert,1902,52,501,700,125,25,1403
Minnesota,Hoyt Lakes,2081,121,630,724,105,58,1638
Minnesota,Iron Junction,113,12,23,38,13,4,90
Minnesota,Prior Lake,25880,541,3362,5602,5891,1955,17351
Minnesota,Audubon,594,24,141,155,42,7,369
Minnesota,Lexington,1953,167,560,443,162,24,1356
Minnesota,Beardsley,197,9,61,56,14,6,146
Minnesota,Graceville,686,39,266,153,54,10,522
Minnesota,Barnesville,2579,98,519,622,372,105,1716
Minnesota,Dilworth,4370,166,747,1134,504,321,2872
Minnesota,Watson,185,12,45,53,6,2,118
Minnesota,Monticello,13439,855,2769,3397,1204,456,8681
Minnesota,Montrose,3136,109,636,715,322,76,1858
Minnesota,Ceylon,332,34,104,67,29,3,237
Minnesota,Eveleth,3633,149,685,882,444,107,2267
Minnesota,Ramsey,26225,805,4587,6600,3526,1366,16884
Minnesota,White Earth,571,72,154,81,16,0,323
Minnesota,Randall,663,32,129,161,65,7,394
Minnesota,Hanover,3298,27,419,647,672,234,1999
Minnesota,Grove City,643,33,154,110,27,24,348
Minnesota,Correll,48,0,16,20,0,0,36
Minnesota,Elbow Lake,82,17,20,22,0,0,59
Minnesota,Hitterdal,182,15,74,39,14,3,145
Minnesota,Sabin,639,14,133,164,60,22,393
Minnesota,Blaine,63319,2400,11021,14582,10157,4506,42666
Minnesota,Centerville,3962,141,548,916,699,197,2501
Minnesota,Circle Pines,4954,141,876,1415,697,387,3516
Minnesota,Coon Rapids,62376,2752,12768,16902,8092,3222,43736
Minnesota,Sunfish Lake,557,0,30,78,151,135,394
Minnesota,West St. Paul,19750,1162,3531,4753,2665,1399,13510
Minnesota,Silver Bay,1748,53,510,401,326,75,1365
Minnesota,Hatfield,31,2,16,5,0,0,23
Minnesota,Two Harbors,3541,140,808,898,390,167,2403
Minnesota,Gary,280,7,63,78,9,8,165
Minnesota,Halstad,632,87,108,159,70,10,434
Minnesota,Denham,33,2,19,4,0,2,27
Minnesota,Rutledge,165,25,47,53,4,2,131
Minnesota,Climax,277,17,55,66,30,15,183
Minnesota,Fertile,1089,81,289,297,93,34,794
Minnesota,Fisher,504,15,75,116,56,22,284
Minnesota,Gully,67,2,26,15,1,2,46
Minnesota,McIntosh,619,64,185,158,40,12,459
Minnesota,Detroit Lakes,9134,432,1851,2176,1205,643,6307
Minnesota,Pine Point,384,17,102,30,43,1,193
Minnesota,Columbia Heights,19958,1534,4372,4623,2397,1096,14022
Minnesota,Altura,509,22,97,110,71,5,305
Minnesota,Bovey,814,56,155,281,51,4,547
Minnesota,Roscoe,107,17,30,25,0,2,74
Minnesota,Wolf Lake,9,1,2,2,2,0,7
Minnesota,East Bethel,11808,343,2530,3238,1582,499,8192
Minnesota,Ham Lake,16282,396,3225,3935,2699,1007,11262
Minnesota,Fridley,27614,1950,5597,5660,3639,1787,18633
Minnesota,Roosevelt,131,10,30,34,11,3,88
Minnesota,Roseau,2679,153,558,670,370,176,1927
Minnesota,Battle Lake,690,34,149,221,105,37,546
Minnesota,New York Mills,1310,64,305,298,82,51,800
Minnesota,Ottertail,480,45,115,128,45,52,385
Minnesota,Parkers Prairie,1007,62,234,282,81,15,674
Minnesota,Gem Lake,489,11,57,104,83,61,316
Minnesota,Cambridge,8587,569,1875,2308,734,296,5782
Minnesota,Humboldt,33,1,8,10,1,0,20
Minnesota,Dawson,1701,116,439,395,140,78,1168
Minnesota,Madison,1540,112,470,418,107,71,1178
Minnesota,Flensburg,229,11,81,63,3,1,159
Minnesota,Little Falls,8664,671,2238,1864,884,305,5962
Minnesota,Motley,636,54,176,156,44,2,432
Minnesota,Pierz,1528,146,390,370,113,40,1059
Minnesota,Sobieski,195,15,52,45,4,0,116
Minnesota,Crystal,22934,884,4947,5532,4032,1369,16764
Minnesota,Deephaven,3864,1,278,438,1192,742,2651
Minnesota,Greenfield,2960,46,384,674,642,284,2030
Minnesota,Maple Plain,1844,55,318,440,355,109,1277
Minnesota,Rockford,4585,127,801,1099,529,260,2816
Minnesota,St. Louis Park,48423,1251,4718,9291,14227,6973,36460
Minnesota,Brainerd,13389,800,2788,3704,909,489,8690
Minnesota,Lino Lakes,21150,386,3064,4524,4217,1854,14045
Minnesota,Paynesville,2482,287,543,598,189,99,1716
Minnesota,Lake Park,745,55,177,185,40,12,469
Minnesota,Winger,195,21,34,55,13,0,123
Minnesota,Farwell,27,3,11,5,3,1,23
Minnesota,Westport,38,18,3,13,1,0,35
Minnesota,Dundas,1555,35,222,364,188,146,955
Minnesota,Sleepy Eye,3414,260,876,768,381,79,2364
Minnesota,Williams,120,9,41,15,26,4,95
Minnesota,Naytahwaush,420,54,60,59,8,4,185
Minnesota,Luverne,4561,240,988,1008,581,254,3071
Minnesota,Steen,208,26,57,32,7,6,128
Minnesota,Wheaton,1491,108,364,403,145,65,1085
Minnesota,Porter,193,9,53,65,11,1,139
Minnesota,Mantorville,1082,32,202,288,147,59,728
Minnesota,Browerville,909,54,253,204,78,36,625
Minnesota,Osakis,1707,70,443,459,159,95,1226
Minnesota,Staples,3029,287,675,744,301,91,2098
Minnesota,Belgrade,1012,99,208,247,71,29,654
Minnesota,Clearwater,1776,58,373,444,206,52,1133
Minnesota,Cold Spring,4117,368,743,887,476,185,2659
Minnesota,Holdingford,570,32,183,120,72,2,409
Minnesota,St. Anthony city (Stearns County),115,2,31,17,7,6,63
Minnesota,St. Rosa,41,3,16,6,2,1,28
Minnesota,Cohasset,2724,86,439,779,487,153,1944
Minnesota,Deer River,954,61,238,226,84,25,634
Minnesota,Warba,134,0,28,48,7,4,87
Minnesota,Zemple,124,15,23,25,10,3,76
Minnesota,Lafayette,499,20,132,122,41,7,322
Minnesota,Mankato,41701,1369,4991,7051,5034,3030,21475
Minnesota,Erskine,438,60,131,102,16,31,340
Minnesota,Savage,30615,916,3049,6165,6181,3072,19383
Minnesota,Nassau,63,7,24,15,2,0,48
Minnesota,Stockton,755,27,174,181,67,21,470
Minnesota,Cottage Grove,36221,1023,5601,8600,5589,2343,23156
Minnesota,Foreston,553,31,102,172,25,12,342
Minnesota,Bock,92,8,16,25,4,0,53
Minnesota,Milaca,2876,333,780,597,167,83,1960
Minnesota,Renville,1380,152,319,286,115,4,876
Minnesota,Excelsior,2448,91,339,556,538,283,1807
Minnesota,Medicine Lake,422,5,45,56,101,95,302
Minnesota,Minnetrista,7408,91,695,1128,1950,1104,4968
Minnesota,Arco,98,8,27,23,6,1,65
Minnesota,Ivanhoe,563,45,146,173,35,15,414
Minnesota,Tyler,1381,117,400,239,162,28,946
Minnesota,Fergus Falls,13647,801,2584,3729,1974,675,9763
Minnesota,Richville,99,15,17,23,4,0,59
Minnesota,Karlstad,825,48,228,132,103,29,540
Minnesota,Redby,1428,117,186,274,25,0,602
Minnesota,Wells,2321,246,497,551,216,54,1564
Minnesota,Oslo,237,20,57,55,19,4,155
Minnesota,Brooklyn Park,79792,5506,11603,18193,11128,4445,50875
Minnesota,Woodland,407,3,11,69,147,87,317
Minnesota,Chanhassen,25357,348,1771,4042,7043,3501,16705
Minnesota,Minnetonka Beach,632,15,35,86,149,142,427
Minnesota,Tonka Bay,1410,10,171,238,428,225,1072
Minnesota,Vergas,355,27,63,103,25,21,239
Minnesota,Lake City,5165,421,1302,1265,617,358,3963
Minnesota,Lewisville,238,22,69,63,14,5,173
Minnesota,Center City,650,10,167,184,88,45,494
Minnesota,North Branch,10321,364,2479,2763,1028,316,6950
Minnesota,Minnesota Lake,625,10,162,204,53,11,440
Minnesota,Donaldson,14,0,12,2,0,0,14
Minnesota,St. Cloud,67513,3547,9971,14264,8154,4095,40031
Minnesota,Freeport,815,38,203,154,93,21,509
Minnesota,Richmond,1568,107,440,412,82,23,1064
Minnesota,Dovray,57,8,14,28,1,2,53
Minnesota,Spring Lake Park,6459,375,1580,1804,671,282,4712
Minnesota,Albertville,7377,151,1464,1642,1063,259,4579
Minnesota,Shelly,134,6,41,32,14,2,95
Minnesota,Vining,54,2,7,16,8,1,34
Minnesota,Mazeppa,850,53,177,201,84,31,546
Minnesota,Brooklyn Center,30899,3327,5630,6659,2832,1054,19502
Minnesota,Long Beach,309,4,53,103,59,27,246
Minnesota,Butterfield,586,136,164,54,31,3,388
Minnesota,Madelia,2690,333,567,482,195,68,1645
Minnesota,West Concord,873,48,251,174,46,8,527
Minnesota,Newfolden,358,21,70,88,28,11,218
Minnesota,East Gull Lake,950,19,110,260,225,106,720
Minnesota,Hackensack,244,15,47,93,12,7,174
Minnesota,Pillager,447,29,72,115,31,8,255
Minnesota,Plato,281,11,70,92,31,2,206
Minnesota,Cannon Falls,4064,164,898,1039,490,179,2770
Minnesota,Evan,67,7,21,15,10,3,56
Minnesota,Goodhue,1175,62,258,277,99,45,741
Minnesota,Northome,227,18,82,67,20,5,192
Minnesota,Ranier,646,23,193,225,62,17,520
Minnesota,Mahnomen,1222,102,379,275,43,28,827
Minnesota,Chandler,341,67,107,40,13,29,256
Minnesota,Wood Lake,453,23,111,133,28,9,304
Minnesota,Ponemah,610,73,136,30,19,0,258
Minnesota,Tenstrike,205,11,52,53,16,15,147
Minnesota,Kandiyohi,593,20,120,155,40,18,353
Minnesota,Red Lake Falls,1509,59,394,406,141,55,1055
Minnesota,Milan,360,59,70,57,27,12,225
Minnesota,Okabena,263,27,60,69,25,10,191
Minnesota,Bejou,75,2,38,21,1,1,63
Minnesota,St. Leo,122,20,37,33,2,2,94
Minnesota,Onamia,949,94,229,190,80,39,632
Minnesota,Kenyon,1983,121,499,437,205,77,1339
Minnesota,Dumont,104,13,21,22,5,5,66
Minnesota,Zumbrota,3395,113,714,945,381,207,2360
Minnesota,Littlefork,654,51,204,184,45,7,491
Minnesota,Hadley,62,3,25,15,8,0,51
Minnesota,Lake Wilson,226,15,78,83,13,1,190
Minnesota,Kenneth,63,2,26,23,2,0,53
Minnesota,Hazel Run,46,0,21,10,10,0,41
Minnesota,Elmore,470,40,161,103,37,12,353
Minnesota,Greenwald,275,13,90,58,5,2,168
Minnesota,Long Prairie,3331,562,669,466,396,87,2180
Minnesota,Albany,2691,353,585,486,268,90,1782
Minnesota,Eden Valley,968,65,283,214,39,19,620
Minnesota,New Munich,304,27,81,75,33,1,217
Minnesota,Waite Park,7623,724,1311,1694,581,222,4532
Minnesota,Calumet,438,20,126,131,15,1,293
Minnesota,Nashwauk,1119,69,239,339,77,28,752
Minnesota,Nimrod,89,1,23,36,1,1,62
Minnesota,Bloomington,85394,4577,12553,19693,17455,8266,62544
Minnesota,Vernon Center,356,10,103,76,32,16,237
Minnesota,Ghent,375,11,69,112,36,28,256
Minnesota,Taunton,146,10,53,23,7,4,97
Minnesota,Chokio,419,17,106,78,62,9,272
Minnesota,New Richland,1156,34,340,307,87,16,784
Minnesota,International Falls,6043,366,1536,1667,573,209,4351
Minnesota,Falcon Heights,5559,65,450,476,1143,1590,3724
Minnesota,Wanamingo,1249,79,271,328,123,46,847
Minnesota,Red Wing,16365,677,3952,4224,1822,962,11637
Minnesota,Pennock,555,46,101,163,13,9,332
Minnesota,Remer,353,36,94,105,17,5,257
Minnesota,Heidelberg,120,6,40,29,6,6,87
Minnesota,Kasota,801,61,230,184,64,13,552
Minnesota,Bena,109,17,21,29,0,1,68
Minnesota,Walker,998,43,204,205,168,34,654
Minnesota,Brownton,728,81,205,190,47,5,528
Minnesota,Good Thunder,603,30,135,173,39,26,403
Minnesota,Spring Valley,2439,122,700,600,152,93,1667
Minnesota,Funkley,14,1,4,5,0,0,10
Minnesota,Kelliher,281,18,110,54,20,11,213
Minnesota,Wendell,115,3,60,30,4,0,97
Minnesota,Glenville,590,40,212,161,44,11,468
Minnesota,Millville,166,9,58,43,5,3,118
Minnesota,Wabasha,2583,166,647,691,247,217,1968
Minnesota,Zumbro Falls,246,13,35,69,11,5,133
Minnesota,Ormsby,114,4,49,20,3,1,77
Minnesota,Dodge Center,2708,159,590,629,226,70,1674
Minnesota,Easton,190,6,59,60,22,3,150
Minnesota,Nevis,417,24,109,112,33,8,286
Minnesota,Park Rapids,3998,352,943,827,456,147,2725
Minnesota,Storden,273,4,74,75,18,1,172
Minnesota,Cass Lake,646,58,110,168,37,5,378
Minnesota,Glencoe,5495,471,1495,1140,385,113,3604
Minnesota,New Ulm,13248,649,3043,3118,1550,580,8940
Minnesota,Springfield,2056,110,591,464,162,62,1389
Minnesota,Canby,1627,147,468,413,146,36,1210
Minnesota,Avoca,96,13,34,28,2,4,81
Minnesota,Pease,245,12,66,62,18,4,162
Minnesota,Glenwood,2535,125,600,673,297,192,1887
Minnesota,Rush City,3139,254,1230,561,139,75,2259
Minnesota,Blomkest,143,6,51,46,5,1,109
Minnesota,Scanlon,1157,52,196,375,147,45,815
Minnesota,Caledonia,2769,154,765,660,275,70,1924
Minnesota,Spring Grove,1331,115,389,328,122,46,1000
Minnesota,Victoria,9032,153,562,1541,2299,1092,5647
Minnesota,Strathcona,24,2,13,7,1,0,23
Minnesota,Brewster,479,24,110,130,35,0,299
Minnesota,Dundee,99,7,50,9,6,0,72
Minnesota,Braham,1854,146,480,410,112,28,1176
Minnesota,Cottonwood,1281,66,329,231,160,73,859
Minnesota,Goodridge,156,10,44,41,7,0,102
Minnesota,Morris,5353,271,727,998,638,403,3037
Minnesota,Murdock,292,16,60,86,17,1,180
Minnesota,Heron Lake,751,51,159,193,94,9,506
Minnesota,Lakefield,1710,46,482,469,125,29,1151
Minnesota,Cleveland,744,29,163,208,57,13,470
Minnesota,Odessa,108,10,32,33,8,2,85
Minnesota,Deerwood,577,38,160,114,44,22,378
Minnesota,Racine,459,11,100,128,36,10,285
Minnesota,Waltham,132,6,36,35,5,4,86
Minnesota,Little Rock,1137,151,134,144,27,0,456
Minnesota,Evansville,606,20,171,207,65,9,472
Minnesota,Kensington,201,14,77,60,8,1,160
Minnesota,Holt,111,4,30,23,1,2,60
Minnesota,Walters,129,16,42,19,0,0,77
Minnesota,Alvarado,410,59,99,87,35,3,283
Minnesota,Grygla,164,15,48,35,17,7,122
Minnesota,Kiester,491,10,155,122,64,8,359
Minnesota,Middle River,264,21,79,51,29,6,186
Minnesota,Blue Earth,3146,208,1011,850,242,109,2420
Minnesota,Sacred Heart,540,47,160,101,33,4,345
Minnesota,Lakeland,1907,47,357,426,327,222,1379
Minnesota,Lake St. Croix Beach,1029,32,151,301,195,56,735
Minnesota,Aitkin,2282,261,560,480,196,69,1566
Minnesota,McGregor,383,34,99,78,23,4,238
Minnesota,Palisade,233,14,77,52,4,7,154
Minnesota,Lake Crystal,2511,202,520,582,313,130,1747
Minnesota,Balaton,602,34,197,136,64,9,440
Minnesota,St. Hilaire,213,31,57,64,5,2,159
Minnesota,Erhard,105,10,35,23,3,4,75
Minnesota,Odin,104,0,39,37,6,1,83
Minnesota,Granite Falls,2600,91,740,803,168,108,1910
Minnesota,Kellogg,502,48,149,135,24,13,369
Minnesota,Warren,1668,158,392,402,151,69,1172
Minnesota,Delavan,277,20,82,51,27,1,181
Minnesota,Winnebago,1355,111,395,286,98,53,943
Minnesota,Strandquist,84,8,29,10,5,0,52
Minnesota,St. Peter,11784,645,1813,2173,1278,789,6698
Minnesota,Grand Marais,1201,46,266,202,258,107,879
Minnesota,Biscay,106,6,38,44,1,0,89
Minnesota,Silver Lake,889,19,288,233,28,16,584
Minnesota,Dent,191,10,39,47,25,2,123
Minnesota,Perham,3345,223,701,725,505,117,2271
Minnesota,Miltona,391,20,80,116,36,8,260
Minnesota,Barrett,445,43,108,109,32,6,298
Minnesota,Elbow Lake,1278,84,275,367,135,45,906
Minnesota,Dennison,157,6,32,47,9,7,101
Minnesota,Lonsdale,3922,148,684,830,438,98,2198
Minnesota,Hayfield,1356,46,396,313,130,59,944
Minnesota,Winona,26981,1091,3858,5109,3230,1904,15192
Minnesota,Bingham Lake,194,10,54,43,14,3,124
Minnesota,Hammond,75,6,32,12,4,1,55
Minnesota,Doran,23,0,13,6,2,0,21
Minnesota,Bayport,3712,177,915,967,520,233,2812
Minnesota,Grant,4138,47,626,890,872,501,2936
Minnesota,Lakeland Shores,352,5,40,97,59,36,237
Minnesota,Oakdale,28018,1242,5126,6981,4282,1743,19374
Minnesota,Taylors Falls,1024,31,237,319,98,67,752
Minnesota,Moose Lake,2823,372,1089,712,229,44,2446
Minnesota,Eitzen,247,14,76,52,21,26,189
Minnesota,Delhi,25,9,13,1,2,0,25
Minnesota,Owatonna,25656,1391,5559,5473,3158,1599,17180
Minnesota,Morgan,865,75,202,172,99,24,572
Minnesota,Norwood Young America,3700,84,953,897,410,119,2463
Minnesota,Hartland,327,18,104,78,19,15,234
Minnesota,Le Roy,1083,67,253,243,121,42,726
Minnesota,Riverton,178,18,24,34,15,0,91
Minnesota,Roseville,35833,1496,4370,6295,7412,5508,25081
Minnesota,Rockville,2533,205,478,665,345,117,1810
Minnesota,Newport,3506,140,826,947,335,173,2421
Minnesota,Minneiska,103,7,15,49,14,7,92
Minnesota,St. Vincent,44,1,20,13,2,1,37
Minnesota,Rushmore,359,29,104,81,21,2,237
Minnesota,Hollandale,407,17,101,110,39,7,274
Minnesota,Pine Island,3456,106,500,756,546,233,2141
Minnesota,Lake Elmo,8794,316,1130,1493,1800,1147,5886
Minnesota,Warroad,1952,88,404,477,260,49,1278
Minnesota,Wanda,76,5,29,20,2,0,56
Minnesota,Afton,2980,65,354,565,775,480,2239
Minnesota,Campbell,204,5,51,51,13,4,124
Minnesota,Elgin,1240,58,233,297,149,27,764
Minnesota,Stewartville,6133,146,1144,1541,654,379,3864
Minnesota,Walnut Grove,709,85,139,141,46,15,426
Minnesota,Turtle River,94,1,19,39,15,5,79
Minnesota,Lanesboro,690,28,129,217,112,63,549
Minnesota,Peterson,200,18,61,46,16,13,154
Minnesota,Rushford,1806,126,421,460,178,59,1244
Minnesota,Brandon,608,26,161,138,80,9,414
Minnesota,Ashby,518,19,103,141,45,21,329
Minnesota,Fountain,375,16,85,99,52,17,269
Minnesota,Belview,336,45,112,95,20,5,277
Minnesota,Lamberton,754,90,237,151,65,23,566
Minnesota,Seaforth,85,6,14,24,7,0,51
Minnesota,Big Lake,10699,377,1708,2326,1381,394,6186
Minnesota,Oak Park Heights,4842,335,1229,1156,821,343,3884
Minnesota,La Crescent,5087,122,891,1341,804,372,3530
Minnesota,St. Charles,3723,109,674,952,489,236,2460
Minnesota,Forest Lake,19643,726,3576,4716,2559,1279,12856
Minnesota,St. Paul Park,5372,304,1135,1426,500,171,3536
Minnesota,Lake Bronson,183,21,96,26,10,1,154
Minnesota,Bowlus,269,12,84,57,17,2,172
Minnesota,Upsala,529,53,120,113,21,20,327
Minnesota,Bigelow,226,26,46,42,12,3,129
Minnesota,Chisago City,5043,274,1015,1599,662,164,3714
Minnesota,Barnum,632,46,109,163,57,11,386
Minnesota,Red Lake,1704,217,244,227,71,0,759
Minnesota,Garfield,253,9,55,93,27,4,188
Minnesota,Hoffman,587,35,150,141,36,16,378
Minnesota,Manchester,43,0,19,10,1,0,30
Minnesota,Twin Lakes,148,14,69,27,10,1,121
Minnesota,Elk River,24211,817,4338,6397,3241,1342,16135
Minnesota,Gilman,265,18,57,74,33,1,183
Minnesota,Bellingham,238,10,90,42,9,2,153
Minnesota,Garvin,128,11,57,24,6,1,99
Minnesota,Ihlen,46,1,31,5,4,2,43
Minnesota,Fairmont,10191,522,2854,2278,1228,409,7291
Minnesota,Barry,10,0,1,2,2,0,5
Minnesota,Lynd,526,32,78,118,56,14,298
Minnesota,Pemberton,275,8,94,55,12,5,174
Minnesota,Grasston,214,23,70,47,1,8,149
Minnesota,Federal Dam,107,8,28,32,8,1,77
Minnesota,Badger,403,25,85,84,33,11,238
Minnesota,Rose Creek,440,43,125,86,39,5,298
Minnesota,Brownsdale,613,27,186,189,45,24,471
Minnesota,Austin,25006,2725,4881,5199,2414,1365,16584
Minnesota,Manhattan Beach,73,0,33,17,3,1,54
Minnesota,Jenkins,420,11,109,106,13,15,254
Minnesota,Ironton,642,25,234,126,47,19,451
Minnesota,Emily,608,29,176,198,91,39,533
Minnesota,Cuyuna,288,7,85,113,6,2,213
Minnesota,Crosby,2825,267,705,661,186,101,1920
Minnesota,St. Anthony city (Hennepin and Ramsey Counties),9027,286,1363,1782,1822,1281,6534
Minnesota,Plymouth,77213,1219,7094,14155,19914,12418,54800
Minnesota,De Graff,134,13,36,37,13,3,102
Minnesota,Danvers,138,8,22,41,23,0,94
Minnesota,Brook Park,121,3,61,13,0,2,79
Minnesota,Rock Creek,1730,120,457,456,162,53,1248
Minnesota,Beltrami,120,12,34,32,10,0,88
Minnesota,Blackduck,856,34,253,216,36,16,555
Minnesota,Cromwell,269,26,94,63,16,3,202
Minnesota,Thief River Falls,8758,500,2128,2213,1029,193,6063
Minnesota,Marshall,13706,704,2531,2593,1691,648,8167
Minnesota,Clarkfield,937,59,194,230,98,27,608
Minnesota,Hanska,427,17,142,97,13,7,276
Minnesota,Windom,4459,334,1109,858,571,184,3056
Minnesota,Viking,109,11,42,19,13,0,85
Minnesota,Laporte,159,5,92,27,12,3,139
Minnesota,Pelican Rapids,2468,401,473,398,138,70,1480
Minnesota,Elizabeth,157,6,39,57,7,1,110
Minnesota,Appleton,1466,204,429,263,117,43,1056
Minnesota,Stephen,678,81,209,86,77,22,475
Minnesota,Cloquet,11998,329,2609,2933,1187,479,7537
Minnesota,Carlton,1063,74,298,321,113,27,833
Minnesota,Wyoming,7839,258,2019,2065,605,290,5237
Minnesota,Wykoff,447,39,105,127,29,2,302
Minnesota,Whalan,66,4,13,11,15,6,49
Minnesota,Ostrander,276,24,89,73,4,6,196
Minnesota,Mabel,794,55,275,182,71,15,598
Minnesota,Herman,443,9,157,136,31,10,343
Minnesota,Forada,200,5,61,60,18,9,153
Minnesota,Solway,68,3,11,29,6,3,52
Minnesota,Wright,129,2,48,25,0,10,85
Minnesota,Donnelly,261,11,98,43,8,9,169
Minnesota,Russell,340,15,109,73,25,8,230
Minnesota,Minneota,1349,115,376,304,140,33,968
Minnesota,Richfield,35982,2738,5092,7658,7001,3227,25716
Minnesota,Meire Grove,173,14,47,29,19,1,110
Minnesota,West Union,114,0,15,45,2,5,67
Minnesota,Wadena,4051,343,990,1074,291,52,2750
Minnesota,Aldrich,55,3,20,15,9,1,48
Minnesota,Little Canada,10387,701,1906,2656,1711,773,7747
Minnesota,Avon,1628,67,292,427,196,83,1065
Minnesota,Hewitt,185,9,53,58,11,4,135
Minnesota,Mahtomedi,8095,126,877,1624,1546,1330,5503
Minnesota,Hastings,22690,643,4945,5651,3173,1384,15796
Minnesota,Independence,3751,88,471,725,882,334,2500
Minnesota,Dellwood,1251,9,64,131,344,273,821
Minnesota,Landfall,754,148,204,88,19,5,464
Minnesota,Clements,123,2,56,23,3,0,84
Minnesota,Hayward,256,14,77,91,9,7,198
Minnesota,Emmons,415,24,119,98,31,6,278
Minnesota,Greenbush,835,31,187,216,91,7,532
Minnesota,White Bear Lake,25601,675,4731,6921,4155,2282,18764
Minnesota,St. Marys Point,361,3,55,95,62,33,248
Minnesota,Pine Springs,421,1,86,68,105,57,317
Minnesota,Lewiston,1639,97,334,435,200,38,1104
Minnesota,Foxhome,111,12,42,18,2,3,77
Minnesota,Utica,307,16,55,77,21,8,177
Minnesota,Wilder,55,8,17,10,0,0,35
Minnesota,Pine River,901,155,242,145,56,30,628
Minnesota,Boy River,37,5,15,6,0,0,26
Minnesota,Taopi,44,2,16,8,2,0,28
Minnesota,New London,1202,87,255,378,138,35,893
Minnesota,Leota,174,13,55,65,0,0,133
Minnesota,Swanville,311,25,89,72,18,7,211
Minnesota,Lastrup,173,4,60,34,8,10,116
Minnesota,Elmdale,74,9,20,26,6,2,63
Minnesota,Boyd,106,16,43,37,3,0,99
Minnesota,Lancaster,377,13,121,83,40,0,257
Minnesota,Halma,36,10,8,12,2,0,32
Minnesota,Hancock,798,34,144,226,101,20,525
Minnesota,Mountain Lake,2153,188,501,513,170,16,1388
Minnesota,Tracy,2172,149,531,538,173,35,1426
Minnesota,Winsted,2269,108,521,573,161,84,1447
Minnesota,Lester Prairie,1958,119,365,481,115,54,1134
Minnesota,Florence,23,0,12,3,0,0,15
Minnesota,Deer Creek,256,18,72,69,13,5,177
Minnesota,Clitherall,84,12,35,10,5,0,62
Minnesota,Bluffton,200,12,63,35,6,1,117
Minnesota,Hendricks,727,42,244,209,61,23,579
Minnesota,Spring Park,1829,94,465,540,370,116,1585
Minnesota,Shorewood,7752,70,567,1092,2189,1365,5283
Minnesota,Minneapolis,416021,28418,43376,67694,82479,53887,275854
Minnesota,Mapleton,1696,66,433,434,145,53,1131
Minnesota,Medford,1339,56,222,318,135,42,773
Minnesota,Kettle River,162,9,42,58,12,1,122
Minnesota,Brownsville,566,15,189,150,57,16,427
Minnesota,Rogers,12777,263,1739,2585,2712,826,8125
Minnesota,Harmony,994,66,282,281,131,58,818
Minnesota,Shafer,1121,42,208,273,102,26,651
Minnesota,Carver,4629,135,288,947,979,514,2863
Minnesota,Clear Lake,583,23,107,152,79,15,376
Minnesota,Kimball,907,29,179,244,65,23,540
Minnesota,Bricelyn,279,23,88,57,28,6,202
Minnesota,Corcoran,5775,229,1090,1392,1033,363,4107
Minnesota,Courtland,676,19,124,223,112,18,496
Minnesota,St. James,4455,622,1261,609,299,82,2873
Minnesota,Comfrey,399,22,106,98,32,17,275
Minnesota,Henning,904,74,178,277,61,29,619
Minnesota,Norcross,41,6,7,13,4,2,32
Minnesota,Kasson,6295,146,1380,1537,671,319,4053
Minnesota,Alexandria,13380,661,2767,3659,1568,555,9210
Minnesota,Revere,78,18,26,15,2,0,61
Minnesota,Dakota,311,27,64,89,39,10,229
Minnesota,Woodbury,68686,1197,5942,11631,15923,10033,44726
Minnesota,Lucan,190,4,48,50,19,7,128
Minnesota,Stewart,576,23,165,200,19,6,413
Minnesota,Alberta,144,4,37,47,16,3,107
Minnesota,Bagley,1496,177,380,317,120,40,1034
Minnesota,Plummer,319,5,68,99,26,3,201
Minnesota,Henderson,893,50,237,222,63,28,600
Minnesota,Baxter,8087,188,1215,2245,952,791,5391
Minnesota,Ogema,191,3,39,39,11,12,104
Minnesota,Hilltop,862,160,235,124,50,5,574
Minnesota,Sturgeon Lake,455,37,127,109,15,5,293
Minnesota,Mountain Iron,2852,169,574,833,336,119,2031
Minnesota,Bethel,471,24,110,136,24,7,301
Minnesota,Hibbing,16106,871,2533,5173,1569,525,10671
Minnesota,Waverly,1395,42,338,339,196,28,943
Minnesota,Maple Lake,2091,116,492,638,130,42,1418
Minnesota,Medina,6191,130,345,938,1381,1226,4020
Minnesota,Bemidji,15004,623,2226,3099,1464,877,8289
Minnesota,Ortonville,1965,195,663,396,110,64,1428
Minnesota,Spring Hill,62,12,15,21,5,1,54
Minnesota,Dalton,299,28,91,66,15,8,208
Minnesota,Argyle,722,102,192,143,86,10,533
Minnesota,Orono,8015,115,760,1146,2311,1356,5688
Minnesota,Plainview,3270,155,639,888,381,77,2140
Minnesota,Iona,128,12,30,45,7,0,94
Minnesota,Frost,234,10,51,62,10,5,138
Minnesota,Stacy,1808,111,407,415,148,39,1120
Minnesota,New Germany,443,16,118,105,33,8,280
Minnesota,Quamba,158,8,48,22,6,3,87
Minnesota,Janesville,2545,94,506,568,326,109,1603
Minnesota,Isle,746,81,209,178,74,30,572
Minnesota,Lismore,231,26,54,59,14,4,157
Minnesota,Taconite,634,36,177,199,38,23,473
Minnesota,Nicollet,1153,30,251,321,136,32,770
Minnesota,Glyndon,1245,54,224,273,158,64,773
Minnesota,Felton,136,17,35,45,10,0,107
Minnesota,Johnson,12,0,2,6,0,0,8
Minnesota,Comstock,95,2,13,28,12,14,69
Minnesota,Kerkhoven,691,47,128,156,70,14,415
Minnesota,Eagle Lake,2924,41,436,722,455,112,1766
Minnesota,Amboy,661,59,194,138,65,4,460
Minnesota,Tamarack,111,17,29,12,0,0,58
Minnesota,McGrath,36,7,11,17,0,0,35
Minnesota,Hill City,625,40,129,193,26,22,410
Minnesota,Hamburg,521,16,142,147,61,4,370
Minnesota,Rice Lake,293,44,45,46,2,2,139
Minnesota,St. Michael,17328,383,2024,3762,2905,1075,10149
Minnesota,Litchfield,6631,427,1778,1622,622,231,4680
Minnesota,Brooks,137,22,43,40,10,0,115
Minnesota,Winthrop,1411,90,354,349,122,59,974
Minnesota,Green Isle,626,27,172,117,46,13,375
Minnesota,Gibbon,842,106,177,192,39,10,524
Minnesota,Elkton,113,3,27,33,7,1,71
Minnesota,Crosslake,2015,20,587,531,431,169,1738
Minnesota,Waterville,1984,125,541,430,177,103,1376
Minnesota,Spicer,1255,61,275,298,194,82,910
Minnesota,Borup,87,1,28,27,6,0,62
Minnesota,Chaska,25998,816,3142,4997,5371,2395,16721
Minnesota,Mayer,1990,32,276,461,351,101,1221
Minnesota,Georgetown,95,11,24,19,9,0,63
Minnesota,Arden Hills,10290,307,787,1246,2161,1524,6025
Minnesota,Mapleview,124,15,38,37,4,1,95
Minnesota,Benson,3086,226,650,916,318,89,2199
Minnesota,Hanley Falls,419,30,75,96,26,5,232
Minnesota,Magnolia,208,30,55,43,19,3,150
Minnesota,Fulda,1309,139,359,288,92,74,952
Minnesota,North Oaks,5068,35,255,629,1408,1539,3866
Minnesota,Waubun,523,19,123,102,26,7,277
Minnesota,Skyline,333,7,33,54,107,50,251
Minnesota,St. Clair,851,21,160,164,109,43,497
Minnesota,Watertown,4372,153,688,1264,486,267,2858
Minnesota,Ogilvie,451,39,120,77,28,8,272
Minnesota,Longville,158,5,51,35,8,47,146
Minnesota,Lake Shore,929,33,146,282,248,80,789
Minnesota,Chickamaw Beach,127,6,31,40,16,11,104
Minnesota,Rosemount,23885,593,2519,5112,5141,2047,15412
Minnesota,Lakeville,62489,1511,6561,12042,14309,5430,39853
Minnesota,Callaway,186,11,60,56,3,2,132
Minnesota,Eagan,66363,1599,6774,13640,15804,8129,45946
Minnesota,Clearbrook,452,44,103,131,51,16,345
Minnesota,Foley,2647,166,582,581,228,82,1639
Minnesota,Moorhead,42395,1214,5552,8674,6588,2449,24477
Minnesota,Hutchinson,13882,523,3319,3863,1324,622,9651
Minnesota,Clontarf,146,10,36,46,10,0,102
Minnesota,Blooming Prairie,1860,135,411,429,171,48,1194
Minnesota,Lindstrom,4516,168,744,1142,585,278,2917
Minnesota,Lengby,57,10,20,13,6,3,52
Minnesota,Willow River,439,50,95,108,53,10,316
Minnesota,Sandstone,2683,153,1018,740,123,36,2070
Minnesota,Askov,343,35,84,94,46,12,271
Minnesota,Ruthton,256,31,64,53,16,3,167
Minnesota,Twin Valley,735,56,202,176,66,26,526
Minnesota,South St. Paul,20256,1223,3509,5005,2803,744,13284
Minnesota,Le Sueur,4009,280,914,1047,485,73,2799
Minnesota,Sargeant,40,2,18,11,0,1,32
Minnesota,Adams,774,65,227,181,105,23,601
Minnesota,Breezy Point,2305,30,357,667,456,154,1664
Minnesota,Ulen,521,10,207,115,51,21,404
Minnesota,Hawley,1925,92,304,428,278,79,1181
Minnesota,Rollingstone,646,16,103,191,115,26,451
Minnesota,Rothsay,531,23,127,135,70,29,384
Minnesota,Nashua,12,2,5,2,0,0,9
Minnesota,Kent,57,1,16,18,9,2,46
Minnesota,Elba,78,5,39,19,3,0,66
Minnesota,Eyota,1945,71,326,541,253,87,1278
Minnesota,Zimmerman,5541,193,1070,1465,611,193,3532
Minnesota,Becker,4787,190,799,1315,714,201,3219
Minnesota,Hallock,1052,33,300,211,154,61,759
Minnesota,Wabasso,790,31,185,174,98,34,522
Minnesota,Willmar,19618,2296,3103,4369,1709,774,12251
Minnesota,Le Center,2650,242,570,523,218,86,1639
Minnesota,Elko New Market,4604,36,543,717,940,430,2666
Minnesota,Columbus,4037,119,939,1238,457,239,2992
Minnesota,Nowthen,4649,72,728,1284,596,211,2891
Minnesota,St. Augusta,3669,118,655,1116,420,167,2476
Minnesota,Nisswa,1937,47,326,477,398,170,1418
Minnesota,Backus,334,42,97,54,7,4,204
Minnesota,Westbrook,746,60,212,177,60,26,535
Minnesota,Oklee,473,30,134,93,37,0,294
Minnesota,Grand Meadow,1065,53,239,283,64,51,690
Minnesota,Pequot Lakes,2330,63,432,543,292,156,1486
Minnesota,Garrison,206,34,80,52,10,9,185
Minnesota,Fort Ripley,38,5,13,10,1,1,30
Minnesota,Wayzata,4518,102,433,948,1127,862,3472
Minnesota,St. Bonifacius,2219,107,372,633,374,120,1606
Minnesota,Long Lake,1768,37,312,414,388,143,1294
Minnesota,Greenwood,686,4,43,126,274,127,574
Minnesota,Ellsworth,469,75,87,105,63,12,342
Minnesota,Adrian,1150,45,366,264,71,30,776
Minnesota,Marietta,156,22,66,36,14,2,140
Minnesota,Louisburg,37,4,9,11,8,0,32
Minnesota,Kennedy,264,8,64,81,32,4,189
Minnesota,Kilkenny,188,9,60,35,13,2,119
Minnesota,Sanborn,346,42,125,87,17,3,274
Minnesota,Geneva,354,17,94,93,29,19,252
Minnesota,Freeborn,264,23,66,71,12,9,181
Minnesota,Sedan,48,2,19,19,4,0,44
Minnesota,Lowry,405,13,87,106,40,6,252
Minnesota,Sunburg,77,5,27,20,11,0,63
Minnesota,Madison Lake,937,21,173,280,125,71,670
Minnesota,Mora,3480,216,976,853,257,163,2465
Minnesota,Atwater,1005,51,218,303,76,24,672
Minnesota,Jeffers,375,37,131,80,18,4,270
Minnesota,Stillwater,19275,418,2461,3957,3928,2251,13015
Minnesota,Redwood Falls,5004,303,1425,1045,484,175,3432
Minnesota,Milroy,223,16,41,57,16,11,141
Minnesota,Fifty Lakes,308,13,76,97,48,22,256
Minnesota,Floodwood,467,44,167,138,10,8,367
Minnesota,Biwabik,706,17,198,247,51,19,532
Minnesota,Aurora,1640,144,424,377,118,73,1136
Minnesota,Howard Lake,1958,116,569,488,139,46,1358
Minnesota,Buffalo,16092,572,2846,3624,2350,741,10133
Minnesota,Sherburn,1058,63,262,300,64,23,712
Minnesota,South Haven,188,9,71,36,5,1,122
Minnesota,Inver Grove Heights,35197,1513,5927,8134,6396,2261,24231
Minnesota,Frazee,1439,148,378,316,93,39,974
Minnesota,Watkins,953,108,235,214,33,10,600
Minnesota,Starbuck,1337,120,326,341,107,46,940
Minnesota,Villard,286,3,67,95,12,3,180
Minnesota,Buffalo Lake,650,89,168,160,32,7,456
Minnesota,Fairfax,1037,115,285,273,46,17,736
Minnesota,Clarks Grove,678,67,183,211,36,5,502
Minnesota,Albert Lea,17687,1643,4582,4321,1487,594,12627
Minnesota,Rushford Village,843,16,177,254,101,39,587
Minnesota,Preston,1409,81,288,376,163,81,989
Minnesota,Nelson,187,15,61,60,13,1,150
Minnesota,Millerville,109,7,34,21,7,2,71
Minnesota,Carlos,458,19,116,143,23,12,313
Minnesota,Wilton,174,6,43,53,11,8,121
Minnesota,Robbinsdale,14466,684,2225,3834,2916,1009,10668
Minnesota,Osseo,2731,159,644,886,320,139,2148
Minnesota,Chatfield,2845,102,626,600,392,187,1907
Minnesota,New Hope,20922,1333,3891,4569,3650,1037,14480
Minnesota,Minnetonka,52546,932,5160,10025,14358,9046,39521
Minnesota,Maple Grove,69571,1095,7231,14436,16819,9126,48707
Minnesota,Loretto,746,20,129,167,119,53,488
Minnesota,Hopkins,18300,798,2747,3782,4017,1617,12961
Minnesota,Golden Valley,21364,335,2106,4449,5777,3856,16523
Minnesota,Dayton,5487,177,972,1101,966,490,3706
Minnesota,Champlin,24478,379,3499,6109,4320,2084,16391
Minnesota,Olivia,2477,204,539,650,209,92,1694
Minnesota,Hector,1005,104,203,316,64,22,709
Minnesota,Franklin,530,67,129,122,19,5,342
Minnesota,Mound,9412,185,1306,2478,2182,969,7120
Minnesota,Angle Inlet,0,0,0,0,0,0,0
Minnesota,Scandia,4083,72,734,1205,762,241,3014
Minnesota,Ball Club,174,18,35,63,7,3,126
Minnesota,Nerstrand,348,5,79,95,29,15,223
Minnesota,Cyrus,339,27,87,69,23,1,207
Minnesota,Wahkon,211,28,82,53,7,8,178
Minnesota,Sauk Centre,4404,447,1060,863,362,116,2848
Minnesota,Faribault,23711,2702,5743,4999,1923,924,16291
Minnesota,Sartell,17076,291,1739,3988,3316,1412,10746
Minnesota,Melrose,3634,494,759,822,252,91,2418
Minnesota,Brooten,632,23,185,126,87,14,435
Minnesota,Grey Eagle,396,23,141,88,27,2,281
Minnesota,Burtrum,118,13,36,24,4,0,77
Minnesota,St. Paul,302760,26164,39264,48732,44889,31543,190592
Minnesota,Morton,342,24,134,76,14,4,252
Minnesota,Danube,521,42,130,114,39,11,336
Minnesota,Northfield,20217,441,2122,3051,2615,2184,10413
Minnesota,Morristown,1036,75,318,225,90,33,741
Minnesota,Darfur,68,5,37,10,1,0,53
Minnesota,Bellechester,188,12,67,35,9,4,127
Minnesota,St. Stephen,916,29,222,249,74,29,603
Minnesota,St. Joseph,6938,87,547,1364,681,560,3239
Minnesota,Elrosa,197,30,55,54,10,2,151
Minnesota,Clarissa,732,73,211,153,51,3,491
Minnesota,Bird Island,884,57,267,243,57,43,667
Minnesota,Currie,222,25,84,46,19,6,180
Minnesota,Slayton,2008,152,530,478,220,56,1436
Minnesota,Hardwick,234,15,60,52,14,10,151
Minnesota,Harris,947,38,332,288,72,15,745
Minnesota,Princeton,4720,322,1320,1079,246,125,3092
Minnesota,Myrtle,77,1,33,13,0,0,47
Minnesota,Conger,127,6,31,40,11,0,88
Minnesota,Alden,654,51,161,155,55,18,440
Minnesota,Dover,832,35,159,210,90,27,521
Minnesota,Canton,343,27,85,96,23,4,235
Minnesota,Tintah,40,2,14,9,0,0,25
Minnesota,Baudette,1057,62,280,248,102,43,735
Minnesota,Mizpah,96,6,32,18,3,1,60
Minnesota,Baker,44,0,13,17,2,2,34
Minnesota,Big Falls,248,36,51,76,14,1,178
Minnesota,Cobden,20,3,6,8,0,0,17
Minnesota,Urbank,92,5,16,23,13,1,58
Minnesota,Lake Benton,677,39,192,152,51,29,463
Minnesota,St. Martin,341,31,89,78,15,5,218
Minnesota,Lake Henry,58,5,19,21,2,1,48
Minnesota,Effie,94,2,18,24,10,2,56
Minnesota,Bigfork,383,57,117,123,27,8,332
Minnesota,Echo,282,10,72,69,19,5,175
Minnesota,Squaw Lake,99,10,22,24,4,0,60
Minnesota,Jasper,606,45,227,138,47,2,459
Minnesota,Browns Valley,565,37,190,166,15,3,411
Minnesota,Keewatin,1001,105,240,284,93,7,729
Minnesota,Bertha,641,54,109,121,39,17,340
Minnesota,New Brighton,22560,773,3247,4250,4967,2548,15785
Minnesota,Osage,314,18,86,85,25,20,234
Minnesota,Nett Lake,361,32,81,67,8,4,192
Minnesota,Midway,18,6,1,3,0,0,10
Minnesota,Merrifield,86,5,53,11,12,0,81
Minnesota,Martin Lake,878,25,192,303,85,26,631
Minnesota,Mahtowa,371,17,96,107,23,18,261
Minnesota,Mahnomen,215,31,45,48,0,0,124
Minnesota,Lansing,161,27,49,31,5,0,112
Minnesota,Lake George,231,4,65,67,31,20,187
Minnesota,Inger,220,36,18,57,0,0,111
Minnesota,Lutsen,265,7,37,53,54,18,169
Minnesota,Homer,213,8,27,73,31,35,174
Minnesota,Garden City,264,24,71,51,25,8,179
Minnesota,Frontenac,228,2,77,45,33,8,165
Minnesota,Fish Lake,113,2,19,37,28,1,87
Minnesota,Finland,214,8,116,45,7,4,180
Minnesota,Fairhaven,408,19,82,134,14,26,275
Minnesota,Esko,1740,12,249,518,333,111,1223
Minnesota,Ebro,78,6,11,21,0,1,39
Minnesota,Big Lake,414,14,72,130,48,36,300
Minnesota,Beaulieu,34,3,20,3,0,0,26
Minnesota,Sebeka,824,35,192,210,55,16,508
Minnesota,Riverland,301,35,32,49,2,2,120
Minnesota,Pine Bend,57,24,1,11,0,0,36
Minnesota,Roy Lake,23,0,9,3,5,0,17
Minnesota,Maplewood,40387,2578,7780,9101,5597,3303,28359
Minnesota,Lauderdale,2514,72,213,413,614,589,1901
Minnesota,Trommald,69,6,29,13,7,0,55
Minnesota,Eagle Bend,458,54,145,136,23,10,368
Minnesota,Marble,590,57,170,143,46,5,421
Minnesota,La Prairie,916,25,235,221,66,33,580
Minnesota,Grand Rapids,11140,503,2203,3207,1317,573,7803
Minnesota,Coleraine,1648,53,329,477,228,61,1148
Minnesota,Menahga,1074,84,359,261,65,25,794
Minnesota,Ronneby,35,0,16,9,0,0,25
Minnesota,North St. Paul,12342,844,2663,2665,1709,660,8541
Minnesota,Vadnais Heights,13376,341,2108,2844,2629,1655,9577
Minnesota,Rice Lake,4142,153,991,1171,493,151,2959
Minnesota,Whipholt,111,1,11,44,20,7,83
Minnesota,West Roy Lake,37,3,11,15,2,0,31
Minnesota,Warsaw,679,6,173,171,101,35,486
Minnesota,Twin Lakes,210,12,36,53,24,7,132
Minnesota,The Ranch,2,2,0,0,0,0,2
Minnesota,Stanchfield,57,14,14,22,0,0,50
Minnesota,Soudan,395,10,77,174,51,9,321
Minnesota,Silver Creek,251,15,59,90,28,0,192
Minnesota,Searles,285,10,119,62,15,0,206
Minnesota,South End,43,10,6,9,0,0,25
Minnesota,Coates,232,21,56,54,29,2,162
Mississippi,Corinth,14647,1567,2865,3179,1342,856,9809
Mississippi,Leland,4058,609,745,694,367,239,2654
Mississippi,Laurel,18607,2633,3345,3602,1628,1119,12327
Mississippi,Heidelberg,830,70,255,190,32,61,608
Mississippi,Diamondhead,8149,228,1244,2484,1523,834,6313
Mississippi,Summit,2185,283,440,381,106,89,1299
Mississippi,Montrose,133,13,31,26,15,9,94
Mississippi,Natchez,15188,1828,3280,2982,1320,1084,10494
Mississippi,Iuka,2978,576,854,534,118,53,2135
Mississippi,Tutwiler,4398,1561,1013,557,106,9,3246
Mississippi,Sebastopol,387,26,51,88,37,20,222
Mississippi,Union,2126,298,449,413,158,65,1383
Mississippi,Saucier,1191,74,305,288,97,95,859
Mississippi,Sumrall,1635,91,304,343,189,142,1069
Mississippi,Sunflower,1158,204,184,188,81,26,683
Mississippi,Amory,6983,1117,1491,1236,677,432,4953
Mississippi,Petal,10669,552,1758,2397,1172,662,6541
Mississippi,Columbus,24272,2686,5259,4772,2078,1510,16305
Mississippi,Terry,1344,85,197,278,212,110,882
Mississippi,Belzoni,2009,300,541,270,123,98,1332
Mississippi,Greenwood,14280,1815,3422,2037,1204,626,9104
Mississippi,Verona,3105,729,632,698,95,20,2174
Mississippi,Eupora,2317,242,529,395,73,150,1389
Mississippi,Boyle,987,94,157,239,56,39,585
Mississippi,Chunky,415,57,97,103,21,2,280
Mississippi,Starkville,25122,1233,2475,3342,3133,3489,13672
Mississippi,New Augusta,688,104,151,124,34,18,431
Mississippi,Centreville,1616,150,554,232,76,29,1041
Mississippi,Anguilla,636,104,111,143,50,22,430
Mississippi,Shubuta,386,46,138,48,6,8,246
Mississippi,Crosby,337,60,85,24,3,5,177
Mississippi,West Hattiesburg,5933,596,692,1209,570,598,3665
Mississippi,Cary,296,46,76,86,20,12,240
Mississippi,Oakland,541,99,101,99,1,12,312
Mississippi,Soso,464,77,99,106,36,6,324
Mississippi,McComb,12723,1625,3134,2141,599,322,7821
Mississippi,Ellisville,4815,596,711,753,401,232,2693
Mississippi,Collinsville,1606,124,315,509,128,267,1343
Mississippi,Glen,541,35,86,172,33,10,336
Mississippi,Wade,966,80,246,217,130,0,673
Mississippi,De Kalb,1278,148,363,255,83,52,901
Mississippi,Enterprise,650,40,119,161,35,11,366
Mississippi,Sledge,400,87,82,104,9,14,296
Mississippi,Crowder,747,159,159,70,43,0,431
Mississippi,Richton,904,117,187,168,77,41,590
Mississippi,Meridian,38602,3914,6966,9380,3290,2109,25659
Mississippi,West Point,10794,1254,2304,2144,933,506,7141
Mississippi,Sidon,443,71,137,30,0,12,250
Mississippi,Nellieburg,1398,161,311,307,81,82,942
Mississippi,Silver Creek,126,7,62,24,2,0,95
Mississippi,Columbus AFB,1673,42,79,200,220,174,715
Mississippi,Lumberton,1839,127,410,515,91,70,1213
Mississippi,Marietta,248,27,51,87,10,17,192
Mississippi,Hattiesburg,46251,3441,6142,8785,4983,4000,27351
Mississippi,Long Beach,15529,792,3206,4409,1306,930,10643
Mississippi,Walnut,1195,107,268,197,67,44,683
Mississippi,Louise,236,44,42,45,22,6,159
Mississippi,Gulfport,71570,6512,13662,16490,6510,3548,46722
Mississippi,Mantee,220,16,66,46,28,5,161
Mississippi,Kiln,2112,213,214,815,117,148,1507
Mississippi,Port Gibson,1699,192,302,280,176,138,1088
Mississippi,Arnold Line,2501,90,489,587,318,263,1747
Mississippi,Alcorn State University,1017,0,0,41,14,153,208
Mississippi,Paden,129,10,32,31,8,0,81
Mississippi,Falkner,819,46,174,179,93,25,517
Mississippi,Aberdeen,5347,709,1157,1015,453,201,3535
Mississippi,Caledonia,1586,199,236,321,154,60,970
Mississippi,Pontotoc,5997,865,1038,1276,482,146,3807
Mississippi,Beaumont,995,153,340,232,36,0,761
Mississippi,Tillatoba,25,0,13,12,0,0,25
Mississippi,Utica,800,113,115,227,55,27,537
Mississippi,Weir,746,89,189,99,40,10,427
Mississippi,Kossuth,254,26,66,62,32,7,193
Mississippi,Pittsboro,184,9,53,58,1,11,132
Mississippi,Jonestown,1124,224,98,295,37,12,666
Mississippi,Walthall,92,9,10,19,25,11,74
Mississippi,Waynesboro,4910,889,1128,513,208,194,2932
Mississippi,Richland,7185,702,1511,1619,480,142,4454
Mississippi,Picayune,11140,1321,1817,2767,890,356,7151
Mississippi,Quitman,2001,271,504,406,235,92,1508
Mississippi,West,173,36,30,27,22,3,118
Mississippi,Isola,849,133,187,136,42,33,531
Mississippi,Fayette,1333,188,180,154,47,144,713
Mississippi,Cleveland,11998,1379,1488,2069,1332,1014,7282
Mississippi,Bude,785,154,137,172,27,45,535
Mississippi,Mize,229,38,34,44,11,16,143
Mississippi,Algoma,849,139,168,123,22,26,478
Mississippi,Jumpertown,668,80,149,143,25,13,410
Mississippi,Potts Camp,613,102,149,103,17,5,376
Mississippi,Batesville,7303,620,1072,1253,805,319,4069
Mississippi,Purvis,2493,154,579,598,198,66,1595
Mississippi,Liberty,831,92,270,149,53,37,601
Mississippi,Hernando,15807,927,2412,3725,2032,1117,10213
Mississippi,Ocean Springs,17613,615,3033,3892,2571,1762,11873
Mississippi,Crawford,428,60,147,60,27,6,300
Mississippi,Bolton,654,70,192,173,35,18,488
Mississippi,Snow Lake Shores,289,19,87,105,30,24,265
Mississippi,Bentonia,335,52,79,86,34,0,251
Mississippi,Woodville,1205,128,257,231,142,17,775
Mississippi,Farmington,2532,171,489,650,190,61,1561
Mississippi,Metcalfe,900,102,175,132,83,2,494
Mississippi,Rienzi,308,66,82,78,3,7,236
Mississippi,French Camp,268,2,3,71,22,19,117
Mississippi,Big Point,633,131,94,236,49,0,510
Mississippi,Meridian Station,620,0,15,125,14,20,174
Mississippi,Saltillo,4991,434,763,1193,401,360,3151
Mississippi,Nettleton,2103,357,553,343,80,56,1389
Mississippi,Latimer,6861,762,1582,1774,482,300,4900
Mississippi,Clinton,25456,1472,2705,5379,4214,2686,16456
Mississippi,Hickory Flat,587,104,138,111,19,12,384
Mississippi,Morgan City,215,31,65,3,11,11,121
Mississippi,Carrollton,148,6,22,24,34,21,107
Mississippi,Lynchburg,2558,140,523,670,158,165,1656
Mississippi,Falcon,146,36,21,19,1,2,79
Mississippi,Biloxi,45568,3859,8106,10410,4744,2554,29673
Mississippi,Pass Christian,5669,434,585,1359,777,482,3637
Mississippi,Pope,230,35,40,34,29,26,164
Mississippi,Blue Springs,329,42,60,49,25,5,181
Mississippi,Pelahatchie,1433,220,384,220,46,45,915
Mississippi,Brandon,23688,1151,2890,5979,3839,2469,16328
Mississippi,Shaw,1733,324,255,290,141,90,1100
Mississippi,Moorhead,1792,159,271,334,33,49,846
Mississippi,Tremont,466,66,81,107,18,37,309
Mississippi,Lexington,2018,235,549,275,116,65,1240
Mississippi,Hazlehurst,3877,458,901,834,266,120,2579
Mississippi,D'Lo,612,80,124,132,18,43,397
Mississippi,Beauregard,482,56,66,110,12,13,257
Mississippi,Mound Bayou,1728,218,283,314,139,59,1013
Mississippi,Pearlington,1022,219,264,255,44,22,804
Mississippi,Ripley,5282,858,1106,749,358,190,3261
Mississippi,Sardis,2245,363,407,388,150,65,1373
Mississippi,Courtland,492,59,133,66,29,13,300
Mississippi,Hickory,654,28,139,160,9,6,342
Mississippi,Carthage,4862,554,1032,766,245,147,2744
Mississippi,New Hope,3759,298,568,1021,531,186,2604
Mississippi,Ackerman,1534,229,367,322,150,87,1155
Mississippi,Artesia,392,56,113,78,11,1,259
Mississippi,Tylertown,1791,254,444,328,155,94,1275
Mississippi,Flowood,8870,373,1231,1718,1648,1373,6343
Mississippi,Canton,12330,2024,2364,2000,913,640,7941
Mississippi,Vaiden,592,146,179,56,22,53,456
Mississippi,Ridgeland,24265,922,2484,4142,4932,3460,15940
Mississippi,Clarksdale,16174,1749,2475,3589,1287,640,9740
Mississippi,Vicksburg,22706,2249,4382,4562,1990,1283,14466
Mississippi,Sylvarena,98,0,34,26,1,4,65
Mississippi,Baldwyn,2998,405,821,645,166,104,2141
Mississippi,Senatobia,7966,813,1093,1588,761,289,4544
Mississippi,Flora,1800,162,325,349,178,54,1068
Mississippi,Sumner,252,35,21,88,30,20,194
Mississippi,Mantachie,1387,226,382,260,65,12,945
Mississippi,Pace,183,39,43,49,13,14,158
Mississippi,Water Valley,3339,399,918,538,223,163,2241
Mississippi,Hollandale,2293,400,459,408,125,98,1490
Mississippi,Arcola,338,64,53,71,12,2,202
Mississippi,Moss Point,13487,1211,3529,3702,1020,526,9988
Mississippi,Scooba,954,73,74,83,23,14,267
Mississippi,Meadville,622,53,134,125,52,58,422
Mississippi,Forest,5668,1374,1168,974,297,103,3916
Mississippi,Guntown,2654,197,400,675,266,71,1609
Mississippi,Shannon,1862,257,351,403,79,22,1112
Mississippi,Satartia,30,1,6,9,8,1,25
Mississippi,Inverness,915,137,158,194,88,49,626
Mississippi,Lucedale,3059,403,932,600,220,93,2248
Mississippi,Georgetown,262,55,75,56,12,3,201
Mississippi,Renova,949,128,160,154,79,17,538
Mississippi,Beulah,503,75,56,101,39,8,279
Mississippi,Lake,397,45,80,84,12,3,224
Mississippi,Sturgis,229,17,62,57,30,10,176
Mississippi,Doddsville,280,37,29,49,12,7,134
Mississippi,Durant,2908,378,770,482,89,47,1766
Mississippi,Merigold,402,51,83,79,51,24,288
Mississippi,Benoit,477,103,98,72,28,14,315
Mississippi,Magee,4301,636,892,977,133,172,2810
Mississippi,Philadelphia,7284,942,1617,1124,507,353,4543
Mississippi,Lyman,2405,241,509,523,150,124,1547
Mississippi,Booneville,8767,909,1895,1506,546,459,5315
Mississippi,Indianola,9624,1481,1575,1778,773,514,6121
Mississippi,Mendenhall,2835,346,532,522,167,136,1703
Mississippi,Braxton,240,66,31,61,9,0,167
Mississippi,Ruleville,2719,333,528,577,193,96,1727
Mississippi,Puckett,335,25,56,116,24,4,225
Mississippi,Horn Lake,26925,2295,5993,5919,1637,887,16731
Mississippi,Toccopola,288,30,83,59,7,11,190
Mississippi,Pachuta,185,42,42,39,17,12,152
Mississippi,Raleigh,1409,222,367,273,70,47,979
Mississippi,Taylorsville,1998,155,503,383,80,103,1224
Mississippi,Bay Springs,1511,128,366,271,165,54,984
Mississippi,Friars Point,1209,155,190,281,41,11,678
Mississippi,Holly Springs,7578,1180,1666,1207,445,231,4729
Mississippi,Conehatta,1208,183,122,118,109,0,532
Mississippi,Decatur,1917,147,204,339,91,94,875
Mississippi,Lula,243,66,22,59,15,4,166
Mississippi,Calhoun City,1866,313,332,328,118,103,1194
Mississippi,Bassfield,359,49,77,85,10,15,236
Mississippi,Oxford,23037,753,1689,2886,3700,3481,12509
Mississippi,Taylor,260,20,38,73,34,32,197
Mississippi,Wiggins,4552,686,930,1028,240,152,3036
Mississippi,Escatawpa,2811,255,927,986,130,54,2352
Mississippi,Gautier,18563,1498,2732,4962,1693,1038,11923
Mississippi,Vancleave,5048,255,1092,1323,425,149,3244
Mississippi,Greenville,31319,3990,5928,6209,2500,1610,20237
Mississippi,Noxapater,419,75,129,81,10,10,305
Mississippi,Abbeville,395,49,93,84,33,10,269
Mississippi,Seminary,439,85,73,86,39,14,297
Mississippi,Mount Olive,1041,67,278,173,50,52,620
Mississippi,Grenada,12633,1914,2281,2577,1015,534,8321
Mississippi,Myrtle,468,65,117,105,28,8,323
Mississippi,Pearl,26508,1827,6088,5968,2077,1093,17053
Mississippi,Stonewall,961,123,249,279,65,5,721
Mississippi,Coffeeville,1108,103,245,169,94,47,658
Mississippi,Newton,3251,231,607,922,306,46,2112
Mississippi,Charleston,2086,343,452,359,100,28,1282
Mississippi,Madison,25522,341,1450,3894,6492,4679,16856
Mississippi,Plantersville,850,96,230,228,97,25,676
Mississippi,Tupelo,38270,3258,5258,8401,5008,2791,24716
Mississippi,Pearl River,4205,784,688,803,82,45,2402
Mississippi,Walls,1347,99,223,303,93,32,750
Mississippi,Polkville,633,68,171,122,17,10,388
Mississippi,Glendora,54,8,6,13,0,2,29
Mississippi,Coldwater,1646,326,424,335,66,61,1212
Mississippi,Burnsville,936,134,223,159,2,9,527
Mississippi,Magnolia,2119,351,637,308,217,34,1547
Mississippi,Ecru,1237,168,231,224,76,49,748
Mississippi,Thaxton,909,67,155,213,58,34,527
Mississippi,Brooksville,1063,190,218,176,88,17,689
Mississippi,New Hebron,631,39,117,150,57,12,375
Mississippi,North Carrollton,303,59,69,39,13,3,183
Mississippi,Derma,1045,170,341,128,21,14,674
Mississippi,Woodland,184,27,24,39,2,0,92
Mississippi,Hillsboro,1124,225,183,138,93,9,648
Mississippi,Holcomb,445,32,103,68,20,85,308
Mississippi,Kearney Park,1434,106,129,345,67,11,658
Mississippi,Lauderdale,487,11,215,10,0,12,248
Mississippi,Mississippi State,4073,0,0,49,36,81,166
Mississippi,Mississippi Valley State University,1348,10,0,88,29,46,173
Mississippi,Morgantown,1655,434,366,233,110,95,1238
Mississippi,New Hamilton,523,34,141,75,98,30,378
Mississippi,Hide-A-Way Lake,2332,68,371,696,343,259,1737
Mississippi,Nicholson,2473,394,527,519,84,124,1648
Mississippi,Robinhood,1438,270,338,271,75,50,1004
Mississippi,Sharon,1020,80,143,349,25,98,695
Mississippi,Toomsuba,980,43,134,313,0,0,490
Mississippi,Mooreville,879,94,174,246,60,61,635
Mississippi,Tunica Resorts,2292,96,288,788,352,148,1672
Mississippi,University,4490,47,14,0,0,0,61
Mississippi,White Oak,323,193,60,19,0,0,272
Mississippi,Florence,4384,52,922,980,481,214,2649
Mississippi,Rawls Springs,920,71,242,148,121,28,610
Mississippi,Henderson Point,197,24,90,52,12,13,191
Mississippi,Hamilton,427,38,120,120,34,10,322
Mississippi,Glendale,2083,221,556,399,148,40,1364
Mississippi,Coahoma,356,91,33,45,3,4,176
Mississippi,Lyon,409,12,49,117,71,69,318
Mississippi,Lambert,1282,330,272,232,36,11,881
Mississippi,Marks,1741,255,363,373,142,49,1182
Mississippi,Brookhaven,12226,1060,2715,2723,1072,465,8035
Mississippi,Beechwood,3523,229,775,753,334,314,2405
Mississippi,Bogue Chitto CDP (Kemper and Neshoba Counties),460,0,71,173,13,0,257
Mississippi,Bogue Chitto CDP (Lincoln County),352,55,125,58,0,0,238
Mississippi,Bridgetown,2538,200,640,588,221,51,1700
Mississippi,Buckatunna,349,82,89,68,0,0,239
Mississippi,Byram,11657,461,1878,2737,1563,1042,7681
Mississippi,Clara,579,74,86,80,132,78,450
Mississippi,Cleary,1412,87,258,464,182,23,1014
Mississippi,Cloverdale,649,52,207,202,24,9,494
Mississippi,Darling,204,39,45,43,3,0,130
Mississippi,DeLisle,1252,265,207,201,95,69,837
Mississippi,Elliott,995,220,278,78,80,0,656
Mississippi,Farrell,390,88,50,109,5,0,252
Mississippi,Foxworth,536,82,149,60,12,0,303
Mississippi,Byhalia,1537,228,357,264,91,9,949
Mississippi,Louin,278,10,63,63,21,33,190
Mississippi,Collins,2889,477,606,357,314,131,1885
Mississippi,Winona,4367,720,805,694,485,160,2864
Mississippi,New Houlka,651,100,107,91,32,11,341
Mississippi,Columbia,6088,758,1515,1075,346,231,3925
Mississippi,Slate Springs,94,19,34,18,4,1,76
Mississippi,Bruce,1751,220,504,333,69,53,1179
Mississippi,Big Creek,273,87,40,34,6,0,167
Mississippi,Mayersville,655,181,225,87,12,5,510
Mississippi,Como,1280,245,326,169,82,57,879
Mississippi,St. Martin,8203,537,2403,1823,508,212,5483
Mississippi,Crenshaw,928,138,182,162,40,20,542
Mississippi,Pascagoula,21865,2244,4500,5341,1429,1010,14524
Mississippi,Gulf Park Estates,6308,195,787,1567,883,514,3946
Mississippi,Gulf Hills,8252,758,1742,1766,1112,440,5818
Mississippi,State Line,547,33,167,117,7,0,324
Mississippi,Yazoo City,11076,1781,2310,1690,530,257,6568
Mississippi,Mathiston,562,72,108,96,70,42,388
Mississippi,Maben,687,182,98,129,20,6,435
Mississippi,Duck Hill,1133,208,245,175,107,30,765
Mississippi,Sherman,783,75,174,164,27,14,454
Mississippi,Hurley,1276,54,349,314,89,57,863
Mississippi,Prentiss,1223,164,343,254,73,53,887
Mississippi,D'Iberville,13531,841,2949,2951,1103,834,8678
Mississippi,Rolling Fork,2306,443,384,416,213,75,1531
Mississippi,Gloster,1085,127,263,251,34,5,680
Mississippi,Poplarville,2960,183,293,548,174,102,1300
Mississippi,Marion,1522,180,191,325,93,122,911
Mississippi,Alligator,119,32,28,19,0,0,79
Mississippi,Leakesville,1084,119,261,169,70,62,681
Mississippi,Winstonville,153,39,27,34,23,13,136
Mississippi,Shelby,2102,310,238,426,135,53,1162
Mississippi,Duncan,378,125,43,71,29,12,280
Mississippi,Hatley,606,42,139,112,59,29,381
Mississippi,Walnut Grove,809,163,179,213,24,19,598
Mississippi,Lena,161,10,42,33,26,14,125
Mississippi,Schlater,239,66,68,37,7,1,179
Mississippi,McCool,112,4,43,20,9,2,78
Mississippi,Redwater,738,108,71,159,68,44,450
Mississippi,Roxie,581,61,129,121,32,9,352
Mississippi,Olive Branch,36721,1936,7026,8592,4389,1944,23887
Mississippi,Tishomingo,414,58,109,64,8,13,252
Mississippi,Morton,3648,712,773,605,90,49,2229
Mississippi,Tucker,650,113,51,111,0,0,275
Mississippi,New Albany,8714,1378,1510,1804,748,443,5883
Mississippi,Kilmichael,878,163,277,62,21,34,557
Mississippi,Tunica,1138,138,198,265,149,53,803
Mississippi,Crystal Springs,4892,766,995,1024,373,139,3297
Mississippi,Golden,222,33,40,38,18,7,136
Mississippi,Belmont,2073,244,443,409,166,63,1325
Mississippi,Webb,454,112,64,63,36,3,278
Mississippi,Waveland,6358,663,1239,1386,594,289,4171
Mississippi,Okolona,2591,585,632,434,161,39,1851
Mississippi,Houston,3497,617,814,503,219,38,2191
Mississippi,Vardaman,1320,247,289,143,46,17,742
Mississippi,Bay St. Louis,12465,817,2263,2702,1754,993,8529
Mississippi,Osyka,402,25,82,62,21,9,199
Mississippi,Monticello,1393,74,285,256,123,129,867
Mississippi,Drew,2074,287,329,454,106,45,1221
Mississippi,Standing Pine,588,113,101,0,52,17,283
Mississippi,Raymond,2409,89,220,252,197,140,898
Mississippi,Learned,91,4,7,23,15,24,73
Mississippi,Ashland,621,161,108,154,28,11,462
Mississippi,Sallis,262,26,50,80,17,10,183
Mississippi,Ethel,623,94,136,119,18,12,379
Mississippi,Kosciusko,6959,1000,1331,1453,496,201,4481
Mississippi,North Tunica,923,107,158,166,13,24,468
Mississippi,Southaven,53274,3805,9964,12728,5938,2345,34780
Mississippi,Helena,1233,208,417,384,0,0,1009
Mississippi,Sandersville,734,60,230,146,56,20,512
Mississippi,Rosedale,1648,332,354,275,57,8,1026
Mississippi,Gunnison,416,52,104,86,6,5,253
Mississippi,Fulton,4024,386,699,643,246,205,2179
Mississippi,Tchula,1884,341,555,228,41,17,1182
Mississippi,Pickens,883,110,213,89,110,20,542
Mississippi,Cruger,370,73,107,43,40,15,278
Mississippi,McLain,302,29,89,52,5,8,183
Mississippi,Wesson,2166,145,228,382,172,101,1028
Mississippi,Goodman,1224,117,138,109,14,7,385
Mississippi,Smithville,671,91,200,140,30,2,463
Mississippi,Gattman,95,18,33,18,5,0,74
Mississippi,Dumas,467,51,117,119,20,17,324
Mississippi,Blue Mountain,1132,149,158,162,51,43,563
Mississippi,Silver City,335,67,70,22,27,8,194
Mississippi,Itta Bena,1556,239,364,208,137,69,1017
Mississippi,Eden,137,41,26,18,0,0,85
Mississippi,Shuqualak,500,82,114,118,16,26,356
Mississippi,Macon,2948,422,584,508,111,94,1719
Mississippi,Louisville,6298,806,1212,1272,571,200,4061
Mississippi,Jackson,168862,15114,26715,34120,16588,12276,104813
Mississippi,Edwards,886,187,166,196,72,50,671
Missouri,Sibley,356,43,120,76,25,2,266
Missouri,Crystal Lakes,335,26,132,78,14,11,261
Missouri,Herculaneum,3935,223,792,1042,417,155,2629
Missouri,Koshkonong,206,16,63,46,2,5,132
Missouri,Crystal City,4752,359,1138,1202,410,195,3304
Missouri,Raymore,20743,396,3456,4993,3102,2166,14113
Missouri,Harrisonville,10023,678,2649,1863,761,209,6160
Missouri,Baldwin Park,97,17,40,16,1,0,74
Missouri,Sikeston,16366,1381,4536,2913,1261,1035,11126
Missouri,Scott City,4503,325,1420,788,230,77,2840
Missouri,Commerce,73,14,19,2,0,5,40
Missouri,Albany,2106,180,580,424,170,90,1444
Missouri,Blue Springs,54370,1867,8947,12400,8176,3796,35186
Missouri,Union Star,377,23,155,88,21,5,292
Missouri,Clarksdale,283,30,116,41,13,4,204
Missouri,Amity,21,3,8,8,2,0,21
Missouri,Exeter,821,97,229,166,17,24,533
Missouri,Conway,674,70,162,117,6,26,381
Missouri,Glasgow,1163,76,291,215,147,64,793
Missouri,Hughesville,164,12,39,60,2,6,119
Missouri,Whiteman AFB,4093,53,162,713,335,118,1381
Missouri,Clark,286,37,88,56,11,0,192
Missouri,Perry,690,78,226,138,44,19,505
Missouri,Fair Play,471,108,124,83,12,4,331
Missouri,Hannibal,17575,1568,4492,3240,1497,732,11529
Missouri,South Greenfield,124,46,33,25,0,2,106
Missouri,Goodnight,20,4,1,8,2,0,15
Missouri,Evergreen,16,2,4,4,0,3,13
Missouri,Dardenne Prairie,13139,241,1545,2362,2893,1441,8482
Missouri,Riverview Estates,79,5,23,14,15,4,61
Missouri,Preston,330,17,98,55,2,9,181
Missouri,Allendale,64,1,16,23,8,2,50
Missouri,Hurdland,148,13,57,15,9,0,94
Missouri,Westphalia,393,41,202,51,26,10,330
Missouri,Lambert,0,0,0,0,0,0,0
Missouri,Oran,1532,162,500,258,114,32,1066
Missouri,Fenton,4034,183,511,915,866,502,2977
Missouri,Edmundson,1067,90,181,248,78,8,605
Missouri,Des Peres,8567,97,485,944,2536,1859,5921
Missouri,Bridgeton,11690,1082,2289,2536,1525,712,8144
Missouri,Berkeley,8991,866,1764,2365,545,333,5873
Missouri,Ballwin,30332,974,3380,5209,7120,4536,21219
Missouri,Florida,0,0,0,0,0,0,0
Missouri,Henrietta,353,53,140,37,8,6,244
Missouri,Camden,296,19,151,33,5,3,211
Missouri,Wilbur Park,554,50,121,162,68,48,449
Missouri,Town and Country,11066,155,636,1341,3044,3150,8326
Missouri,Mehlville,28376,1571,6334,6865,4151,2319,21240
Missouri,Lemay,16814,1650,4248,3427,1520,622,11467
Missouri,Ladue,8586,9,250,843,2163,2820,6085
Missouri,Hillsdale,1335,158,242,272,67,22,761
Missouri,Grantwood Village,1038,9,97,179,251,175,711
Missouri,Glen Echo Park,134,2,18,41,7,22,90
Missouri,Bertrand,827,165,332,131,15,9,652
Missouri,Ste. Genevieve,4444,271,1318,975,350,272,3186
Missouri,Truesdale,781,86,202,105,19,22,434
Missouri,Shelbyville,489,29,125,113,71,26,364
Missouri,Wilson City,51,7,19,16,1,0,43
Missouri,Bellefontaine Neighbors,10613,896,2419,2826,664,386,7191
Missouri,Stoutland,185,24,90,23,5,6,148
Missouri,Lakeshire,1658,107,247,480,255,125,1214
Missouri,Chula,218,6,72,60,8,0,146
Missouri,Mount Vernon,4493,522,1144,1251,208,181,3306
Missouri,Bella Villa,841,108,154,193,119,38,612
Missouri,Beverly Hills,505,21,182,105,19,20,347
Missouri,Black Jack,6943,329,1008,2330,829,306,4802
Missouri,Ellisville,9581,340,1376,1652,2185,1154,6707
Missouri,Manchester,18189,608,1613,3290,4086,2766,12363
Missouri,Maryland Heights,27128,1237,3841,5724,5169,3546,19517
Missouri,Plato,77,5,12,13,9,10,49
Missouri,Kirbyville,195,31,59,34,16,2,142
Missouri,Hoberg,49,17,9,8,2,0,36
Missouri,Horine,1295,31,363,409,0,0,803
Missouri,Independence,117207,9255,30087,26739,10788,5019,81888
Missouri,Clarkson Valley,2640,22,134,268,733,751,1908
Missouri,Berger,205,27,50,47,9,4,137
Missouri,St. Cloud,55,7,12,17,5,0,41
Missouri,Washington,13987,766,3059,3379,1905,774,9883
Missouri,Morrison,89,7,27,9,6,9,58
Missouri,La Plata,1362,100,452,310,52,63,977
Missouri,Mountain View,2658,415,676,503,114,50,1758
Missouri,Old Monroe,227,12,93,52,13,1,171
Missouri,Weaubleau,587,115,137,85,10,23,370
Missouri,New London,886,96,331,127,41,18,613
Missouri,Appleton City,1240,96,462,206,44,46,854
Missouri,Green Park,2628,153,531,710,327,194,1915
Missouri,Bell City,528,82,120,73,25,15,315
Missouri,Arbyrd,434,75,130,59,13,5,282
Missouri,Dadeville,238,12,88,48,18,8,174
Missouri,Rhineland,125,2,53,22,8,8,93
Missouri,Cliff Village,30,1,20,5,0,0,26
Missouri,Overland,15787,1556,3642,3493,1622,590,10903
Missouri,Doolittle,745,79,135,232,40,24,510
Missouri,Eminence,666,56,180,115,132,25,508
Missouri,West Alton,378,61,139,69,32,5,306
Missouri,Lee's Summit,96325,2080,12100,20081,18984,11160,64405
Missouri,Drexel,806,62,276,175,72,17,602
Missouri,Lake Tapawingo,809,25,133,264,139,94,655
Missouri,Sedalia,21642,2306,5028,4709,1588,734,14365
Missouri,Essex,526,92,176,82,13,6,369
Missouri,Lebanon,14637,1801,3514,3153,805,402,9675
Missouri,Osborn,434,20,175,86,18,8,307
Missouri,Rolla,20117,1037,2840,2902,1890,1732,10401
Missouri,Webb City,11572,853,2799,2207,1357,376,7592
Missouri,Smithton,517,31,106,151,8,5,301
Missouri,Goss,0,0,0,0,0,0,0
Missouri,Rosebud,573,64,154,81,14,15,328
Missouri,Jasper,968,90,320,136,59,30,635
Missouri,Fort Leonard Wood,15882,161,857,2257,1183,547,5005
Missouri,Alma,420,23,129,53,46,29,280
Missouri,Freeburg,498,46,114,128,11,0,299
Missouri,Seneca,2570,251,600,511,238,60,1660
Missouri,Centralia,4207,312,913,1039,462,173,2899
Missouri,Ravenwood,449,17,134,85,30,16,282
Missouri,Williamsville,403,96,98,84,6,1,285
Missouri,Nevada,8252,506,2173,1759,614,348,5400
Missouri,Marthasville,1328,51,275,347,111,34,818
Missouri,Branson West,569,70,172,109,60,21,432
Missouri,Mosby,164,21,55,36,0,0,112
Missouri,Pattonsburg,354,33,117,77,11,1,239
Missouri,Galena,641,71,168,133,11,3,386
Missouri,Portageville,3074,455,845,382,101,154,1937
Missouri,Asbury,246,34,69,51,15,6,175
Missouri,Homestown,114,15,22,13,9,3,62
Missouri,Dearborn,461,42,131,87,38,26,324
Missouri,Amazonia,317,43,134,29,2,0,208
Missouri,Mokane,186,14,60,25,9,6,114
Missouri,West Line,107,8,30,14,11,8,71
Missouri,Pendleton,34,7,15,5,0,0,27
Missouri,Monticello,132,28,36,26,10,6,106
Missouri,Alton,583,158,106,135,52,12,463
Missouri,Kingston,285,31,120,68,11,3,233
Missouri,Mineral Point,365,74,106,33,0,1,214
Missouri,Willow Springs,2179,145,533,467,83,107,1335
Missouri,Belle,1458,187,404,371,90,10,1062
Missouri,Maysville,1151,59,351,240,66,54,770
Missouri,Seymour,2128,247,618,406,106,67,1444
Missouri,Frontenac,3525,54,131,309,1028,1004,2526
Missouri,Oakland,1558,63,216,282,384,285,1230
Missouri,Jennings,14794,1897,3578,3476,628,184,9763
Missouri,Wellston,1775,163,351,387,36,20,957
Missouri,Valley Park,6832,540,968,1555,1124,811,4998
Missouri,Uplands Park,357,37,96,77,17,14,241
Missouri,Sunset Hills,8488,178,1610,1460,1610,1415,6273
Missouri,Pacific,6329,746,1488,1637,518,147,4536
Missouri,Mackenzie,174,5,15,50,45,17,132
Missouri,Kinloch,276,33,68,37,6,2,146
Missouri,Hazelwood,25399,1402,4680,6171,3226,1988,17467
Missouri,Ferguson,20931,1406,4055,4833,1515,993,12802
Missouri,Dellwood,4912,457,1006,1152,290,109,3014
Missouri,Country Club Hills,1393,102,348,322,21,36,829
Missouri,Concord,17652,586,2830,3955,3568,1663,12602
Missouri,Champ,5,0,3,2,0,0,5
Missouri,Weatherby,75,10,35,12,0,0,57
Missouri,Woodson Terrace,4062,413,1109,945,232,72,2771
Missouri,Cameron,9665,1186,3029,2069,636,188,7108
Missouri,Meta,196,26,77,47,3,1,154
Missouri,Argyle,193,11,65,59,11,6,152
Missouri,Fillmore,170,22,62,24,7,4,119
Missouri,Turney,216,10,63,43,7,7,130
Missouri,Levasy,82,11,25,13,8,3,60
Missouri,Pevely,5784,280,1210,1688,286,154,3618
Missouri,Olympian Village,606,94,117,151,34,11,407
Missouri,Cedar Hill Lakes,258,32,71,53,20,21,197
Missouri,Ava,2916,223,911,485,136,99,1854
Missouri,Lake Annette,114,15,31,41,11,4,102
Missouri,Vinita Park,1931,201,484,410,190,98,1383
Missouri,Sappington,7577,418,1332,1907,1230,751,5638
Missouri,Strasburg,129,18,23,27,8,3,79
Missouri,Mound City,1114,95,306,244,133,69,847
Missouri,Thayer,2292,245,551,492,141,40,1469
Missouri,Harwood,87,43,8,8,0,1,60
Missouri,Tuscumbia,183,38,55,25,5,4,127
Missouri,Roscoe,103,12,31,36,0,0,79
Missouri,Smithville,9541,307,1750,2275,1270,577,6179
Missouri,Randolph,21,3,14,1,0,1,19
Missouri,Oakwood Park,284,17,49,53,44,34,197
Missouri,McBaine,9,2,3,1,2,0,8
Missouri,Ironton,1674,181,400,346,162,39,1128
Missouri,Lock Springs,37,3,23,5,0,0,31
Missouri,Passaic,20,6,11,3,0,0,20
Missouri,Columbia,120248,3361,11828,16497,18419,16973,67078
Missouri,Mountain Grove,4608,667,1480,793,176,82,3198
Missouri,Memphis,1803,137,526,427,161,41,1292
Missouri,Purcell,468,44,121,81,17,6,269
Missouri,Carterville,2134,276,528,329,107,25,1265
Missouri,St. Joseph,76465,6589,18706,15635,6865,3492,51287
Missouri,Flemington,74,14,23,19,0,0,56
Missouri,Bolivar,10760,450,2142,1827,902,535,5856
Missouri,Parma,660,156,114,85,28,0,383
Missouri,Marston,328,44,169,11,0,0,224
Missouri,Metz,33,7,17,1,0,0,25
Missouri,Sheldon,427,56,110,76,23,0,265
Missouri,Mooresville,154,16,47,18,15,2,98
Missouri,Homestead,124,12,50,24,3,5,94
Missouri,Amoret,178,27,74,23,4,0,128
Missouri,Shell Knob,1246,44,298,436,213,81,1072
Missouri,Wheatland,293,34,95,73,10,6,218
Missouri,Norwood,900,79,226,171,36,8,520
Missouri,Rich Hill,1425,195,465,168,68,46,942
Missouri,New Bloomfield,544,50,180,117,29,10,386
Missouri,Leasburg,389,54,93,39,10,3,199
Missouri,Cross Timbers,185,32,54,34,6,5,131
Missouri,Gideon,1202,271,392,97,19,23,802
Missouri,Howardville,279,47,83,28,15,0,173
Missouri,Adrian,1793,150,517,313,95,34,1109
Missouri,Lake Mykee Town,450,6,72,116,63,35,292
Missouri,Branson,11345,831,2391,3083,1071,540,7916
Missouri,Forest City,250,14,90,50,14,2,170
Missouri,Stotts City,129,0,37,35,9,0,81
Missouri,Monett,8917,1246,1942,1434,726,287,5635
Missouri,Glendale,5888,16,154,710,1438,1699,4017
Missouri,Creve Coeur,18445,426,1214,2464,4345,5121,13570
Missouri,Country Life Acres,84,0,2,17,23,21,63
Missouri,Aurora,7435,1037,1735,1654,539,142,5107
Missouri,Holcomb,580,75,176,120,2,3,376
Missouri,Jerico Springs,224,27,84,42,3,6,162
Missouri,Affton,20187,1418,3885,4540,3189,1524,14556
Missouri,Waynesville,5262,56,1253,1175,747,336,3567
Missouri,Richland,1895,232,625,448,50,25,1380
Missouri,Saginaw,410,15,125,107,34,14,295
Missouri,Pilot Grove,650,46,246,132,28,17,469
Missouri,Montrose,328,34,127,61,36,5,263
Missouri,Brownington,124,13,37,39,0,6,95
Missouri,Tallapoosa,134,17,44,11,0,0,72
Missouri,Matthews,726,193,240,69,12,20,534
Missouri,Normandy,4931,322,1265,1128,425,177,3317
Missouri,Olivette,7837,184,595,1252,1426,1608,5065
Missouri,Pasadena Park,480,5,66,108,87,99,365
Missouri,Richmond Heights,8457,124,465,1369,2330,2295,6583
Missouri,Riverview,2872,374,630,803,135,48,1990
Missouri,Webster Groves,23029,359,1570,3415,5063,5220,15627
Missouri,Wheeling,304,30,100,60,16,0,206
Missouri,Greenville,546,72,105,131,15,15,338
Missouri,Old Appleton,65,9,8,7,4,1,29
Missouri,Dalton,3,3,0,0,0,0,3
Missouri,Leslie,123,6,21,26,5,2,60
Missouri,Villa Ridge,2497,271,715,619,177,204,1986
Missouri,Cave,4,2,0,2,0,0,4
Missouri,Lilbourn,1165,212,355,169,10,19,765
Missouri,Fredericktown,3990,516,727,894,416,241,2794
Missouri,North Lilbourn,8,0,8,0,0,0,8
Missouri,Wildwood,35517,350,2338,5940,9262,5898,23788
Missouri,Bagnell,34,7,24,0,1,0,32
Missouri,Middletown,267,40,69,35,5,2,151
Missouri,Licking,2844,459,1078,587,61,65,2250
Missouri,High Ridge,4151,249,1097,1076,458,158,3038
Missouri,Cedar Hill,1751,138,327,556,169,54,1244
Missouri,Barnhart,6318,291,1248,1351,928,312,4130
Missouri,Freeman,517,29,130,111,24,7,301
Missouri,Cleveland,572,34,141,136,85,20,416
Missouri,Kelso,568,93,113,85,63,19,373
Missouri,Higbee,541,78,166,123,26,7,400
Missouri,Madison,663,64,191,122,11,6,394
Missouri,Cabool,2337,265,478,495,199,97,1534
Missouri,O'Fallon,86340,2083,13293,17788,14475,8538,56177
Missouri,Clifton Hill,85,11,18,10,2,4,45
Missouri,Cottleville,4882,80,672,696,1229,552,3229
Missouri,New Hampton,297,17,83,69,14,2,185
Missouri,Raytown,29216,1322,6973,7326,2970,1591,20182
Missouri,Lone Jack,1280,26,232,280,191,93,822
Missouri,Eldon,4591,516,1226,900,273,182,3097
Missouri,St. Elizabeth,332,30,89,51,47,29,246
Missouri,Hardin,622,24,202,84,26,19,355
Missouri,Freistatt,181,33,45,38,8,8,132
Missouri,Marionville,2350,185,660,485,69,78,1477
Missouri,Pierce City,1313,131,375,243,66,49,864
Missouri,Winchester,1482,81,338,388,228,63,1098
Missouri,Verona,481,94,95,81,7,11,288
Missouri,Knox City,241,14,86,24,6,0,130
Missouri,Phillipsburg,164,26,50,51,2,0,129
Missouri,La Monte,1380,316,208,147,33,13,717
Missouri,Buckner,3058,275,860,562,197,75,1969
Missouri,Grandview,25174,1726,5198,5792,2195,1041,15952
Missouri,Greenwood,6092,120,1017,1404,1022,365,3928
Missouri,De Witt,108,25,48,9,0,0,82
Missouri,Watson,38,1,23,3,0,0,27
Missouri,Gunn City,122,21,10,24,7,0,62
Missouri,Edina,1139,57,345,247,99,69,817
Missouri,Macks Creek,425,35,198,31,13,10,287
Missouri,Charmwood,40,3,16,9,0,0,28
Missouri,Rayville,135,3,29,32,0,0,64
Missouri,Montreal,170,0,55,0,0,0,55
Missouri,Centerview,246,28,58,43,3,2,134
Missouri,Annada,37,0,27,2,0,0,29
Missouri,Irena,21,0,5,6,1,2,14
Missouri,Centerville,219,27,76,35,5,0,143
Missouri,Burlington Junction,550,65,141,93,7,9,315
Missouri,Conception Junction,181,13,67,20,14,8,122
Missouri,Osgood,20,0,3,3,3,0,9
Missouri,Village of Four Seasons,2122,50,407,617,277,248,1599
Missouri,Atlanta,594,63,146,116,22,14,361
Missouri,South Gifford,53,6,16,9,0,0,31
Missouri,Jane,445,56,85,115,10,5,271
Missouri,Boonville,8410,823,2307,1939,944,272,6285
Missouri,Concordia,2697,125,702,474,247,167,1715
Missouri,Higginsville,4628,304,1121,802,515,201,2943
Missouri,Mayview,269,19,122,46,6,2,195
Missouri,Waverly,942,74,278,150,55,35,592
Missouri,California,4375,453,1020,736,478,141,2828
Missouri,Ellington,1230,177,305,280,40,12,814
Missouri,Browning,202,15,63,35,15,0,128
Missouri,Greencastle,175,44,46,23,28,3,144
Missouri,Pollock,40,2,19,7,0,0,28
Missouri,Urbana,336,22,138,63,16,9,248
Missouri,West Plains,12222,820,2581,2621,1082,867,7971
Missouri,Alexandria,103,18,36,17,0,0,71
Missouri,Lake Waukomis,846,8,107,236,239,125,715
Missouri,Lewis and Clark Village,142,8,35,37,3,1,84
Missouri,Tightwad,48,10,19,12,1,4,46
Missouri,Terre du Lac,2663,114,717,803,193,117,1944
Missouri,St. George,1666,288,278,459,239,81,1345
Missouri,Quitman,16,3,5,6,0,0,14
Missouri,Bennett Springs,151,67,57,13,14,0,151
Missouri,Biehle,32,0,0,21,0,0,21
Missouri,Big Spring,268,0,24,64,14,0,102
Missouri,Blanchard,17,0,5,6,0,0,11
Missouri,Brewer,324,25,86,81,23,6,221
Missouri,Cherokee Pass,327,9,103,92,37,9,250
Missouri,Dawn,176,18,49,26,11,0,104
Missouri,Chesapeake,38,0,0,14,0,11,25
Missouri,Conception,302,2,25,61,23,22,133
Missouri,Danville,26,17,0,0,0,0,17
Missouri,Defiance,88,10,68,10,0,0,88
Missouri,Doe Run,810,120,296,178,31,0,625
Missouri,Eagle Rock,163,13,76,11,14,0,114
Missouri,Edinburg,137,10,41,55,0,10,116
Missouri,Excello,11,0,0,11,0,0,11
Missouri,Fairdealing,819,46,234,103,85,47,515
Missouri,Frankclay,166,46,48,53,0,0,147
Missouri,Lithium,117,26,22,5,0,0,53
Missouri,Goodman,1441,162,475,208,51,18,914
Missouri,Eugene,269,0,88,47,43,6,184
Missouri,Butterfield,538,88,137,58,35,5,323
Missouri,Burgess,66,5,17,10,4,0,36
Missouri,Zalma,82,24,24,2,0,3,53
Missouri,Ellsinore,498,47,116,104,12,18,297
Missouri,Bellerive Acres,170,6,16,26,41,55,144
Missouri,Climax Springs,220,61,62,7,5,6,141
Missouri,Calverton Park,1518,94,294,340,124,115,967
Missouri,Grayhawk,686,59,175,223,109,9,575
Missouri,Golden,410,23,148,106,104,10,391
Missouri,Gilliam,198,12,75,40,13,0,140
Missouri,Fremont,28,0,7,16,0,0,23
Missouri,Velda Village Hills,918,134,263,217,43,12,669
Missouri,Ashley,75,0,66,0,0,9,75
Missouri,Carthage,14690,2354,2811,2267,1134,485,9051
Missouri,Wayland,646,112,200,91,13,2,418
Missouri,Hopkins,362,24,134,75,25,6,264
Missouri,Graham,155,6,61,22,6,5,100
Missouri,Cooter,406,71,87,70,16,2,246
Missouri,Glen Allen,192,20,34,20,16,0,90
Missouri,Farmington,18269,1897,4562,4270,1449,1192,13370
Missouri,Hale,433,38,140,64,18,22,282
Missouri,Bogard,133,25,43,37,0,5,110
Missouri,Houstonia,134,22,43,40,1,10,116
Missouri,Green Ridge,452,9,131,104,30,17,291
Missouri,Novinger,382,53,136,59,16,9,273
Missouri,Armstrong,281,26,91,40,22,1,180
Missouri,Park Hills,8568,770,2055,1833,338,192,5188
Missouri,Leadington,601,86,108,184,27,5,410
Missouri,Desloge,4896,543,1464,1182,175,150,3514
Missouri,Maryville,11771,408,1571,1263,1047,992,5281
Missouri,Peculiar,5006,388,1188,1083,470,289,3418
Missouri,Belton,23348,1606,5471,5412,1954,1030,15473
Missouri,Archie,1327,52,290,251,97,31,721
Missouri,Miner,981,164,317,226,18,39,764
Missouri,Haywood City,139,15,59,27,3,0,104
Missouri,Chaffee,2920,275,788,762,123,43,1991
Missouri,Jamesport,548,66,179,63,16,1,325
Missouri,Arcadia,653,111,140,150,36,43,480
Missouri,Bull Creek,524,82,81,99,10,2,274
Missouri,Holden,2453,276,634,438,188,95,1631
Missouri,Fountain N' Lakes,193,47,56,27,4,0,134
Missouri,Gallatin,1730,163,449,319,175,64,1170
Missouri,Slater,2061,223,588,435,108,59,1413
Missouri,Marshall,13001,1499,2963,2090,973,559,8084
Missouri,Blackburn,309,12,103,81,26,4,226
Missouri,Lake Winnebago,1114,10,124,205,307,229,875
Missouri,Callao,337,39,118,50,12,0,219
Missouri,Billings,983,86,290,259,49,39,723
Missouri,Wooldridge,21,0,12,5,2,1,20
Missouri,Highlandville,1044,93,294,276,83,36,782
Missouri,Fairfax,609,43,221,141,62,12,479
Missouri,Westboro,121,14,47,23,5,0,89
Missouri,St. Martins,1172,55,311,219,204,50,839
Missouri,Taos,1310,58,272,224,226,51,831
Missouri,Eagleville,265,28,88,56,5,11,188
Missouri,Weldon Spring,5545,108,813,1261,1336,918,4436
Missouri,Stewartsville,697,48,250,119,67,13,497
Missouri,Grain Valley,13715,434,2882,3117,1456,756,8645
Missouri,McCord Bend,391,35,115,66,3,0,219
Missouri,Schell City,273,27,95,36,16,1,175
Missouri,Hayti,2714,436,701,474,87,17,1715
Missouri,Cape Girardeau,39323,2142,6417,7100,4865,3264,23788
Missouri,Versailles,2760,304,792,486,154,87,1823
Missouri,Ritchey,55,6,13,21,2,4,46
Missouri,Granby,2311,207,571,613,70,30,1491
Missouri,Purdin,128,16,56,18,0,0,90
Missouri,Westwood,337,15,21,18,86,110,250
Missouri,Allenville,138,31,43,13,19,0,106
Missouri,Whitewater,116,13,25,21,9,6,74
Missouri,Jameson,65,10,34,8,3,1,56
Missouri,Urich,629,13,263,94,32,6,408
Missouri,Raymondville,496,60,129,82,18,4,293
Missouri,Clarksburg,218,38,59,44,13,2,156
Missouri,Washburn,491,56,158,86,10,8,318
Missouri,Martinsburg,306,22,112,53,26,18,231
Missouri,Savannah,5124,285,1286,1102,503,295,3471
Missouri,Calhoun,349,46,120,68,13,1,248
Missouri,Clinton,9107,925,2592,1555,788,385,6245
Missouri,St. Louis,311273,28768,51909,62051,42151,34815,219694
Missouri,Wellington,787,36,271,124,39,20,490
Missouri,La Due,46,24,14,6,0,0,44
Missouri,Wortham,226,0,78,41,0,10,129
Missouri,Winigan,52,8,11,9,0,0,28
Missouri,West Sullivan,197,40,40,11,0,7,98
Missouri,Foster,184,18,74,28,40,6,166
Missouri,Parnell,183,14,75,14,4,4,111
Missouri,Amsterdam,220,32,84,36,7,3,162
Missouri,Pascola,105,23,36,9,0,0,68
Missouri,Fleming,85,12,31,15,1,0,59
Missouri,Orrick,689,32,240,126,34,21,453
Missouri,Coney Island,77,5,42,8,1,0,56
Missouri,Crane,1453,181,318,296,63,53,911
Missouri,Milford,18,0,7,11,0,0,18
Missouri,Cardwell,701,196,132,96,9,15,448
Missouri,Senath,1847,395,354,233,80,33,1095
Missouri,Cobalt,242,63,72,53,2,0,190
Missouri,Jackson,14826,787,3222,2986,1846,1073,9914
Missouri,Pocahontas,56,3,15,10,2,9,39
Missouri,Merwin,30,5,24,1,0,0,30
Missouri,Sturgeon,820,55,207,215,82,22,581
Missouri,Greentop,583,127,133,108,15,17,400
Missouri,Prathersville,142,8,34,52,13,1,108
Missouri,Craig,231,39,60,26,7,6,138
Missouri,Fortescue,42,5,6,4,0,0,15
Missouri,Elmo,159,22,46,16,12,4,100
Missouri,Oregon,997,43,355,200,67,26,691
Missouri,Rothville,73,3,15,5,7,2,32
Missouri,Catron,37,21,8,0,1,2,32
Missouri,Skidmore,221,15,78,42,6,14,155
Missouri,Green City,550,54,168,92,25,35,374
Missouri,Kahoka,2100,180,599,463,134,53,1429
Missouri,Clever,2592,158,494,663,190,98,1603
Missouri,Nixa,21113,854,3888,4915,2733,1732,14122
Missouri,Denver,34,0,10,11,3,0,24
Missouri,Downing,408,38,166,68,15,2,289
Missouri,Gilman City,413,13,130,84,19,4,250
Missouri,Jacksonville,122,11,52,18,2,0,83
Missouri,New Melle,442,33,108,90,55,54,340
Missouri,Mexico,11544,1148,3438,1781,759,351,7477
Missouri,Grand Pass,76,6,29,8,2,0,45
Missouri,Twin Oaks,342,10,54,96,74,51,285
Missouri,Northwoods,4148,357,1441,849,214,359,3220
Missouri,Moline Acres,2355,304,504,456,153,59,1476
Missouri,Theodosia,168,14,80,50,10,0,154
Missouri,Pasadena Hills,994,18,85,257,192,217,769
Missouri,Breckenridge Hills,4654,415,1290,854,131,194,2884
Missouri,Montgomery City,2685,292,804,527,122,100,1845
Missouri,Avondale,502,89,108,96,49,12,354
Missouri,Tindall,82,3,12,20,6,2,43
Missouri,Trimble,660,23,213,143,28,18,425
Missouri,Brimson,44,10,18,2,0,0,30
Missouri,Agency,866,60,210,174,66,26,536
Missouri,New Madrid,2945,300,812,602,167,136,2017
Missouri,Truxton,163,32,62,24,2,0,120
Missouri,Moscow Mills,2829,329,613,546,76,34,1598
Missouri,St. Thomas,249,11,67,38,36,8,160
Missouri,Wardsville,1731,36,312,294,315,120,1077
Missouri,Lake St. Louis,15646,380,2214,3565,3182,1732,11073
Missouri,Houston,2559,307,619,624,159,65,1774
Missouri,Bonne Terre,7110,1037,2203,1282,253,84,4859
Missouri,Gibbs,107,3,35,18,1,0,57
Missouri,Walnut Grove,635,111,198,116,29,17,471
Missouri,Millard,71,14,23,18,0,0,55
Missouri,River Bend,7,0,1,1,3,0,5
Missouri,Corning,5,5,0,0,0,0,5
Missouri,Maitland,289,20,108,49,7,2,186
Missouri,Keytesville,390,37,124,62,38,13,274
Missouri,Parkway,561,55,105,182,21,11,374
Missouri,Elsberry,1958,207,535,315,185,66,1308
Missouri,Kirksville,17483,580,2915,2073,1198,1267,8033
Missouri,Palmyra,3607,256,970,729,205,175,2335
Missouri,Bowling Green,5501,754,1880,867,423,80,4004
Missouri,Luray,87,8,39,2,0,6,55
Missouri,Hartwell,37,20,10,0,0,0,30
Missouri,Harviell,0,0,0,0,0,0,0
Missouri,Hayward,117,18,37,15,3,0,73
Missouri,Hunter,128,21,38,0,22,23,104
Missouri,Irwin,49,29,8,12,0,0,49
Missouri,Kissee Mills,1002,130,390,178,93,38,829
Missouri,LaBarque Creek,1668,0,372,373,293,139,1177
Missouri,Lake Tekakwitha,220,11,66,60,13,22,172
Missouri,Lake Viking,360,36,112,66,74,27,315
Missouri,La Tour,139,9,34,15,0,0,58
Missouri,Laurie,1024,84,396,275,109,42,906
Missouri,Leisure Lake,123,3,65,28,8,3,107
Missouri,Mine La Motte,332,21,65,155,0,0,241
Missouri,Montier,23,0,0,23,0,0,23
Missouri,Old Jamestown,19439,840,3020,5114,2859,2397,14230
Missouri,Oxly,160,50,49,23,0,0,122
Missouri,Ozora,117,22,46,31,9,0,108
Missouri,Weingarten,74,9,21,0,11,0,41
Missouri,Wasola,140,0,38,71,0,17,126
Missouri,Thomasville,0,0,0,0,0,0,0
Missouri,Sundown,34,11,0,5,18,0,34
Missouri,South Fork,92,0,36,34,11,11,92
Missouri,Shoal Creek Estates,91,4,10,23,21,11,69
Missouri,Grayridge,143,18,25,45,8,0,96
Missouri,St. Francisville,162,19,59,12,5,13,108
Missouri,Ravanna,92,5,39,20,0,0,64
Missouri,Pontiac,229,38,92,0,35,14,179
Missouri,Pomona,349,113,102,62,0,0,277
Missouri,Plevna,13,0,13,0,0,0,13
Missouri,Phelps City,0,0,0,0,0,0,0
Missouri,Peaceful Village,43,15,7,11,2,4,39
Missouri,St. Clement,207,33,0,27,16,0,76
Missouri,New Florence,739,166,260,87,27,11,551
Missouri,Wood Heights,646,28,186,169,37,25,445
Missouri,Waco,59,10,14,13,7,2,46
Missouri,Spokane,91,16,0,54,0,0,70
Missouri,Bucklin,383,39,155,81,28,9,312
Missouri,Meadville,466,9,155,93,38,19,314
Missouri,Neosho,12009,1276,2198,2251,797,394,6916
Missouri,Ashburn,0,0,0,0,0,0,0
Missouri,Otterville,395,28,104,94,20,4,250
Missouri,Springfield,166633,10373,30096,35293,17747,11137,104646
Missouri,Leeton,570,24,143,171,25,15,378
Missouri,Clarksville,444,73,94,90,95,15,367
Missouri,Ethel,51,4,14,9,10,0,37
Missouri,New Cambria,140,4,55,44,10,4,117
Missouri,Fulton,12799,1781,3034,2078,679,517,8089
Missouri,Cuba,3340,704,650,649,117,81,2201
Missouri,Bigelow,8,0,8,0,0,0,8
Missouri,Mendon,223,10,93,38,16,0,157
Missouri,Salisbury,1907,165,557,342,161,80,1305
Missouri,Sumner,113,9,44,7,6,8,74
Missouri,Saddlebrooke,277,16,37,74,52,27,206
Missouri,Oak Grove Village,464,127,85,65,30,9,316
Missouri,Huntsdale,8,0,1,6,1,0,8
Missouri,Ginger Blue,33,7,13,11,0,2,33
Missouri,Three Creeks,8,2,4,2,0,0,8
Missouri,Worth,65,8,21,10,6,0,45
Missouri,Windsor Place,361,7,63,79,49,33,231
Missouri,Wyatt,305,74,72,41,22,0,209
Missouri,Powersville,39,12,10,9,0,0,31
Missouri,Taneyville,288,51,61,63,10,13,198
Missouri,Rockaway Beach,891,71,204,272,88,24,659
Missouri,Union,11274,961,2619,2350,813,420,7163
Missouri,Miramiguoa Park,94,12,19,30,1,2,64
Missouri,Gerald,1300,124,276,285,90,32,807
Missouri,Bethel,98,12,34,26,7,6,85
Missouri,Nelson,154,22,46,34,8,2,112
Missouri,Baring,136,5,56,23,4,0,88
Missouri,Farber,322,44,117,50,20,2,233
Missouri,Russellville,751,66,167,153,64,36,486
Missouri,Bethany,3065,386,925,574,248,88,2221
Missouri,Blythedale,180,14,63,36,10,2,125
Missouri,Willard,5453,391,1035,1201,677,286,3590
Missouri,Chilhowee,397,62,98,42,11,30,243
Missouri,Warrensburg,20025,565,2216,2906,2132,1974,9793
Missouri,Lancaster,853,72,200,186,56,24,538
Missouri,Curryville,188,33,48,32,8,1,122
Missouri,Queen City,694,52,203,165,22,14,456
Missouri,Hillsboro,3105,170,642,752,157,153,1874
Missouri,Kimmswick,136,16,39,34,3,0,92
Missouri,Murphy,8163,718,1966,2085,541,258,5568
Missouri,Parkdale,186,10,80,43,11,1,145
Missouri,Purdy,1338,252,316,154,36,40,798
Missouri,Knob Noster,2770,215,370,766,212,89,1652
Missouri,Imperial,4279,335,1105,942,444,189,3015
Missouri,Centertown,319,40,96,55,21,15,227
Missouri,Josephville,372,19,94,82,66,23,284
Missouri,Portage Des Sioux,376,40,98,90,23,6,257
Missouri,St. Charles,69576,3265,11752,15321,10156,6422,46916
Missouri,Wentzville,37485,1386,5905,7772,5247,2585,22895
Missouri,Summersville,541,37,101,162,46,18,364
Missouri,Irondale,416,47,97,96,12,5,257
Missouri,Fayette,2694,148,634,309,206,229,1526
Missouri,Arrow Rock,45,0,2,8,14,12,36
Missouri,Mount Leonard,42,2,25,8,2,2,39
Missouri,Diggins,270,23,111,40,16,12,202
Missouri,Niangua,608,63,187,87,12,43,392
Missouri,Laddonia,577,59,212,102,26,16,415
Missouri,Vandiver,75,0,28,15,4,10,57
Missouri,Fisk,413,45,88,112,8,5,258
Missouri,Clarkton,1213,236,280,154,6,10,686
Missouri,Campbell,2165,484,371,447,66,29,1397
Missouri,Richards,181,8,49,20,7,0,84
Missouri,Gerster,26,8,11,6,0,0,25
Missouri,Lowry City,710,108,203,137,30,19,497
Missouri,Trenton,5846,404,1580,1131,424,335,3874
Missouri,Mercer,335,34,158,29,10,21,252
Missouri,Barnett,249,58,62,51,0,4,175
Missouri,Worthington,201,3,48,0,3,0,54
Missouri,Leonard,64,2,27,10,6,2,47
Missouri,Shelbina,1530,89,551,294,88,35,1057
Missouri,Anniston,145,29,64,17,0,0,110
Missouri,Charleston,5704,919,1819,1144,322,163,4367
Missouri,Pinhook,0,0,0,0,0,0,0
Missouri,Tarkio,1509,143,449,278,169,54,1093
Missouri,Caruthersville,5760,1006,1449,880,294,245,3874
Missouri,Holland,177,53,36,39,2,1,131
Missouri,St. Mary,365,42,111,55,7,11,226
Missouri,Bellflower,384,34,155,53,15,0,257
Missouri,High Hill,214,24,72,38,21,4,159
Missouri,Osceola,1025,130,353,223,28,23,757
Missouri,El Dorado Springs,3545,305,937,738,268,94,2342
Missouri,Mindenmines,301,17,109,67,10,6,209
Missouri,Gower,1554,87,366,382,154,61,1050
Missouri,Holt,395,40,113,57,22,11,243
Missouri,Humansville,1026,198,413,133,38,0,782
Missouri,Cairo,330,25,90,83,10,18,226
Missouri,Risco,370,35,135,60,7,6,243
Missouri,Winfield,1321,118,393,206,90,42,849
Missouri,Chain of Rocks,95,5,25,24,6,0,60
Missouri,Gray Summit,2594,263,487,670,322,75,1817
Missouri,Triplett,16,1,6,3,0,6,16
Missouri,Potosi,2617,579,463,517,161,85,1805
Missouri,Bismarck,1395,232,295,343,69,38,977
Missouri,Canalou,215,41,52,28,4,0,125
Missouri,Chain-O-Lakes,112,3,21,56,15,4,99
Missouri,Lincoln,926,83,243,231,42,25,624
Missouri,Carl Junction,7995,339,1262,1541,1164,592,4898
Missouri,Bourbon,1946,400,567,330,56,25,1378
Missouri,Brunswick,854,98,298,137,45,27,605
Missouri,New Haven,1952,153,452,542,125,57,1329
Missouri,Grandin,269,26,58,41,16,0,141
Missouri,Granger,30,4,9,7,2,0,22
Missouri,Fidelity,231,25,72,55,23,1,176
Missouri,Neck City,174,14,74,30,0,9,127
Missouri,Reeds,89,7,33,20,6,2,68
Missouri,Weston,1675,73,287,363,274,145,1142
Missouri,Revere,60,2,24,12,0,0,38
Missouri,Fremont Hills,1130,43,127,189,291,198,848
Missouri,Hermann,2422,160,663,495,290,132,1740
Missouri,Rock Port,1452,99,441,311,196,58,1105
Missouri,Bloomsdale,772,36,201,169,75,21,502
Missouri,Innsbrook,700,27,126,117,157,159,586
Missouri,Warrenton,8129,655,1701,1952,506,272,5086
Missouri,Hume,397,41,106,50,12,7,216
Missouri,Kingsville,256,26,76,55,12,5,174
Missouri,Strafford,2035,172,588,473,177,26,1436
Missouri,Republic,16044,809,3042,3689,1392,815,9747
Missouri,North Kansas City,4414,384,1105,1003,529,274,3295
Missouri,Missouri City,543,150,181,79,7,19,436
Missouri,Liberty,30928,1189,5522,5946,5229,2492,20378
Missouri,Kidder,213,24,70,38,23,2,157
Missouri,Oaks,141,10,15,34,33,12,104
Missouri,Bland,505,103,145,67,25,10,350
Missouri,Cosby,189,13,21,51,21,1,107
Missouri,Mansfield,1450,179,399,332,68,27,1005
Missouri,Hartville,578,140,163,99,18,11,431
Missouri,Weatherby Lake,1967,26,154,464,441,392,1477
Missouri,Camden Point,512,23,129,104,42,37,335
Missouri,Naylor,793,71,211,165,24,10,481
Missouri,Iberia,674,63,226,84,47,18,438
Missouri,Cowgill,206,19,62,30,2,3,116
Missouri,Kansas City,481417,33675,82996,96876,69682,41836,325065
Missouri,St. Peters,56838,2254,9840,12928,9879,5484,40385
Missouri,Wardell,234,38,94,41,10,3,186
Missouri,Van Buren,1080,91,177,222,66,27,583
Missouri,Airport Drive,889,25,147,190,121,75,558
Missouri,Duenweg,1370,94,420,266,121,19,920
Missouri,Lucerne,80,2,20,11,7,1,41
Missouri,Unionville,1998,164,528,477,96,52,1317
Missouri,Clarence,917,85,268,186,26,18,583
Missouri,La Russell,121,24,27,16,2,0,69
Missouri,Sweet Springs,1572,194,498,321,70,30,1113
Missouri,Ridgely,66,3,30,9,7,1,50
Missouri,Camdenton,3977,441,936,944,266,134,2721
Missouri,Brandsville,99,15,35,26,3,2,81
Missouri,Riverside,3255,239,609,712,408,205,2173
Missouri,Arbela,31,2,12,6,0,0,20
Missouri,Rutledge,83,23,20,3,1,3,50
Missouri,Huntsville,1527,133,446,408,78,18,1083
Missouri,Edgerton,517,21,155,83,68,6,333
Missouri,Sarcoxie,1343,109,354,338,65,37,903
Missouri,Duquesne,1839,113,381,360,181,129,1164
Missouri,Iatan,48,6,25,1,1,3,36
Missouri,Moberly,13762,1317,3008,3468,1061,514,9368
Missouri,Frohna,235,8,85,43,18,6,160
Missouri,Carrollton,3637,424,1107,550,275,154,2510
Missouri,Altenburg,372,25,114,61,28,22,250
Missouri,Leadwood,1382,191,356,273,20,16,856
Missouri,Rocheport,260,9,50,55,29,23,166
Missouri,Jefferson City,43013,2694,8349,8981,6402,3387,29813
Missouri,Odessa,5189,300,1589,949,378,242,3458
Missouri,Deepwater,432,41,111,100,25,7,284
Missouri,Blackwater,198,7,57,43,14,3,124
Missouri,Arcola,80,3,23,23,9,3,61
Missouri,Frankford,404,37,173,61,27,8,306
Missouri,Hurley,237,38,50,46,3,0,137
Missouri,Elmira,29,4,13,3,3,1,24
Missouri,Bloomfield,2086,278,579,374,203,32,1466
Missouri,Dudley,218,33,83,39,16,1,172
Missouri,Oak Grove,8008,373,1667,1996,577,195,4808
Missouri,Lake Lotawana,2092,54,331,369,466,298,1518
Missouri,Unity Village,92,1,8,15,29,13,66
Missouri,Dexter,7885,1314,1935,1573,433,234,5489
Missouri,Lexington,4558,431,1445,877,426,203,3382
Missouri,Napoleon,213,17,88,31,10,9,155
Missouri,Jamestown,462,31,146,46,38,19,280
Missouri,Velda City,1367,186,274,346,48,12,866
Missouri,Mill Spring,130,45,25,12,1,0,83
Missouri,Ludlow,122,32,38,14,8,3,95
Missouri,Excelsior Estates,203,34,58,31,3,0,126
Missouri,Osage Beach,4909,349,1308,973,570,278,3478
Missouri,Vandalia,4178,731,1484,680,214,77,3186
Missouri,Collins,178,24,66,47,2,6,145
Missouri,Chillicothe,9136,1116,2398,1673,844,431,6462
Missouri,Reeds Spring,987,90,272,182,69,27,640
Missouri,Kennett,10225,1652,2531,1706,885,342,7116
Missouri,Golden City,671,95,202,147,25,11,480
Missouri,Liberal,644,47,226,113,41,9,436
Missouri,Stockton,1818,222,496,350,120,79,1267
Missouri,Miller,756,81,204,142,43,12,482
Missouri,Holliday,102,13,47,10,4,1,75
Missouri,Newburg,492,69,172,86,5,12,344
Missouri,Bel-Nor,1389,54,138,269,279,289,1029
Missouri,Cool Valley,1164,143,299,234,107,34,817
Missouri,Crestwood,11881,381,1440,2362,2763,1727,8673
Missouri,Flordell Hills,898,59,192,163,34,9,457
Missouri,Hanley Hills,1832,219,410,502,131,26,1288
Missouri,Moundville,143,16,40,44,4,3,107
Missouri,Rensselaer,241,30,61,60,24,23,198
Missouri,Anderson,2254,356,525,313,139,86,1419
Missouri,McKittrick,56,7,19,12,0,1,39
Missouri,Sullivan,6496,844,1607,1373,413,302,4539
Missouri,Lewistown,685,47,261,116,36,3,463
Missouri,Sugar Creek,3309,296,1119,566,167,103,2251
Missouri,La Grange,958,77,408,140,39,29,693
Missouri,Livonia,95,2,15,14,1,0,32
Missouri,Hunnewell,158,13,75,19,17,1,125
Missouri,Center,477,63,199,61,24,7,354
Missouri,Puxico,931,81,270,171,68,45,635
Missouri,Chamois,438,32,117,96,37,12,294
Missouri,Linn,1654,78,280,351,153,26,888
Missouri,Doniphan,2236,305,701,460,140,41,1647
Missouri,Hollister,4504,450,980,1036,390,121,2977
Missouri,Gentry,63,1,23,14,0,0,38
Missouri,King City,962,33,344,162,59,56,654
Missouri,Stanberry,1222,103,362,219,93,37,814
Missouri,Benton,913,109,216,195,90,37,647
Missouri,Vanduser,194,47,53,23,4,6,133
Missouri,Jonesburg,704,89,263,93,23,16,484
Missouri,Breckenridge,299,21,95,70,25,18,229
Missouri,Ionia,90,12,26,28,1,2,69
Missouri,Princeton,1083,60,314,249,56,30,709
Missouri,Galt,184,17,92,61,0,1,171
Missouri,Halfway,136,32,30,25,5,3,95
Missouri,Marlborough,2457,88,320,542,439,179,1568
Missouri,Aldrich,66,6,6,15,7,10,44
Missouri,Troy,11771,549,3044,2478,901,248,7220
Missouri,Silex,62,30,3,23,1,0,57
Missouri,Hawk Point,809,75,314,127,27,3,546
Missouri,Festus,11970,1140,2597,3029,1013,544,8323
Missouri,Garden City,1494,187,449,219,59,43,957
Missouri,Creighton,329,36,120,53,7,8,224
Missouri,Morehouse,913,178,225,223,3,23,652
Missouri,Rock Hill,4637,194,329,580,1307,746,3156
Missouri,St. Ann,12853,971,2787,3102,1233,385,8478
Missouri,Lake Ozark,1759,89,287,449,221,167,1213
Missouri,Linneus,282,29,116,38,17,5,205
Missouri,Joplin,50073,3359,10582,11038,5759,2833,33571
Missouri,Leawood,584,19,77,126,131,67,420
Missouri,Redings Mill,148,18,27,46,8,14,113
Missouri,Stotesbury,17,2,11,2,0,0,15
Missouri,Maplewood,8008,296,1239,1773,1488,921,5717
Missouri,Halltown,165,31,26,26,4,0,87
Missouri,Pine Lawn,3513,463,734,574,29,19,1819
Missouri,Brumley,95,9,26,9,12,2,58
Missouri,Walker,257,33,85,54,5,6,183
Missouri,Stoutsville,24,3,13,4,0,0,20
Missouri,Crystal Lake Park,430,0,23,59,144,114,340
Missouri,Eureka,10575,308,1511,1938,2161,1295,7213
Missouri,Florissant,51744,3152,9946,12291,5992,2630,34011
Missouri,Norwood Court,985,66,220,297,25,32,640
Missouri,Oakville,36827,1042,6086,8569,6917,3698,26312
Missouri,Shrewsbury,6166,181,616,1147,1487,1102,4533
Missouri,Utica,157,19,94,24,9,0,146
Missouri,Spanish Lake,18048,1006,3111,4745,1209,522,10593
Missouri,Lawson,2363,123,783,383,179,79,1547
Missouri,Merriam Woods,2001,223,475,380,73,19,1170
Missouri,Rosendale,138,25,34,17,6,0,82
Missouri,Country Club,2810,56,599,490,398,277,1820
Missouri,Brookfield,4481,478,1447,821,196,86,3028
Missouri,Bolckow,159,21,45,38,11,2,117
Missouri,Loma Linda,754,13,136,222,137,103,611
Missouri,Fairview,471,94,146,64,25,0,329
Missouri,Diamond,921,133,242,183,52,15,625
Missouri,Blairstown,122,7,65,16,0,2,90
Missouri,University City,34653,1282,3421,5164,6075,7799,23741
Missouri,Sycamore Hills,673,8,133,200,132,23,496
Missouri,Newtonia,192,30,46,50,5,6,137
Missouri,Richmond,5606,613,1697,1172,322,130,3934
Missouri,Sheridan,200,9,77,47,11,7,151
Missouri,Hartsburg,94,5,27,28,18,4,82
Missouri,Olean,55,12,20,8,0,0,40
Missouri,Deerfield,42,1,17,10,3,1,32
Missouri,Milo,79,32,9,10,4,0,55
Missouri,Oronogo,2580,108,386,479,338,125,1436
Missouri,Bates City,207,14,51,75,13,12,165
Missouri,Dover,81,11,33,16,2,0,62
Missouri,Lake Lafayette,313,43,115,67,4,3,232
Missouri,Farley,250,19,58,44,36,13,170
Missouri,Ferrelview,538,48,155,148,44,16,411
Missouri,Houston Lake,379,10,67,107,92,5,281
Missouri,Northmoor,481,44,106,76,59,27,312
Missouri,Parkville,6524,83,539,1069,1521,1146,4358
Missouri,Platte City,4905,108,1109,1041,541,297,3096
Missouri,Tracy,282,34,51,52,20,11,168
Missouri,South Gorin,87,35,6,12,0,1,54
Missouri,Bel-Ridge,2718,206,517,671,101,41,1536
Missouri,Bragg City,145,29,29,12,0,2,72
Missouri,Harrisburg,329,19,48,73,34,18,192
Missouri,Ashland,3905,204,682,920,573,201,2580
Missouri,Macon,5379,567,1374,976,549,174,3640
Missouri,Buffalo,3032,375,868,545,167,22,1977
Missouri,Carytown,257,23,81,45,37,7,193
Missouri,Brooklyn Heights,105,11,28,21,12,2,74
Missouri,Oakwood,176,12,28,27,48,16,131
Missouri,Avilla,68,5,21,14,1,0,41
Missouri,Salem,4939,885,1394,782,210,228,3499
Missouri,Rockville,123,20,43,28,1,0,92
Missouri,Lupus,29,0,7,10,9,2,28
Missouri,St. James,4112,491,829,854,428,241,2843
Missouri,Malta Bend,240,20,49,37,12,6,124
Missouri,Fordland,915,54,280,194,38,23,589
Missouri,Alba,710,47,175,161,90,0,473
Missouri,Winston,244,20,89,47,6,4,166
Missouri,Platte Woods,414,16,66,93,90,53,318
Missouri,Viburnum,734,79,140,169,52,12,452
Missouri,Arnold,21107,1711,5311,4956,1871,1112,14961
Missouri,Laredo,212,36,69,30,9,0,144
Missouri,Brashear,156,6,61,41,10,1,119
Missouri,Newark,82,10,30,17,1,3,61
Missouri,Hamilton,1771,145,568,277,132,75,1197
Missouri,Bosworth,166,22,77,24,0,3,126
Missouri,Tina,293,40,115,15,5,0,175
Missouri,Iron Mountain Lake,687,125,172,151,25,0,473
Missouri,Caledonia,185,24,66,26,6,4,126
Missouri,New Franklin,1105,133,289,232,60,47,761
Missouri,Butler,4164,311,1224,773,274,119,2701
Missouri,Poplar Bluff,17107,1932,3910,4129,776,550,11297
Missouri,Cainsville,219,19,84,49,7,3,162
Missouri,Pleasant Hope,684,26,158,181,44,22,431
Missouri,Easton,266,37,82,76,16,0,211
Missouri,South Lineville,12,0,1,8,0,0,9
Missouri,Castle Point,2593,157,534,590,193,91,1565
Missouri,Paris,1445,73,399,294,113,63,942
Missouri,Edgar Springs,194,7,50,49,9,4,119
Missouri,Charlack,1473,88,386,336,62,68,940
Missouri,Chesterfield,47663,606,3935,6732,11759,11282,34314
Missouri,East Lynne,220,16,70,46,14,2,148
Missouri,Clayton,16448,309,689,1148,3337,4261,9744
Missouri,Diehlstadt,188,39,61,28,8,0,136
Missouri,Forsyth,2536,252,676,635,213,93,1869
Missouri,Marceline,2021,172,545,396,100,60,1273
Missouri,Dennis Acres,41,5,13,13,2,1,34
Missouri,Stark City,137,28,33,21,6,0,88
Missouri,St. Robert,5767,495,691,1431,681,607,3905
Missouri,Canton,2616,172,469,422,178,113,1354
Missouri,Gravois Mills,172,7,77,12,0,0,96
Missouri,Stover,1359,202,329,187,33,45,796
Missouri,Syracuse,144,16,64,17,1,1,99
Missouri,Auxvasse,1183,117,369,172,90,15,763
Missouri,Pagedale,3291,369,727,782,91,125,2094
Missouri,St. John,6432,555,1603,1457,377,280,4272
Missouri,Emma,232,18,57,44,22,17,158
Missouri,Lathrop,2259,87,535,526,155,75,1378
Missouri,Spickard,295,35,69,45,7,5,161
Missouri,Sunrise Beach,363,37,105,75,37,8,262
Missouri,Sedgewickville,161,16,41,21,9,11,98
Missouri,Marshfield,7226,438,1688,1580,513,283,4502
Missouri,Rogersville,3644,195,627,854,344,114,2134
Missouri,Marble Hill,1727,193,469,290,71,38,1061
Missouri,Hayti Heights,612,43,132,80,1,0,256
Missouri,Foristell,639,19,125,173,102,16,435
Missouri,McFall,95,1,41,11,5,0,58
Missouri,Glasgow Village,4981,190,916,805,150,1,2062
Missouri,Greendale,822,30,102,205,160,93,590
Missouri,Huntleigh,533,2,44,69,155,77,347
Missouri,Darlington,64,10,22,7,1,2,42
Missouri,Rea,38,2,27,5,3,0,37
Missouri,Miami,92,12,17,30,3,3,65
Missouri,Ewing,383,62,127,80,12,4,285
Missouri,Birch Tree,705,173,172,110,45,2,502
Missouri,Grand Falls Plaza,118,8,13,25,25,13,84
Missouri,Seligman,862,132,244,105,17,0,498
Missouri,Renick,152,9,51,44,14,0,118
Missouri,Longtown,123,12,49,7,6,0,74
Missouri,Neelyville,354,73,85,63,1,2,224
Missouri,Bernie,1957,312,487,329,61,43,1232
Missouri,Baker,0,0,0,0,0,0,0
Missouri,Lanagan,411,115,104,36,20,6,281
Missouri,Lockwood,1154,143,385,182,55,23,788
Missouri,Greenfield,1503,185,413,321,59,33,1011
Missouri,Polo,551,50,196,97,10,7,360
Missouri,Braymer,686,54,201,183,53,14,505
Missouri,Windsor,2990,362,659,803,151,22,1997
Missouri,Novelty,175,3,85,18,8,4,118
Missouri,Wright City,3593,389,779,659,270,79,2176
Missouri,Steele,2188,255,526,312,126,60,1279
Missouri,Blodgett,192,34,51,11,5,0,101
Missouri,Foley,122,33,31,14,4,1,83
Missouri,Whiteside,60,20,22,9,0,0,51
Missouri,Morrisville,419,52,96,103,23,6,280
Missouri,Kirkwood,27693,613,2327,4304,6911,5716,19871
Missouri,Excelsior Springs,11575,880,3005,2191,1022,430,7528
Missouri,Hornersville,597,101,192,95,15,11,414
Missouri,Coffey,188,16,50,42,2,0,110
Missouri,Pilot Knob,684,73,175,117,30,2,397
Missouri,Ash Grove,1634,179,348,368,120,46,1061
Missouri,St. Clair,4693,697,967,1194,196,74,3128
Missouri,Big Lake,102,4,44,31,21,2,102
Missouri,Hermitage,769,117,178,143,76,41,555
Missouri,Steelville,1888,298,485,276,37,50,1146
Missouri,Laclede,362,22,154,77,18,7,278
Missouri,Kingdom City,170,35,52,17,9,11,124
Missouri,Gasconade,329,45,88,49,3,0,185
Missouri,Ozark,19418,929,3105,3973,2663,1261,11931
Missouri,Southwest City,1238,371,113,146,47,10,687
Missouri,Pineville,811,69,233,180,50,17,549
Missouri,Pierpont,69,0,23,9,10,13,55
Missouri,Lamar Heights,198,35,39,21,17,16,128
Missouri,Plattsburg,2304,189,612,469,212,100,1582
Missouri,Rushville,250,14,78,40,21,5,158
Missouri,Loch Lloyd,649,0,38,135,273,113,559
Missouri,De Kalb,210,15,80,39,18,4,156
Missouri,Owensville,2580,280,624,513,206,116,1739
Missouri,Tipton,3369,392,1391,639,167,49,2638
Missouri,Brentwood,8023,103,306,1192,2197,2016,5814
Missouri,Aullville,106,13,40,8,0,4,65
Missouri,Birmingham,204,21,59,51,7,0,138
Missouri,Benton City,188,16,58,48,0,3,125
Missouri,Rush Hill,175,48,49,17,2,0,116
Missouri,Arkoe,44,5,13,11,1,1,31
Missouri,Warson Woods,1915,4,68,202,579,479,1332
Missouri,Piedmont,2621,404,666,499,141,70,1780
Missouri,Vienna,678,82,199,146,43,24,494
Missouri,Clyde,72,1,19,15,4,0,39
Missouri,Guilford,56,5,23,9,4,0,41
Missouri,Pickering,119,2,30,18,6,8,64
Missouri,Harris,18,2,9,4,0,0,15
Missouri,Humphreys,81,23,18,10,3,0,54
Missouri,Milan,2670,371,876,460,78,39,1824
Missouri,Newtown,190,8,76,14,12,2,112
Missouri,Claycomo,1419,149,558,361,92,21,1181
Missouri,Glenwood,214,11,38,69,4,2,124
Missouri,Paynesville,47,4,18,16,3,2,43
Missouri,Grant City,908,80,302,152,77,58,669
Missouri,Bevier,696,70,258,134,17,7,486
Missouri,Elmer,73,7,34,12,0,0,53
Missouri,Holts Summit,3720,337,725,711,423,304,2500
Missouri,Gladstone,26995,1270,6004,6264,3876,1936,19350
Missouri,Battlefield,6104,178,821,1390,896,480,3765
Missouri,Pleasant Hill,8418,639,1855,1483,968,333,5278
Missouri,Oakview,482,17,77,121,75,25,315
Missouri,Warsaw,2469,226,717,530,89,74,1636
Missouri,St. Paul,2431,51,556,466,409,255,1737
Missouri,Augusta,266,17,54,58,37,21,187
Missouri,Qulin,554,99,131,108,36,2,376
Missouri,Corder,386,25,116,78,19,6,244
Missouri,Cole Camp,1168,77,385,298,81,56,897
Missouri,Louisiana,3272,279,1049,478,202,70,2078
Missouri,Umber View Heights,51,0,18,18,8,3,47
Missouri,Bronaugh,207,26,52,37,4,5,124
Missouri,Vista,64,0,19,11,3,0,33
Missouri,Monroe City,2487,211,914,379,101,76,1681
Missouri,Gainesville,685,86,171,138,35,0,430
Missouri,Lakeside,0,0,0,0,0,0,0
Missouri,Kimberling City,2714,142,534,853,380,208,2117
Missouri,Norborne,830,60,294,186,31,27,598
Missouri,Wheaton,647,74,200,123,10,0,407
Missouri,Emerald Beach,276,10,75,60,68,58,271
Missouri,Cassville,3289,598,945,406,157,163,2269
Missouri,Scotsdale,168,10,45,44,23,7,129
Missouri,Byrnes Mill,2944,200,675,741,352,134,2102
Missouri,Morley,726,146,186,125,24,0,481
Missouri,De Soto,6390,842,1430,1452,389,278,4391
Missouri,Bakersfield,244,29,58,39,4,5,135
Missouri,Tarrants,0,0,0,0,0,0,0
Missouri,Eolia,489,48,137,86,38,11,320
Missouri,Sparta,1642,147,482,330,127,15,1101
Missouri,Altamont,173,11,61,27,14,5,118
Missouri,Des Arc,211,38,52,30,0,0,120
Missouri,Bunker,347,58,146,54,2,0,260
Missouri,Barnard,234,16,83,48,6,6,159
Missouri,Clearmont,169,9,73,21,22,3,128
Missouri,Linn Creek,302,31,79,48,43,19,220
Missouri,Louisburg,68,11,20,19,0,3,53
Missouri,Hallsville,1579,106,361,292,172,63,994
Missouri,Glenaire,496,43,125,114,62,38,382
Missouri,Pleasant Valley,3033,167,885,834,311,35,2232
Missouri,Fair Grove,1624,62,366,349,166,67,1010
Missouri,Kearney,9778,380,1986,2196,1144,354,6060
Missouri,Flint Hill,564,13,145,100,116,35,409
Missouri,Lohman,174,6,49,28,29,13,125
Missouri,Mount Moriah,75,13,21,12,3,0,49
Missouri,Ridgeway,378,32,157,44,19,13,265
Missouri,Weldon Spring Heights,93,2,21,22,14,15,74
Missouri,Dixon,1256,180,297,280,27,30,814
Missouri,Shoal Creek Drive,463,19,91,91,89,21,311
Missouri,Wentworth,111,9,43,13,8,1,74
Missouri,Crocker,1152,71,267,225,108,21,692
Missouri,La Belle,688,110,210,138,52,4,514
Missouri,Bunceton,333,45,80,74,11,8,218
Missouri,Dutchtown,22,10,8,2,2,0,22
Missouri,Wyaconda,190,38,66,29,5,0,138
Missouri,Rives,53,4,14,14,0,0,32
Missouri,Blue Eye,280,26,71,64,23,15,199
Missouri,Stella,161,15,45,17,7,3,87
Missouri,Winona,1395,215,374,205,56,18,868
Missouri,Prairie Home,264,22,62,58,18,22,182
Missouri,Penermon,87,25,13,13,0,0,51
Missouri,Wellsville,1157,147,330,205,37,22,741
Missouri,Noel,2424,511,601,225,44,37,1418
Missouri,Advance,1246,175,347,338,91,19,970
Missouri,Lamar,4329,444,1248,763,309,165,2929
Missouri,Delta,415,40,128,62,22,6,258
Missouri,Everton,359,45,117,77,15,0,254
Missouri,Franklin,58,24,20,9,0,1,54
Missouri,East Prairie,3096,746,621,396,144,42,1949
Missouri,Malden,4244,546,1122,558,207,135,2568
Missouri,Junction City,309,43,44,84,11,4,186
Missouri,Marquand,316,23,111,67,18,0,219
Missouri,Gordonville,511,21,143,103,68,38,373
Missouri,Oak Ridge,228,20,72,36,8,6,142
Missouri,Indian Point,477,27,95,151,82,37,392
Missouri,Annapolis,420,87,105,69,20,10,291
Missouri,Arrow Point,111,10,47,8,3,11,79
Missouri,Perryville,8403,796,2361,1594,640,327,5718
Montana,Olney,225,0,83,60,0,0,143
Montana,Midvale,462,88,242,0,0,0,330
Montana,Maxville,214,20,45,91,31,17,204
Montana,Marysville,67,0,27,8,23,9,67
Montana,Santa Rita,267,33,21,41,13,0,108
Montana,Pioneer Junction,849,93,350,179,77,22,721
Montana,Spokane Creek,344,0,111,82,45,42,280
Montana,South Hills,700,5,32,78,139,135,389
Montana,Silver Gate,25,0,3,7,8,3,21
Montana,Silesia,10,0,5,5,0,0,10
Montana,Shawmut,56,4,28,12,8,0,52
Montana,Sedan,97,0,21,50,3,23,97
Montana,Martinsdale,26,5,8,4,9,0,26
Montana,Sand Coulee,276,22,55,50,59,23,209
Montana,Roy,119,2,44,30,10,14,100
Montana,Rosebud,76,0,22,24,22,0,68
Montana,Roscoe,32,0,5,22,5,0,32
Montana,Rocky Boy West,878,72,124,198,52,7,453
Montana,Roberts,295,10,71,55,66,3,205
Montana,Rader Creek,195,11,84,72,0,8,175
Montana,Pray,751,9,248,174,93,84,608
Montana,Pony,125,0,22,37,18,7,84
Montana,Ponderosa Pines,328,26,80,109,27,7,249
Montana,Piltzville,433,10,103,147,50,20,330
Montana,Marion,930,20,303,237,63,40,663
Montana,Conner,91,9,38,22,5,4,78
Montana,Little Browning,260,0,68,49,10,0,127
Montana,Biddle,48,0,16,13,7,0,36
Montana,Belknap,317,0,148,70,0,0,218
Montana,Bear Dance,193,0,26,14,82,62,184
Montana,Batavia,328,33,97,47,30,10,217
Montana,Babb,160,0,64,84,0,0,148
Montana,Amsterdam,184,10,44,42,15,3,114
Montana,Alzada,24,8,8,5,0,1,22
Montana,Rocky Boy's Agency,475,72,80,60,27,23,262
Montana,Boulder,942,113,280,199,48,15,655
Montana,Belt,538,40,196,133,17,15,401
Montana,Frazer,330,21,76,44,2,3,146
Montana,Absarokee,859,52,215,313,82,25,687
Montana,St. Xavier,97,0,10,26,7,15,58
Montana,Muddy,626,43,86,140,16,3,288
Montana,Busby,715,29,127,125,30,11,322
Montana,Cardwell,96,14,24,7,7,0,52
Montana,Joplin,242,0,57,82,35,6,180
Montana,Springdale,57,0,27,8,0,0,35
Montana,St. Regis,305,33,53,23,45,9,163
Montana,Garrison,52,4,12,15,3,3,37
Montana,Helena Valley Southeast,8067,323,1707,1813,846,312,5001
Montana,Herron,210,11,28,19,21,14,93
Montana,Inverness,41,9,6,6,5,0,26
Montana,Boyd,34,0,0,0,0,30,30
Montana,Rudyard,126,0,34,46,35,2,117
Montana,Columbia Falls,5225,223,1178,1395,715,239,3750
Montana,Lakeside,2160,85,474,348,470,174,1551
Montana,Reserve,34,0,5,17,4,0,26
Montana,Richey,187,6,47,46,24,8,131
Montana,Fort Belknap Agency,1514,157,131,396,68,25,777
Montana,Lodge Pole,232,20,32,78,5,10,145
Montana,Helena Valley West Central,8277,248,1564,2069,1186,730,5797
Montana,Logan,31,15,16,0,0,0,31
Montana,Brady,141,0,45,22,29,16,112
Montana,Bynum,35,12,11,9,1,0,33
Montana,Little Bitterroot Lake,144,9,11,65,27,15,127
Montana,Lindisfarne,255,25,26,137,14,4,206
Montana,Lake Mary Ronan,77,0,21,20,19,5,65
Montana,King Arthur Park,1239,0,96,326,297,0,719
Montana,Kila,321,19,86,73,40,30,248
Montana,Jardine,33,2,3,10,14,0,29
Montana,Indian Springs,63,0,0,0,46,17,63
Montana,Huson,18,0,18,0,0,0,18
Montana,Hinsdale,285,1,56,55,31,16,159
Montana,Helena Flats,999,48,278,244,115,43,728
Montana,Hebgen Lake Estates,88,12,0,60,11,5,88
Montana,Happys Inn,102,0,13,60,16,13,102
Montana,Gibson Flats,219,0,83,35,18,22,158
Montana,Geyser,95,3,28,32,16,0,79
Montana,Gallatin River Ranch,105,0,38,11,22,17,88
Montana,Gallatin Gateway,868,45,148,200,178,60,631
Montana,Forest Hill Village,240,0,121,66,0,0,187
Montana,Camas,79,11,15,17,0,0,43
Montana,Carlton,686,27,307,54,172,18,578
Montana,Charlos Heights,97,0,84,13,0,0,97
Montana,Churchill,984,63,142,143,207,61,616
Montana,Condon,269,10,84,59,46,28,227
Montana,Cooke City,46,2,6,18,17,3,46
Montana,Bridger,49,0,0,13,21,0,34
Montana,Dupuyer,96,3,37,31,21,0,92
Montana,Craig,23,0,8,6,9,0,23
Montana,Crane,179,5,25,51,41,7,129
Montana,East Helena,1808,85,389,522,239,62,1297
Montana,Edgar,103,18,31,38,0,0,87
Montana,Elkhorn,0,0,0,0,0,0,0
Montana,Emigrant,233,3,32,50,54,35,174
Montana,Corwin Springs,98,11,5,33,17,10,76
Montana,Springhill,175,8,7,47,35,34,131
Montana,Saddle Butte,55,0,16,23,3,5,47
Montana,Stryker,38,8,14,5,3,0,30
Montana,Gardiner,971,50,195,151,200,107,703
Montana,Hungry Horse,575,8,109,154,126,42,439
Montana,Coram,439,23,156,148,46,0,373
Montana,Stevensville,2163,88,461,461,259,135,1404
Montana,Hamilton,4628,398,969,1047,693,424,3531
Montana,Hays,996,37,112,244,53,34,480
Montana,Heart Butte,571,40,82,127,18,11,278
Montana,Helena,31212,1076,4661,6271,5804,4002,21814
Montana,White Sulphur Springs,939,42,382,174,54,29,681
Montana,Wilsall,322,25,55,61,72,33,246
Montana,Lewistown Heights,559,21,102,133,22,0,278
Montana,West Yellowstone,1016,22,271,248,156,50,747
Montana,Four Corners,4336,81,379,772,998,570,2800
Montana,Big Sky,3098,127,351,534,894,269,2175
Montana,Hingham,100,10,27,26,15,5,83
Montana,Beaver Creek,384,15,115,119,18,0,267
Montana,Twin Bridges,305,12,111,67,32,11,233
Montana,Winnett,165,4,51,36,19,8,118
Montana,De Borgia,70,37,33,0,0,0,70
Montana,Woods Bay,800,5,207,241,95,89,637
Montana,Jefferson City,521,17,94,167,48,38,364
Montana,Ennis,925,42,255,350,100,48,795
Montana,Jordan,473,12,157,113,24,6,312
Montana,Baker,1727,82,412,493,97,75,1159
Montana,Melstone,101,15,19,37,7,0,78
Montana,Evergreen,7907,552,2187,1899,550,212,5400
Montana,Sunburst,276,19,63,80,35,12,209
Montana,Fort Shaw,125,27,29,47,5,0,108
Montana,Worden,668,0,201,179,35,15,430
Montana,Shepherd,595,22,94,103,75,34,328
Montana,Reed Point,277,7,95,61,17,15,195
Montana,Fort Smith,107,13,19,34,19,9,94
Montana,Montana City,2796,45,390,609,689,231,1964
Montana,Anaconda-Deer Lodge,9100,707,2621,2411,902,306,6947
Montana,Basin,237,13,47,69,29,12,170
Montana,Billings,109431,4616,21294,23695,17343,7657,74605
Montana,Park City,746,20,252,171,55,39,537
Montana,Pryor,557,31,131,131,27,10,330
Montana,Lodge Grass,419,30,81,82,15,0,208
Montana,Chinook,944,64,290,247,126,27,754
Montana,West Glendive,1803,66,502,531,151,52,1302
Montana,Sidney,6475,368,1563,1543,574,190,4238
Montana,Manhattan,1506,20,271,403,277,98,1069
Montana,Bozeman,45121,551,3240,7301,8824,5728,25644
Montana,Lockwood,7479,334,2044,1556,773,169,4876
Montana,Helena Valley Northeast,3201,112,584,825,649,263,2433
Montana,Starr School,292,73,110,20,10,8,221
Montana,Cut Bank,3007,230,496,774,178,163,1841
Montana,Huntley,471,23,144,100,54,14,335
Montana,Savage,283,20,87,60,39,3,209
Montana,South Glastonbury,351,0,80,134,64,12,290
Montana,Zortman,30,0,12,8,10,0,30
Montana,Yaak,282,20,81,82,29,27,239
Montana,Wineglass,411,32,65,152,51,0,300
Montana,Whitewater,124,6,14,17,19,0,56
Montana,White Haven,490,30,150,96,66,0,342
Montana,Wheatland,398,10,112,110,54,9,295
Montana,Laurel,6849,228,2055,1613,757,109,4762
Montana,West Kootenai,64,15,32,17,0,0,64
Montana,Weeksville,72,16,35,21,0,0,72
Montana,Turner,84,1,26,14,9,3,53
Montana,Turah,394,0,102,54,49,32,237
Montana,The Silos,682,8,101,107,164,76,456
Montana,Sylvanite,70,0,18,22,13,8,61
Montana,Sweet Grass,55,3,3,20,21,0,47
Montana,Trego,554,63,117,133,97,23,433
Montana,Swan Lake,171,46,37,50,17,4,154
Montana,Sula,93,15,0,56,3,0,74
Montana,West Glacier,159,0,16,38,23,31,108
Montana,Gildford,158,3,29,45,28,0,105
Montana,Eureka,1405,182,277,392,179,46,1076
Montana,Troy,687,22,308,228,47,36,641
Montana,Colstrip,2446,30,521,582,251,82,1466
Montana,Broadus,509,12,130,133,49,27,351
Montana,Lima,147,11,41,71,4,4,131
Montana,Libby,2663,373,644,562,256,47,1882
Montana,Havre,9762,554,1796,2138,1105,431,6024
Montana,Ovando,73,14,26,17,1,0,58
Montana,Kings Point,113,0,14,70,17,12,113
Montana,Kicking Horse,74,0,7,28,17,8,60
Montana,Hysham,293,17,86,72,21,6,202
Montana,Toston,79,16,42,10,11,0,79
Montana,Riverbend,358,50,73,96,42,0,261
Montana,Old Agency,88,24,17,12,1,3,57
Montana,Malta,2090,232,537,428,233,89,1519
Montana,Camp Three,177,9,35,72,3,6,125
Montana,Malmstrom AFB,4116,18,245,722,425,119,1529
Montana,Black Eagle,1027,101,231,252,135,26,745
Montana,Brockton,224,3,65,37,17,2,124
Montana,Fox Lake,79,3,11,21,10,10,55
Montana,Wisdom,96,6,25,36,7,14,88
Montana,Joliet,475,10,116,112,57,3,298
Montana,Miles City,8576,422,1789,2489,763,479,5942
Montana,Stockett,224,0,59,55,11,6,131
Montana,Rollins,218,10,17,46,71,30,174
Montana,Plains,893,72,326,166,66,28,658
Montana,Polson,4843,219,911,1036,560,397,3123
Montana,Arlee,603,27,114,159,53,44,397
Montana,Carter,72,4,29,11,5,5,54
Montana,Winston,245,0,63,47,109,0,219
Montana,Musselshell,57,4,39,5,6,0,54
Montana,Circle,505,21,158,163,41,3,386
Montana,Fort Benton,1462,48,416,317,249,54,1084
Montana,Big Timber,1739,52,516,383,165,90,1206
Montana,Rocky Point,97,18,15,34,30,0,97
Montana,Fallon,68,0,13,35,4,3,55
Montana,Elliston,230,27,57,60,52,12,208
Montana,Highwood,197,8,52,46,25,4,135
Montana,East Glacier Park Village,520,2,79,101,78,79,339
Montana,Ulm,632,45,205,177,34,17,478
Montana,Somers,1088,100,316,295,148,32,891
Montana,Augusta,294,11,74,63,46,25,219
Montana,Fairview,978,77,274,223,53,29,656
Montana,St. Pierre,327,10,33,88,15,9,155
Montana,Charlo,320,13,74,82,22,10,201
Montana,Avon,152,4,51,26,10,6,97
Montana,Pablo,2655,200,397,542,93,19,1251
Montana,St. Ignatius,746,64,186,149,60,27,486
Montana,Lolo,3780,28,794,837,607,270,2536
Montana,Willow Creek,247,7,75,42,34,12,170
Montana,Belgrade,8345,325,1710,1575,1328,411,5349
Montana,Victor,753,88,189,162,22,30,491
Montana,West Havre,217,0,33,66,53,0,152
Montana,Dayton,75,9,23,17,17,9,75
Montana,Big Arm,242,0,65,77,69,0,211
Montana,Bridger,745,50,259,197,57,37,600
Montana,Harlowton,1076,121,311,206,97,35,770
Montana,Trout Creek,150,7,58,58,21,6,150
Montana,Orchard Homes,5859,114,921,1267,1160,498,3960
Montana,Evaro,416,5,113,124,24,42,308
Montana,Bonner-West Riverside,1726,124,420,468,123,20,1155
Montana,Opheim,89,4,20,41,4,10,79
Montana,Fairfield,654,30,163,144,79,24,440
Montana,Ronan,1985,129,370,488,215,62,1264
Montana,Deer Lodge,2976,186,669,752,368,189,2164
Montana,Turtle Lake,325,43,47,42,0,0,132
Montana,Paradise,189,30,50,52,11,2,145
Montana,Livingston,7478,221,1892,1707,1200,451,5471
Montana,Radersburg,112,34,61,7,10,0,112
Montana,Hobson,198,12,63,49,29,6,159
Montana,Alder,92,6,27,22,14,0,69
Montana,Wolf Point,2799,176,532,657,247,102,1714
Montana,Froid,206,23,41,39,31,9,143
Montana,Wye,664,49,136,120,46,15,366
Montana,East Missoula,2132,94,345,627,277,135,1478
Montana,Azure,310,19,72,51,10,0,152
Montana,Plevna,226,7,33,70,18,5,133
Montana,Superior,690,26,280,197,62,13,578
Montana,Clinton,875,97,174,184,90,26,571
Montana,Frenchtown,2330,131,452,597,263,110,1553
Montana,Lewistown,5895,399,1542,1325,903,270,4439
Montana,Lincoln,898,73,227,287,76,15,678
Montana,Drummond,304,26,80,51,28,21,206
Montana,Big Sandy,527,36,144,105,69,32,386
Montana,Box Elder,69,17,13,20,7,0,57
Montana,Bearcreek,187,2,68,40,32,2,144
Montana,Belfry,259,15,66,87,18,7,193
Montana,Sheridan,879,40,167,241,136,58,642
Montana,Kevin,126,10,47,31,0,0,88
Montana,Cascade,653,47,196,164,65,24,496
Montana,Sun Prairie,1515,109,447,307,88,36,987
Montana,Walkerville,737,38,192,175,44,57,506
Montana,Dutton,296,18,73,81,29,11,212
Montana,Sun River,88,7,15,20,13,0,55
Montana,Westby,139,7,36,38,8,19,108
Montana,Wyola,194,17,48,42,18,9,134
Montana,Sangrey,373,48,51,96,9,0,204
Montana,Harrison,144,7,66,13,0,0,86
Montana,Jette,174,12,45,96,21,0,174
Montana,Finley Point,471,58,127,75,68,101,429
Montana,North Browning,2720,216,685,295,129,68,1393
Montana,Crow Agency,1928,126,333,334,119,28,940
Montana,Harlem,857,35,136,216,102,44,533
Montana,Clancy,1986,75,327,507,455,159,1523
Montana,Antelope,94,0,27,15,10,0,52
Montana,Dodson,123,22,6,17,6,1,52
Montana,Loma,82,13,46,23,0,0,82
Montana,Butte-Silver Bow (balance),34077,1873,7718,7254,4124,1952,22921
Montana,Roundup,1817,160,573,319,103,56,1211
Montana,Havre North,670,34,146,106,143,19,448
Montana,Whitefish,7309,167,995,1356,1979,1137,5634
Montana,Ryegate,195,13,54,44,19,14,144
Montana,South Browning,1522,96,368,156,88,33,741
Montana,Noxon,252,0,128,46,18,3,195
Montana,Heron,133,20,49,13,33,0,115
Montana,Fortine,321,11,75,72,44,0,202
Montana,Boneau,356,38,67,63,9,0,177
Montana,Vaughn,730,47,229,150,58,15,499
Montana,Great Falls,58990,3404,12560,13789,7007,3491,40251
Montana,Terry,782,48,226,161,87,18,540
Montana,Chester,1073,74,264,288,121,69,816
Montana,Clyde Park,206,7,64,60,18,8,157
Montana,Glendive,5232,261,1272,1272,584,278,3667
Montana,Florence,581,16,167,142,40,59,424
Montana,Corvallis,1143,136,223,206,78,13,656
Montana,Valier,617,35,176,136,52,14,413
Montana,Helena West Side,1320,108,273,351,178,157,1067
Montana,Grass Range,126,5,35,37,13,5,95
Montana,Shelby,3160,337,958,659,265,37,2256
Montana,Forsyth,1673,237,481,399,127,31,1275
Montana,Ashland,982,84,115,180,68,48,495
Montana,Poplar,896,46,180,212,61,57,556
Montana,Rexford,109,16,46,30,0,0,92
Montana,Scobey,1162,35,401,282,137,34,889
Montana,Flaxville,34,0,10,9,6,1,26
Montana,Seeley Lake,1256,107,330,326,158,94,1015
Montana,Fromberg,398,40,117,89,40,10,296
Montana,Ballantine,165,10,48,62,19,0,139
Montana,Red Lodge,2277,92,427,597,511,212,1839
Montana,Kerr,84,14,14,13,20,0,61
Montana,Wibaux,556,78,175,103,33,17,406
Montana,Niarada,11,0,8,3,0,0,11
Montana,Hot Springs,506,77,155,128,43,34,437
Montana,Saco,239,10,78,80,23,0,191
Montana,Townsend,2069,92,658,421,208,106,1485
Montana,Judith Gap,89,4,36,28,4,6,78
Montana,Thompson Falls,1231,92,353,215,118,20,798
Montana,Lonepine,162,13,29,56,17,2,117
Montana,Klein,75,11,32,9,10,0,62
Montana,Philipsburg,630,63,152,128,53,57,453
Montana,Simms,354,0,71,126,37,0,234
Montana,Dixon,202,16,53,40,35,5,149
Montana,Neihart,40,3,11,8,8,6,36
Montana,Parker School,522,51,86,98,20,5,260
Montana,Geraldine,202,11,52,65,18,13,159
Montana,Helena Valley Northwest,4163,72,540,1011,673,353,2649
Montana,Winifred,118,4,38,25,35,1,103
Montana,Culbertson,753,35,205,159,72,33,504
Montana,Dillon,4244,101,788,735,481,371,2476
Montana,Missoula,72125,1673,8321,14136,12874,9116,46120
Montana,Kremlin,79,17,21,13,15,2,68
Montana,Bainville,294,8,84,37,29,3,161
Montana,Ravalli,38,24,0,14,0,0,38
Montana,Elmo,177,17,42,50,15,0,124
Montana,Moore,183,15,54,43,22,3,137
Montana,Alberton,542,59,117,130,20,62,388
Montana,Denton,241,7,15,97,51,5,175
Montana,Whitehall,881,20,247,245,143,45,700
Montana,Ekalaka,373,23,127,116,37,16,319
Montana,Bigfork,4626,191,763,1281,845,504,3584
Montana,Lame Deer,2156,220,317,452,57,72,1118
Montana,Greycliff,96,17,15,36,6,0,74
Montana,Virginia City,204,14,37,76,34,11,172
Montana,Stanford,330,10,89,100,50,19,268
Montana,Birney,62,0,15,25,7,0,47
Montana,Broadview,134,2,42,42,9,7,102
Montana,Nashua,315,21,97,77,26,8,229
Montana,Glasgow,3348,138,886,699,429,173,2325
Montana,Fort Peck,218,7,42,89,28,9,175
Montana,Conrad,2531,97,587,644,282,136,1746
Montana,Browning,848,72,254,153,68,21,568
Montana,Lavina,212,6,69,51,26,10,162
Montana,Power,186,10,39,61,20,5,135
Montana,Plentywood,1858,113,366,553,237,48,1317
Montana,Darby,762,97,240,181,38,22,578
Montana,Pinesdale,955,64,167,97,19,6,353
Montana,Three Forks,1922,130,487,434,251,52,1354
Montana,Hardin,3842,256,879,591,311,139,2176
Montana,Columbus,2324,61,532,504,231,130,1458
Montana,Ismay,0,0,0,0,0,0,0
Montana,Choteau,1866,125,537,433,216,94,1405
Montana,Kalispell,22621,1051,4408,5363,2675,1512,15009
Montana,Martin City,391,47,189,63,35,0,334
Montana,Medicine Lake,284,10,67,69,45,16,207
Montana,Outlook,87,2,14,22,12,2,52
Montana,St. Marie,489,57,196,123,23,0,399
Montana,Custer,124,9,47,24,9,6,95
Moore County metropolitan government; Tennessee,Lynchbur,6322,655,1912,1044,583,359,4553
Nebraska,Wilber,1790,130,397,508,125,60,1220
Nebraska,Fairbury,3711,347,935,881,255,85,2503
Nebraska,Pickrell,227,10,74,51,19,7,161
Nebraska,Belgrade,125,4,54,29,12,0,99
Nebraska,Reynolds,82,3,26,17,0,0,46
Nebraska,Craig,166,16,70,31,7,8,132
Nebraska,Comstock,131,11,46,31,5,3,96
Nebraska,Oconto,139,13,45,54,7,0,119
Nebraska,Sargent,548,45,200,130,47,11,433
Nebraska,Venango,192,14,29,62,22,7,134
Nebraska,Syracuse,2110,58,540,561,240,69,1468
Nebraska,Octavia,139,17,47,26,5,0,95
Nebraska,Kilgore,74,2,15,20,0,9,46
Nebraska,Hildreth,449,19,116,122,44,24,325
Nebraska,Lindsay,287,21,99,62,34,7,223
Nebraska,Lebanon,73,6,6,24,13,4,53
Nebraska,Verdel,28,11,0,6,6,1,24
Nebraska,Cook,387,20,103,65,41,11,240
Nebraska,Giltner,315,17,86,79,18,13,213
Nebraska,Winslow,91,2,32,34,0,0,68
Nebraska,Homer,485,22,136,132,34,15,339
Nebraska,Fremont,26426,2231,6020,5815,1995,1100,17161
Nebraska,Howells,702,30,185,124,70,45,454
Nebraska,Waverly,3804,60,456,829,664,185,2194
Nebraska,Raymond,187,11,44,61,9,8,133
Nebraska,Hallam,244,8,56,72,22,5,163
Nebraska,Taylor,140,8,39,47,11,3,108
Nebraska,Amherst,158,9,33,44,19,10,115
Nebraska,Harrison,301,9,66,77,36,16,204
Nebraska,Central City,2893,87,706,819,263,87,1962
Nebraska,Utica,924,42,178,228,129,58,635
Nebraska,Seward,7151,220,1099,1307,884,622,4132
Nebraska,De Witt,581,12,166,159,39,11,387
Nebraska,Heartwell,72,4,35,8,2,2,51
Nebraska,Allen,348,18,100,70,29,5,222
Nebraska,Hemingford,867,32,207,226,131,29,625
Nebraska,Preston,36,9,11,8,0,2,30
Nebraska,Ponca,1009,45,266,219,109,55,694
Nebraska,Mason City,198,13,52,44,29,7,145
Nebraska,Callaway,746,42,178,187,52,28,487
Nebraska,Decatur,364,44,132,105,21,6,308
Nebraska,Elwood,754,26,221,193,77,37,554
Nebraska,Weeping Water,964,43,305,251,74,42,715
Nebraska,Gurley,221,4,52,82,18,1,157
Nebraska,Bruno,113,9,33,21,2,7,72
Nebraska,Bee,233,13,33,98,9,9,162
Nebraska,Cortland,502,16,95,143,53,18,325
Nebraska,Adams,517,32,150,94,49,26,351
Nebraska,Maywood,348,13,86,114,27,5,245
Nebraska,Polk,326,19,95,92,18,12,236
Nebraska,Culbertson,562,37,124,164,41,30,396
Nebraska,Holstein,274,30,75,72,10,1,188
Nebraska,Rulo,121,20,35,39,3,5,102
Nebraska,Filley,123,1,47,44,6,4,102
Nebraska,Kennard,383,14,89,111,21,9,244
Nebraska,Chapman,247,16,54,67,20,5,162
Nebraska,Gandy,52,0,2,31,2,2,37
Nebraska,Brewster,9,1,0,8,0,0,9
Nebraska,Rogers,110,15,37,14,2,2,70
Nebraska,Page,210,12,40,63,30,2,147
Nebraska,Geneva,1997,143,492,529,206,89,1459
Nebraska,Brunswick,191,12,58,38,29,2,139
Nebraska,Unadilla,277,11,91,43,35,19,199
Nebraska,Palmyra,596,34,116,187,36,13,386
Nebraska,Cody,195,8,33,54,22,15,132
Nebraska,Nebraska City,7263,535,1944,1435,626,294,4834
Nebraska,Douglas,161,16,30,46,18,6,116
Nebraska,Grant,1342,86,254,403,145,60,948
Nebraska,Plattsmouth,6448,308,1554,1785,481,157,4285
Nebraska,Alvo,138,6,32,32,10,5,85
Nebraska,Goehner,120,0,53,23,7,3,86
Nebraska,Garland,248,14,57,67,27,5,170
Nebraska,Genoa,1075,55,345,271,50,71,792
Nebraska,Richland,101,10,9,21,13,6,59
Nebraska,Loomis,412,6,99,125,27,8,265
Nebraska,Lawrence,391,25,102,104,23,22,276
Nebraska,Ord,2284,125,626,525,272,77,1625
Nebraska,Rushville,978,88,244,166,62,34,594
Nebraska,Berwyn,86,8,26,28,6,0,68
Nebraska,Lyons,838,47,261,206,65,24,603
Nebraska,Springfield,1344,43,303,294,256,69,965
Nebraska,Dixon,110,11,34,33,6,5,89
Nebraska,Papillion,20466,532,3069,4725,3540,2014,13880
Nebraska,La Vista,17077,516,2779,4553,2534,1177,11559
Nebraska,Crookston,70,0,15,15,2,1,33
Nebraska,Union,132,19,43,38,2,2,104
Nebraska,Elmwood,686,8,144,222,57,27,458
Nebraska,Fullerton,1459,132,296,328,119,71,946
Nebraska,Wymore,1438,135,417,404,67,28,1051
Nebraska,Juniata,711,24,193,236,73,20,546
Nebraska,Hastings,24922,1832,4329,5592,2448,1636,15837
Nebraska,Funk,253,23,43,60,38,1,165
Nebraska,Salem,123,19,29,20,0,8,76
Nebraska,Nehawka,216,13,65,44,18,4,144
Nebraska,Axtell,731,10,182,181,102,31,506
Nebraska,Wilcox,426,19,107,103,40,26,295
Nebraska,Herman,296,22,63,90,26,4,205
Nebraska,Upland,186,18,53,21,21,0,113
Nebraska,Spencer,377,14,99,85,63,32,293
Nebraska,Bristow,86,4,31,21,2,2,60
Nebraska,Dunbar,152,17,64,33,12,0,126
Nebraska,Gretna,5037,102,668,1000,985,502,3257
Nebraska,Jansen,140,5,48,36,8,3,100
Nebraska,South Bend,106,6,43,25,15,2,91
Nebraska,Murray,512,27,124,150,40,16,357
Nebraska,Avoca,265,21,60,59,1,0,141
Nebraska,Maskell,92,8,23,27,2,0,60
Nebraska,Primrose,77,6,26,22,2,0,56
Nebraska,Elyria,71,2,16,26,6,0,50
Nebraska,Battle Creek,1339,45,226,372,200,66,909
Nebraska,Henderson,991,24,201,273,73,82,653
Nebraska,Benedict,256,6,61,54,5,48,174
Nebraska,Ragan,41,9,16,3,4,0,32
Nebraska,Deshler,711,20,224,143,45,34,466
Nebraska,Humboldt,876,66,269,265,41,32,673
Nebraska,Fairfield,421,9,121,119,24,9,282
Nebraska,Long Pine,246,16,97,49,40,9,211
Nebraska,Winnetoon,63,6,26,13,5,0,50
Nebraska,Mead,628,27,126,166,55,15,389
Nebraska,Ithaca,148,9,31,46,13,4,103
Nebraska,Ashton,245,11,85,43,10,4,153
Nebraska,Niobrara,317,18,64,83,39,27,231
Nebraska,Bazile Mills,32,1,4,7,4,4,20
Nebraska,Saronville,72,3,16,7,4,4,34
Nebraska,St. Edward,718,46,182,193,34,37,492
Nebraska,Petersburg,385,16,121,92,24,7,260
Nebraska,Cedar Bluffs,601,19,128,178,35,20,380
Nebraska,Pleasant Dale,254,8,46,80,16,7,157
Nebraska,Milford,2327,134,376,485,183,80,1258
Nebraska,Crete,7050,1008,1094,1183,218,199,3702
Nebraska,Liberty,71,9,12,19,2,0,42
Nebraska,Curtis,848,18,144,206,55,60,483
Nebraska,Beaver Crossing,367,17,109,110,22,15,273
Nebraska,Mullen,391,20,99,118,48,20,305
Nebraska,Naponee,99,5,37,24,5,7,78
Nebraska,Cozad,3832,303,1000,926,348,151,2728
Nebraska,Farnam,250,10,84,50,13,17,174
Nebraska,Gothenburg,3482,197,645,882,249,179,2152
Nebraska,Sumner,244,9,67,44,19,9,148
Nebraska,Thurston,129,12,48,27,6,0,93
Nebraska,Nemaha,118,21,29,19,14,0,83
Nebraska,Overton,561,27,172,120,29,14,362
Nebraska,Big Springs,515,43,159,120,32,16,370
Nebraska,South Sioux City,12994,2254,2811,1844,610,288,7807
Nebraska,Hubbard,208,1,65,51,29,4,150
Nebraska,Schuyler,6301,1683,1012,532,193,132,3552
Nebraska,Cowles,13,3,2,4,1,0,10
Nebraska,Coleridge,554,25,124,176,30,14,369
Nebraska,Ohiowa,157,34,42,43,2,2,123
Nebraska,Winside,488,17,96,163,48,22,346
Nebraska,Mitchell,1827,214,347,477,147,59,1244
Nebraska,Burton,0,0,0,0,0,0,0
Nebraska,Walthill,796,67,112,168,29,18,394
Nebraska,Pender,1164,59,333,238,129,78,837
Nebraska,Macy,954,83,117,162,23,2,387
Nebraska,Hendley,12,1,7,4,0,0,12
Nebraska,Arapahoe,1206,56,301,292,69,29,747
Nebraska,Exeter,610,10,151,188,73,16,438
Nebraska,North Platte,24011,1344,4908,6626,2162,1123,16163
Nebraska,Lynch,232,22,84,58,16,4,184
Nebraska,Gilead,27,2,6,16,3,0,27
Nebraska,Bennet,1049,24,162,262,116,54,618
Nebraska,Dix,325,27,68,124,10,0,229
Nebraska,Stamford,154,9,16,46,3,8,82
Nebraska,Orleans,437,54,132,80,26,11,303
Nebraska,Alma,1378,52,271,474,190,57,1044
Nebraska,Sidney,6732,317,1326,1659,1026,333,4661
Nebraska,Ong,54,6,16,13,10,2,47
Nebraska,Huntley,25,0,11,8,0,0,19
Nebraska,Atlanta,90,1,52,14,8,0,75
Nebraska,Nelson,517,22,153,149,43,18,385
Nebraska,Verdon,199,27,61,48,3,0,139
Nebraska,Stella,203,17,63,31,35,15,161
Nebraska,McCook,7580,341,1546,2106,628,334,4955
Nebraska,Peru,898,20,79,100,55,45,299
Nebraska,Winnebago,746,58,107,144,29,11,349
Nebraska,Valley,2703,170,453,658,474,253,2008
Nebraska,Sutherland,1561,42,369,450,157,50,1068
Nebraska,Crawford,1116,72,266,261,98,52,749
Nebraska,Dodge,558,54,167,158,30,13,422
Nebraska,Hooper,789,18,228,231,76,33,586
Nebraska,Snyder,358,22,85,108,27,1,243
Nebraska,Arlington,1534,54,274,351,184,79,942
Nebraska,Bruning,287,8,72,95,20,20,215
Nebraska,Washington,92,5,20,25,12,3,65
Nebraska,Newman Grove,722,49,183,207,83,18,540
Nebraska,Stockville,10,2,5,3,0,0,10
Nebraska,Eustis,514,27,102,134,48,21,332
Nebraska,York,7859,362,1346,1723,1170,513,5114
Nebraska,Elba,346,28,102,64,28,5,227
Nebraska,Newport,87,3,26,31,5,0,65
Nebraska,Cotesfield,37,3,17,5,4,0,29
Nebraska,Oxford,723,107,170,161,67,20,525
Nebraska,Clay Center,794,8,171,238,52,29,498
Nebraska,Colon,101,6,16,26,30,2,80
Nebraska,Loup City,997,68,324,269,106,51,818
Nebraska,Hazard,58,0,19,18,16,0,53
Nebraska,Wausa,646,37,131,203,65,37,473
Nebraska,Phillips,317,7,104,112,5,0,228
Nebraska,Spalding,479,15,107,133,29,14,298
Nebraska,Stratton,410,22,122,98,35,25,302
Nebraska,Neligh,1548,54,354,453,115,85,1061
Nebraska,Bradshaw,321,19,80,64,33,16,212
Nebraska,Lodgepole,354,17,75,126,29,9,256
Nebraska,Malcolm,422,8,69,117,33,28,255
Nebraska,Davey,169,4,49,35,21,7,116
Nebraska,Beemer,628,72,205,159,48,17,501
Nebraska,Eagle,988,20,143,325,121,16,625
Nebraska,Alliance,8313,527,1698,2172,775,272,5444
Nebraska,Concord,122,13,36,24,15,10,98
Nebraska,Broken Bow,3522,234,639,927,243,175,2218
Nebraska,Anselmo,164,9,58,57,13,3,140
Nebraska,Gibbon,2072,320,372,416,169,47,1324
Nebraska,McCool Junction,405,11,83,117,24,15,250
Nebraska,Gresham,244,22,65,46,6,0,139
Nebraska,Dannebrog,336,19,85,98,19,24,245
Nebraska,Trenton,550,44,193,128,35,15,415
Nebraska,Potter,346,20,51,118,38,18,245
Nebraska,Howard City,178,15,66,48,10,4,143
Nebraska,Randolph,914,89,204,237,91,30,651
Nebraska,Gross,0,0,0,0,0,0,0
Nebraska,Panama,261,5,61,80,22,18,186
Nebraska,Doniphan,1020,22,221,224,108,28,603
Nebraska,Red Cloud,1118,84,310,235,101,53,783
Nebraska,Alda,758,114,185,141,22,9,471
Nebraska,Crofton,879,45,207,206,83,46,587
Nebraska,Sterling,493,12,138,118,65,14,347
Nebraska,Stockham,45,8,14,9,2,0,33
Nebraska,Hampton,460,12,113,138,48,17,328
Nebraska,Center,85,6,28,23,2,0,59
Nebraska,Chappell,911,84,204,246,81,36,651
Nebraska,Staplehurst,278,10,57,74,26,5,172
Nebraska,Tobias,123,0,50,27,11,0,88
Nebraska,North Loup,288,29,105,81,20,5,240
Nebraska,Beatrice,12307,1119,3152,2964,1183,389,8807
Nebraska,Wolbach,236,8,77,51,29,7,172
Nebraska,Bloomfield,974,71,296,265,101,40,773
Nebraska,Aurora,4481,140,929,1208,594,253,3124
Nebraska,Chadron,5654,121,585,1010,713,677,3106
Nebraska,Leigh,372,15,95,114,43,17,284
Nebraska,Minatare,988,143,199,185,54,13,594
Nebraska,McGrew,69,3,19,10,6,4,42
Nebraska,Cairo,980,51,161,252,94,32,590
Nebraska,Carleton,98,2,22,47,7,5,83
Nebraska,Norfolk,24446,1458,4816,5619,2588,1108,15589
Nebraska,Talmage,228,27,76,35,13,15,166
Nebraska,Lorton,27,4,11,3,1,0,19
Nebraska,Franklin,1041,62,249,309,78,42,740
Nebraska,Bloomington,137,11,47,24,5,2,89
Nebraska,Belden,117,5,28,41,11,1,86
Nebraska,Naper,104,8,59,15,12,1,95
Nebraska,Butte,330,12,96,118,26,1,253
Nebraska,Fort Calhoun,893,34,209,196,111,50,600
Nebraska,Blair,7684,302,1679,1705,1022,426,5134
Nebraska,Foster,68,1,5,19,6,6,37
Nebraska,Riverton,49,8,22,7,7,2,46
Nebraska,Bartlett,112,3,46,31,17,9,106
Nebraska,Tilden,1136,80,254,309,111,27,781
Nebraska,Madison,2301,425,423,421,121,29,1419
Nebraska,Bertrand,774,48,187,150,104,22,511
Nebraska,Shelton,1201,83,182,324,101,38,728
Nebraska,Ravenna,1512,94,411,291,165,42,1003
Nebraska,Thayer,64,2,8,19,8,0,37
Nebraska,Palisade,365,32,95,141,29,8,305
Nebraska,Republican City,145,4,46,47,22,2,121
Nebraska,Arcadia,316,13,81,61,45,14,214
Nebraska,Edgar,369,25,108,114,33,9,289
Nebraska,Halsey,67,1,16,20,7,0,44
Nebraska,Monroe,436,31,102,123,19,13,288
Nebraska,Burr,32,1,16,10,0,0,27
Nebraska,Daykin,221,19,43,37,25,10,134
Nebraska,Manley,133,5,70,20,7,7,109
Nebraska,Greenwood,546,39,153,145,43,11,391
Nebraska,Chalco,11456,247,1714,2712,1887,762,7322
Nebraska,Tecumseh,1794,242,416,275,153,78,1164
Nebraska,Hordville,110,9,27,41,4,1,82
Nebraska,Chambers,316,12,97,69,23,14,215
Nebraska,Duncan,491,30,178,112,18,3,341
Nebraska,Blue Hill,1028,50,206,239,102,78,675
Nebraska,Morrill,830,41,173,247,92,35,588
Nebraska,Melbeta,128,5,22,43,2,0,72
Nebraska,Brule,398,36,118,112,22,13,301
Nebraska,Belvidere,38,4,18,8,0,0,30
Nebraska,Nora,8,0,2,4,0,0,6
Nebraska,Hardy,186,15,41,43,3,3,105
Nebraska,Falls City,4176,152,1055,1125,395,164,2891
Nebraska,Bassett,659,27,226,165,59,30,507
Nebraska,Sholes,33,1,19,0,4,2,26
Nebraska,Ogallala,4561,279,1011,1325,477,195,3287
Nebraska,Barneston,110,12,29,34,4,2,81
Nebraska,Stapleton,307,21,87,79,24,7,218
Nebraska,Emerson,915,68,198,227,48,37,578
Nebraska,Table Rock,335,20,123,51,28,5,227
Nebraska,Gering,8312,415,1592,2107,991,345,5450
Nebraska,Lisco,45,0,26,19,0,0,45
Nebraska,Terrytown,1160,219,278,210,52,11,770
Nebraska,Louisville,1199,51,227,250,176,35,739
Nebraska,Bridgeport,1700,140,346,428,184,67,1165
Nebraska,Belmar,86,0,27,42,8,9,86
Nebraska,Archer,42,0,10,13,13,0,36
Nebraska,Aten,24,0,4,15,0,0,19
Nebraska,Berea,16,5,0,11,0,0,16
Nebraska,Bow Valley,91,20,16,27,4,0,67
Nebraska,Brownlee,4,2,2,0,0,0,4
Nebraska,Champion,40,0,13,27,0,0,40
Nebraska,Ames,69,0,25,25,0,0,50
Nebraska,Enders,8,0,0,0,8,0,8
Nebraska,Hamlet,65,6,31,16,7,0,60
Nebraska,Clatonia,389,16,73,102,22,21,234
Nebraska,Superior,1929,154,563,378,157,142,1394
Nebraska,Benkelman,1015,58,155,290,94,42,639
Nebraska,Haigler,228,49,36,57,6,3,151
Nebraska,Firth,453,39,89,108,45,16,297
Nebraska,Rising City,359,30,109,80,27,8,254
Nebraska,Moorefield,15,0,4,8,2,0,14
Nebraska,Du Bois,95,13,44,28,2,1,88
Nebraska,Odell,328,14,86,82,31,6,219
Nebraska,Cushing,46,3,14,12,0,0,29
Nebraska,Farwell,124,4,39,45,5,0,93
Nebraska,Osceola,941,45,208,250,101,31,635
Nebraska,Waco,300,13,62,105,39,20,239
Nebraska,Kimball,2762,219,674,636,262,86,1877
Nebraska,Dunning,109,0,28,21,17,2,68
Nebraska,Dalton,313,5,71,84,34,14,208
Nebraska,Fontanelle,22,0,22,0,0,0,22
Nebraska,Glenwood,457,16,49,101,83,56,305
Nebraska,Holmesville,15,0,15,0,0,0,15
Nebraska,Sarben,105,0,55,0,0,8,63
Nebraska,Sunol,78,5,31,25,4,0,65
Nebraska,Tamora,75,0,14,21,0,0,35
Nebraska,Tryon,98,17,25,40,2,3,87
Nebraska,Venice,72,9,46,0,0,0,55
Nebraska,Walton,184,4,4,32,45,49,134
Nebraska,St. Libory,194,20,68,32,16,10,146
Nebraska,Wann,54,11,7,10,0,7,35
Nebraska,White Clay,0,0,0,0,0,0,0
Nebraska,Willow Island,7,0,0,7,0,0,7
Nebraska,Woodland Hills,170,0,40,31,51,11,133
Nebraska,Woodland Park,1653,78,356,410,163,41,1048
Nebraska,Yankee Hill,338,0,52,81,58,12,203
Nebraska,Seneca,53,7,24,9,4,0,44
Nebraska,Westerville,0,0,0,0,0,0,0
Nebraska,Roscoe,85,0,11,19,0,0,30
Nebraska,Richfield,159,0,0,55,0,20,75
Nebraska,Raeville,0,0,0,0,0,0,0
Nebraska,Inavale,65,10,15,29,0,11,65
Nebraska,Keystone,46,0,30,4,3,0,37
Nebraska,King Lake,132,14,14,104,0,0,132
Nebraska,Lakeview,358,0,101,73,75,25,274
Nebraska,La Platte,135,0,49,9,27,0,85
Nebraska,Lemoyne,92,21,49,22,0,0,92
Nebraska,Lindy,23,1,12,7,0,3,23
Nebraska,Lorenzo,20,0,0,13,0,0,13
Nebraska,Loretto,50,21,0,29,0,0,50
Nebraska,Martin,20,0,11,9,0,0,20
Nebraska,Max,130,0,18,36,5,15,74
Nebraska,Odessa,91,7,28,34,12,0,81
Nebraska,Overland,101,0,39,29,12,21,101
Nebraska,Parks,12,0,0,8,4,0,12
Nebraska,Poole,51,0,6,10,14,5,35
Nebraska,Ruskin,97,0,37,23,8,3,71
Nebraska,Inland,7,0,0,7,0,0,7
Nebraska,Gordon,1726,127,392,382,206,60,1167
Nebraska,Norman,39,2,14,12,1,0,29
Nebraska,McLean,22,0,5,10,2,3,20
Nebraska,Osmond,872,81,201,212,50,31,575
Nebraska,Pierce,1910,69,388,515,236,51,1259
Nebraska,Plainview,1350,67,367,284,147,47,912
Nebraska,Byron,95,4,23,36,4,3,70
Nebraska,Hebron,1694,102,424,439,184,89,1238
Nebraska,Hadar,231,5,56,89,16,11,177
Nebraska,Minden,2890,107,739,740,196,106,1888
Nebraska,Bennington,1839,59,297,458,300,105,1219
Nebraska,Ralston,7314,353,1451,1778,1289,391,5262
Nebraska,Brady,382,6,76,101,47,13,243
Nebraska,Maxwell,245,19,75,75,8,0,177
Nebraska,Wood River,1444,205,264,356,71,44,940
Nebraska,Springview,242,10,64,67,19,21,181
Nebraska,Lexington,10067,2378,1666,1352,485,130,6011
Nebraska,Burchard,46,4,23,7,2,2,38
Nebraska,Roseland,220,12,45,52,18,17,144
Nebraska,Prague,366,20,114,96,12,3,245
Nebraska,Paxton,525,39,100,143,63,25,370
Nebraska,Wauneta,713,75,139,224,37,18,493
Nebraska,Prosser,60,6,16,8,12,7,49
Nebraska,Kenesaw,1132,54,237,332,65,56,744
Nebraska,Memphis,86,2,28,27,4,0,61
Nebraska,Yutan,962,55,194,324,96,25,694
Nebraska,Valparaiso,660,29,180,156,54,27,446
Nebraska,Deweese,61,0,33,7,0,0,40
Nebraska,Leshara,101,12,31,32,3,1,79
Nebraska,Albion,1501,67,340,448,136,70,1061
Nebraska,Arnold,750,19,165,193,113,36,526
Nebraska,Newcastle,309,20,82,81,26,12,221
Nebraska,Marquette,254,18,93,54,5,1,171
Nebraska,Santee,393,30,60,85,9,6,190
Nebraska,Glenvil,306,25,73,98,12,7,215
Nebraska,Lewiston,66,0,12,14,8,0,34
Nebraska,Henry,81,6,24,28,3,2,63
Nebraska,Denton,245,5,49,92,6,19,171
Nebraska,Dwight,189,9,68,58,2,3,140
Nebraska,Garrison,51,5,14,7,2,2,30
Nebraska,Linwood,117,5,15,43,17,0,80
Nebraska,Palmer,538,57,155,127,50,0,389
Nebraska,Silver Creek,453,22,97,149,22,5,295
Nebraska,Cedar Rapids,471,18,106,135,58,24,341
Nebraska,Brainard,384,18,75,105,38,13,249
Nebraska,Oakland,1506,105,340,361,155,51,1012
Nebraska,Lamar,9,0,5,4,0,0,9
Nebraska,Ansley,470,29,109,135,53,13,339
Nebraska,Merna,364,25,118,84,13,17,257
Nebraska,Martinsburg,81,5,17,20,9,8,59
Nebraska,Ainsworth,1722,133,464,420,188,70,1275
Nebraska,Johnstown,64,0,26,19,6,0,51
Nebraska,Imperial,1857,169,268,543,226,97,1303
Nebraska,Bellwood,351,28,95,74,26,9,232
Nebraska,Abie,82,3,36,16,2,2,59
Nebraska,Lincoln,280849,11791,37560,56129,42740,24246,172466
Nebraska,Hickman,2146,18,296,444,320,160,1238
Nebraska,Sprague,110,2,50,19,9,6,86
Nebraska,Inman,111,14,39,26,3,4,86
Nebraska,Clarkson,669,69,152,230,37,32,520
Nebraska,Whitney,97,7,46,19,4,1,77
Nebraska,Waterbury,65,7,24,8,6,0,45
Nebraska,North Bend,1324,25,388,289,107,68,877
Nebraska,Omaha,465112,33994,67563,90824,71916,38932,303229
Nebraska,Hay Springs,602,40,174,169,79,29,491
Nebraska,Ulysses,237,26,69,60,26,6,187
Nebraska,Clarks,360,29,81,105,24,6,245
Nebraska,Merriman,143,12,44,32,13,0,101
Nebraska,Kearney,33273,1196,4496,6445,4911,2531,19579
Nebraska,Miller,184,17,50,48,7,0,122
Nebraska,Bushnell,184,33,55,60,2,7,157
Nebraska,Clinton,35,0,11,15,1,1,28
Nebraska,Cedar Creek,442,19,131,134,41,23,348
Nebraska,Stromsburg,1136,57,299,266,139,58,819
Nebraska,Diller,265,13,70,74,28,1,186
Nebraska,Stanton,1642,70,355,486,84,40,1035
Nebraska,Waterloo,931,37,211,259,84,16,607
Nebraska,Strang,28,1,6,5,7,0,19
Nebraska,Fairmont,656,51,190,141,73,21,476
Nebraska,Hayes Center,323,36,55,122,28,7,248
Nebraska,Guide Rock,209,10,52,67,12,1,142
Nebraska,Wood Lake,54,8,4,27,9,0,48
Nebraska,Elk Creek,121,12,37,22,9,0,80
Nebraska,Verdigre,557,49,145,139,77,22,432
Nebraska,Friend,1133,54,299,300,98,48,799
Nebraska,West Point,3327,458,694,516,387,115,2170
Nebraska,Bladen,181,9,50,40,19,2,120
Nebraska,Jackson,151,7,52,32,16,4,111
Nebraska,Burwell,1239,53,280,367,140,43,883
Nebraska,Pawnee City,1062,74,305,240,95,51,765
Nebraska,Endicott,151,5,64,24,8,2,103
Nebraska,Anoka,14,0,8,6,0,0,14
Nebraska,Creston,218,11,41,59,17,2,130
Nebraska,Lyman,388,44,91,64,20,4,223
Nebraska,Grafton,134,5,42,36,14,0,97
Nebraska,Surprise,81,8,15,46,1,0,70
Nebraska,Hyannis,199,6,68,58,24,19,175
Nebraska,Hershey,555,39,150,166,48,4,407
Nebraska,Stuart,725,35,120,201,66,30,452
Nebraska,Lushton,22,0,1,18,3,0,22
Nebraska,Steinauer,65,3,25,21,3,0,52
Nebraska,Grand Island,51187,5454,9841,10648,4695,1881,32519
Nebraska,Julian,53,9,24,4,4,3,44
Nebraska,Ericson,169,13,30,59,16,4,122
Nebraska,Trumbull,264,17,47,78,4,3,149
Nebraska,Litchfield,293,31,65,108,14,9,227
Nebraska,Wahoo,4487,330,932,1104,491,184,3041
Nebraska,Meadow Grove,306,28,65,91,39,9,232
Nebraska,Barada,12,0,9,2,1,0,12
Nebraska,Scottsbluff,14805,1431,2616,3215,1463,731,9456
Nebraska,Magnet,52,6,38,4,0,0,48
Nebraska,Morse Bluff,130,11,29,40,2,9,91
Nebraska,Dakota City,1919,268,470,301,104,57,1200
Nebraska,Murdock,189,7,64,52,27,10,160
Nebraska,Blue Springs,259,36,98,41,19,0,194
Nebraska,Nickerson,317,34,98,47,15,4,198
Nebraska,St. Paul,2451,133,572,555,270,106,1636
Nebraska,Sutton,1606,133,327,399,155,67,1081
Nebraska,Greeley Center,380,18,108,113,41,20,300
Nebraska,Weston,255,9,107,68,6,4,194
Nebraska,Ashland,2447,174,578,537,243,149,1681
Nebraska,Rockville,141,7,32,41,9,0,89
Nebraska,Creighton,1194,61,275,302,153,78,869
Nebraska,Crab Orchard,58,16,16,13,2,0,47
Nebraska,Uehling,255,23,81,50,22,8,184
Nebraska,Scribner,847,53,222,217,87,30,609
Nebraska,Ceresco,1054,36,191,313,95,48,683
Nebraska,Scotia,313,37,61,71,26,16,211
Nebraska,Alexandria,153,11,56,35,16,4,122
Nebraska,Smithfield,40,6,12,14,0,1,33
Nebraska,Inglewood,420,36,103,91,22,3,255
Nebraska,Roca,209,4,38,71,10,3,126
Nebraska,Elsie,117,5,35,27,9,10,86
Nebraska,Western,293,18,116,60,14,3,211
Nebraska,Wisner,1258,102,338,235,113,29,817
Nebraska,Shelby,748,75,153,151,51,46,476
Nebraska,Virginia,64,5,27,9,0,1,42
Nebraska,Offutt AFB,5074,71,358,1216,515,159,2319
Nebraska,Cordova,103,7,34,23,1,1,66
Nebraska,David City,2831,151,815,638,290,117,2011
Nebraska,Tekamah,1824,114,480,432,164,65,1255
Nebraska,Dorchester,679,54,224,163,43,4,488
Nebraska,Bancroft,481,17,122,139,38,30,346
Nebraska,Fordyce,131,13,34,32,4,1,84
Nebraska,Otoe,250,4,76,57,24,1,162
Nebraska,Oak,42,2,20,7,2,0,31
Nebraska,Shickley,257,10,63,71,37,20,201
Nebraska,Swanton,67,4,20,19,5,3,51
Nebraska,O'Neill,3631,252,877,872,380,194,2575
Nebraska,Pilger,333,19,103,105,12,14,253
Nebraska,Hoskins,255,19,68,94,22,2,205
Nebraska,Wakefield,1533,212,360,201,150,65,988
Nebraska,Milligan,305,14,82,92,24,3,215
Nebraska,Emmet,41,5,16,6,3,4,34
Nebraska,Ewing,454,16,107,134,21,4,282
Nebraska,Wellfleet,54,6,5,15,8,1,35
Nebraska,Elm Creek,1160,41,241,317,100,44,743
Nebraska,Riverdale,281,8,31,78,42,10,169
Nebraska,Eddyville,95,17,37,12,6,1,73
Nebraska,Auburn,3322,149,733,751,490,191,2314
Nebraska,Brownville,99,10,28,31,12,8,89
Nebraska,Arthur,118,10,26,27,8,6,77
Nebraska,Carroll,209,16,62,52,20,3,153
Nebraska,Pleasanton,338,10,59,94,36,12,211
Nebraska,Ayr,85,4,16,11,16,2,49
Nebraska,Hubbell,80,3,24,28,0,0,55
Nebraska,Davenport,358,26,93,65,30,10,224
Nebraska,Harbine,76,0,30,19,3,2,54
Nebraska,Plymouth,436,24,126,122,47,8,327
Nebraska,Steele City,68,4,18,21,2,2,47
Nebraska,Bellevue,53225,2884,8883,12307,6678,3464,34216
Nebraska,Atkinson,1418,58,324,343,195,32,952
Nebraska,Madrid,198,37,41,51,7,8,144
Nebraska,Obert,20,3,9,5,0,0,17
Nebraska,Wynot,198,13,69,43,12,3,140
Nebraska,Campbell,332,37,123,100,14,4,278
Nebraska,Valentine,2777,201,675,615,288,163,1942
Nebraska,Humphrey,960,49,212,253,75,27,616
Nebraska,Platte Center,398,16,115,92,25,4,252
Nebraska,Shubert,186,19,64,44,12,4,143
Nebraska,Holdrege,5476,207,1252,1335,639,358,3791
Nebraska,Chester,268,17,72,73,24,10,196
Nebraska,Wayne,5558,146,569,739,695,466,2615
Nebraska,Beaver City,495,51,111,130,73,5,370
Nebraska,St. Helena,70,2,32,9,6,2,51
Nebraska,Harvard,1176,111,296,219,98,27,751
Nebraska,Brock,116,7,33,46,9,0,95
Nebraska,Broadwater,154,18,76,18,3,1,116
Nebraska,Wilsonville,59,6,24,19,3,0,52
Nebraska,Cambridge,1281,98,276,324,219,39,956
Nebraska,Malmo,285,21,50,56,6,6,139
Nebraska,Danbury,76,7,14,37,6,1,65
Nebraska,Bartley,342,30,83,91,21,16,241
Nebraska,Cornlea,22,0,16,2,0,0,18
Nebraska,Laurel,1047,35,194,249,127,56,661
Nebraska,Hartington,1611,70,436,397,130,79,1112
Nebraska,Monowi,0,0,0,0,0,0,0
Nebraska,Nenzel,31,0,10,19,0,2,31
Nebraska,Dawson,166,12,58,36,9,1,116
Nebraska,Indianola,603,60,182,143,42,6,433
Nebraska,Tarnov,38,0,5,13,0,0,18
Nebraska,Johnson,320,12,81,80,35,11,219
Nebraska,Thedford,179,15,30,49,43,5,142
Nebraska,Bayard,1013,122,247,312,66,9,756
Nebraska,Rosalie,185,14,41,40,5,7,107
Nebraska,Harrisburg,66,2,32,14,3,2,53
Nebraska,Holbrook,259,26,81,62,10,9,188
Nebraska,Edison,204,33,49,37,2,4,125
Nebraska,Oshkosh,858,51,200,221,139,21,632
Nebraska,Boys Town,900,0,2,12,0,2,16
Nebraska,Wallace,262,19,46,83,36,11,195
Nebraska,Lewellen,198,13,56,71,9,9,158
Nebraska,Elgin,723,51,144,216,71,38,520
Nebraska,Oakdale,353,39,120,90,17,1,267
Nebraska,Orchard,494,41,109,99,43,13,305
Nebraska,Royal,105,11,31,25,7,0,74
Nebraska,Columbus,22992,1860,4363,5418,2397,1006,15044
Nebraska,Clearwater,366,30,55,125,21,2,233
Nevada,Oasis,34,0,18,16,0,0,34
Nevada,Mina,105,0,51,21,0,0,72
Nevada,Orovada,49,0,21,28,0,0,49
Nevada,Osino,661,0,218,215,0,0,433
Nevada,Nelson,42,0,20,10,0,0,30
Nevada,Mount Wilson,0,0,0,0,0,0,0
Nevada,Montello,50,0,0,40,10,0,50
Nevada,Mogul,2005,26,171,605,505,221,1528
Nevada,Logan Creek,53,0,24,20,0,9,53
Nevada,Kingston,104,0,60,44,0,0,104
Nevada,Lamoille,241,0,36,29,0,120,185
Nevada,Lund,91,11,29,27,0,0,67
Nevada,Lakeridge,281,0,31,57,141,52,281
Nevada,Jackpot,1551,531,126,208,28,36,929
Nevada,Incline Village,8491,412,732,1747,2332,1432,6655
Nevada,Imlay,129,0,61,16,0,0,77
Nevada,Humboldt River Ranch,203,0,0,94,41,68,203
Nevada,Hiko,76,0,11,65,0,0,76
Nevada,Grass Valley,719,45,126,290,0,123,584
Nevada,Goldfield,359,24,100,101,28,12,265
Nevada,Panaca,947,52,256,178,78,55,619
Nevada,Golconda,112,0,63,33,16,0,112
Nevada,Glenbrook,209,6,20,21,72,39,158
Nevada,Gerlach,107,0,27,0,49,31,107
Nevada,Lemmon Valley,5469,497,1638,1244,351,199,3929
Nevada,Golden Valley,1393,73,279,540,124,35,1051
Nevada,Valmy,108,0,28,29,19,0,76
Nevada,Pioche,1189,267,293,275,103,37,975
Nevada,Summerlin South,27506,845,3418,6423,5525,4605,20816
Nevada,Whitney,43072,4600,8362,10503,3784,1535,28784
Nevada,Genoa,645,21,49,184,156,107,517
Nevada,Spring Valley,199722,17099,42168,49013,24363,9697,142340
Nevada,Indian Springs,831,68,178,200,63,15,524
Nevada,Winnemucca,7798,788,1698,1440,485,409,4820
Nevada,Indian Hills,6054,452,1058,1810,713,422,4455
Nevada,Caliente,1135,57,223,308,50,102,740
Nevada,Hawthorne,2613,303,762,695,262,120,2142
Nevada,Owyhee,1177,111,221,291,71,49,743
Nevada,Tonopah,2211,188,812,573,108,35,1716
Nevada,Unionville,0,0,0,0,0,0,0
Nevada,Silver City,131,0,15,45,12,33,105
Nevada,Walker Lake,413,11,71,198,48,5,333
Nevada,Zephyr Cove,461,13,27,87,111,211,449
Nevada,Washoe Valley,2651,130,613,1010,409,192,2354
Nevada,Virginia City,800,8,160,179,231,48,626
Nevada,Verdi,1368,89,213,431,202,168,1103
Nevada,Ursine,26,0,19,7,0,0,26
Nevada,Topaz Ranch Estates,1545,107,497,532,92,48,1276
Nevada,Topaz Lake,198,18,61,90,18,9,196
Nevada,Stagecoach,1961,253,390,610,113,55,1421
Nevada,Skyland,204,0,23,68,31,60,182
Nevada,Silver Peak,115,5,50,54,6,0,115
Nevada,Ruth,142,0,21,106,0,15,142
Nevada,Ruhenstroth,1280,25,194,580,169,57,1025
Nevada,Round Hill Village,777,36,114,199,148,163,660
Nevada,Rachel,96,0,0,32,64,0,96
Nevada,Preston,17,0,0,17,0,0,17
Nevada,Paradise Valley,51,0,21,29,0,0,50
Nevada,Gabbs,155,10,98,47,0,0,155
Nevada,Cold Springs,9168,499,1810,2874,789,199,6171
Nevada,Fish Springs,629,19,113,150,99,50,431
Nevada,Laughlin,7502,900,2517,2417,578,293,6705
Nevada,Mesquite,17904,1746,3829,5146,2060,1266,14047
Nevada,Carlin,2023,99,644,619,47,23,1432
Nevada,Spring Creek,13805,315,2722,3729,1344,629,8739
Nevada,Wells,1150,117,212,393,64,7,793
Nevada,Pahrump,36174,3939,10330,10960,2423,857,28509
Nevada,Spanish Springs,16241,604,3039,4657,1719,1011,11030
Nevada,Blue Diamond,339,15,109,35,49,51,259
Nevada,Nellis AFB,3342,80,202,833,202,146,1463
Nevada,McGill,1180,83,302,212,131,21,749
Nevada,Wadsworth,768,49,239,225,5,10,528
Nevada,West Wendover,4320,963,940,457,52,141,2553
Nevada,Winchester,28331,4969,6518,4786,2327,1696,20296
Nevada,Sutcliffe,196,29,60,51,15,0,155
Nevada,Moapa Valley,6843,379,1335,1980,387,330,4411
Nevada,Ely,4063,384,997,941,308,151,2781
Nevada,Cal-Nev-Ari,119,14,56,37,0,12,119
Nevada,Sun Valley,20683,3684,4059,4229,782,367,13121
Nevada,Reno,242633,19899,36846,53553,33305,20748,164351
Nevada,Schurz,1075,107,259,227,33,0,626
Nevada,Smith Valley,1463,64,199,663,193,119,1238
Nevada,Sunrise Manor,192934,32496,40092,33889,9265,3321,119063
Nevada,Elko,20247,2116,3353,4712,1722,946,12849
Nevada,Las Vegas,626637,66178,117872,138413,66441,35040,423944
Nevada,Fallon Station,628,0,74,166,38,0,278
Nevada,Silver Springs,4514,478,1240,1562,314,95,3689
Nevada,Nixon,280,22,106,52,24,3,207
Nevada,Henderson,291346,13570,54720,73009,41904,26202,209405
Nevada,Fort McDermitt,336,58,102,45,7,6,218
Nevada,Goodsprings,110,110,0,0,0,0,110
Nevada,Gardnerville,6148,338,1379,1668,643,392,4420
Nevada,Eureka,480,20,183,156,72,0,431
Nevada,Empire,145,0,16,54,0,0,70
Nevada,East Valley,1487,58,221,409,332,203,1223
Nevada,Dyer,290,40,92,45,44,11,232
Nevada,Dry Valley,30,0,30,0,0,0,30
Nevada,Double Spring,262,1,91,82,13,16,203
Nevada,Denio,15,0,0,15,0,0,15
Nevada,Crystal Bay,129,0,0,8,38,83,129
Nevada,Crescent Valley,442,56,121,166,12,0,355
Nevada,Carter Springs,516,47,104,179,40,17,387
Nevada,Bennett Springs,160,12,54,94,0,0,160
Nevada,Beaverdam,29,0,13,16,0,0,29
Nevada,Baker,64,9,0,23,8,0,40
Nevada,Austin,161,86,22,34,0,0,142
Nevada,Alamo,1199,123,220,281,99,68,791
Nevada,Fernley,19573,1497,4965,5273,1322,435,13492
Nevada,Enterprise,164314,7366,27319,40655,24810,10076,110226
Nevada,Sandy Valley,1831,285,542,351,125,15,1318
Nevada,Gardnerville Ranchos,11274,518,2564,3577,1076,256,7991
Nevada,Moapa Town,731,80,201,133,59,0,473
Nevada,Searchlight,268,25,138,54,25,5,247
Nevada,Johnson Lane,6065,174,788,2225,1050,653,4890
Nevada,North Las Vegas,236986,27997,44583,48270,16837,7651,145338
Nevada,Sparks,98524,8790,18496,24411,10761,4948,67406
Nevada,Bunkerville,1122,85,388,194,40,23,730
Nevada,Mount Charleston,401,6,119,103,117,8,353
Nevada,Beatty,881,177,166,219,47,26,635
Nevada,Boulder City,15680,677,3512,4154,2085,1549,11977
Nevada,Minden,3239,132,492,1010,522,376,2532
Nevada,Paradise,233689,25658,49026,53111,24722,10901,163418
Nevada,Lovelock,1806,226,572,290,77,81,1246
Nevada,Battle Mountain,3317,257,786,807,119,177,2146
Nevada,Dayton,9508,779,2191,2985,532,330,6817
Nevada,Yerington,3103,512,591,686,158,128,2075
Nevada,Fallon,8330,448,1842,2281,649,279,5499
Nevada,Kingsbury,2122,25,279,656,474,398,1832
Nevada,Stateline,969,103,170,290,96,32,691
Nevada,McDermitt,213,21,91,31,0,0,143
Nevada,Carson,54467,4939,10705,14594,5513,3141,38892
New Hampshire,East Merrimack,4148,94,770,888,804,358,2914
New Hampshire,Somersworth,11883,643,3183,2520,1690,514,8550
New Hampshire,South Hooksett,5811,250,828,1036,716,531,3361
New Hampshire,Manchester,111657,9978,23447,21796,14906,7366,77493
New Hampshire,Goffstown,3000,147,457,871,543,249,2267
New Hampshire,Wilton,886,51,436,121,141,27,776
New Hampshire,Keene,23165,981,3407,4006,3380,2697,14471
New Hampshire,Berlin,10382,1070,3633,2264,762,216,7945
New Hampshire,Derry,22381,948,5312,5429,2911,939,15539
New Hampshire,Durham,11101,22,108,324,624,928,2006
New Hampshire,Alton,168,0,16,0,102,0,118
New Hampshire,Bennington,351,13,56,81,83,26,259
New Hampshire,Ashland,1353,39,314,307,136,106,902
New Hampshire,Bartlett,104,10,73,9,1,2,95
New Hampshire,Belmont,1814,363,383,440,90,80,1356
New Hampshire,Greenville,983,46,170,277,158,52,703
New Hampshire,Bethlehem,923,43,134,301,169,69,716
New Hampshire,Blodgett Landing,105,0,11,11,22,22,66
New Hampshire,Bradford,340,24,94,64,40,24,246
New Hampshire,Canaan,299,14,66,62,57,23,222
New Hampshire,Center Ossipee,368,30,219,43,4,18,314
New Hampshire,Amherst,709,8,0,118,96,231,453
New Hampshire,Dover,31316,1465,4764,5690,6300,3972,22191
New Hampshire,Meredith,1632,41,239,288,234,121,923
New Hampshire,Enfield,1666,62,456,421,192,97,1228
New Hampshire,Littleton,4604,272,1030,1349,536,296,3483
New Hampshire,Jaffrey,2614,161,756,599,189,199,1904
New Hampshire,Conway,3838,250,1154,838,347,167,2756
New Hampshire,Wolfeboro,2870,192,596,703,482,441,2414
New Hampshire,Exeter,9070,490,1764,1879,1501,1370,7004
New Hampshire,West Swanzey,1150,65,323,91,154,118,751
New Hampshire,Winchester,2199,261,664,399,92,0,1416
New Hampshire,Rochester,30661,2339,7867,7098,3461,1116,21881
New Hampshire,Hillsborough,1735,125,594,389,84,112,1304
New Hampshire,Pittsfield,1586,109,408,299,173,35,1024
New Hampshire,Antrim,1232,82,266,360,129,62,899
New Hampshire,Hinsdale,1524,150,383,318,116,32,999
New Hampshire,Marlborough,1112,62,323,202,185,42,814
New Hampshire,Hanover,8591,158,178,310,1157,1928,3731
New Hampshire,Plymouth,3163,78,263,254,192,375,1162
New Hampshire,Laconia,16342,1266,3507,3855,2162,1322,12112
New Hampshire,Suncook,5111,277,1352,1347,512,244,3732
New Hampshire,Gorham,1460,71,363,409,235,131,1209
New Hampshire,Center Sandwich,129,0,6,29,24,24,83
New Hampshire,Newport,5019,391,1443,1081,363,209,3487
New Hampshire,Bristol,1916,127,427,390,223,48,1215
New Hampshire,North Conway,2284,25,302,523,611,256,1717
New Hampshire,Colebrook,1064,155,278,242,78,49,802
New Hampshire,Farmington,4451,314,1086,964,295,68,2727
New Hampshire,Lisbon,850,64,212,168,98,30,572
New Hampshire,Franklin,8586,513,2588,2014,879,246,6240
New Hampshire,Charlestown,1029,18,420,211,82,15,746
New Hampshire,Nashua,88606,6043,16543,18154,14229,8529,63498
New Hampshire,Henniker,1798,39,145,282,192,173,831
New Hampshire,Newmarket,5536,202,763,988,1297,584,3834
New Hampshire,Hampton,9235,149,1201,1997,1998,1699,7044
New Hampshire,Claremont,13016,1133,4034,2427,1350,488,9432
New Hampshire,Suissevale,316,49,139,37,29,6,260
New Hampshire,Groveton,1204,125,392,245,59,8,829
New Hampshire,Milford,9168,622,2085,2035,1447,686,6875
New Hampshire,Pinardville,5390,511,1368,1294,475,231,3879
New Hampshire,Contoocook,1702,24,264,309,144,449,1190
New Hampshire,Concord,43040,2451,7506,9379,6526,5011,30873
New Hampshire,Portsmouth,21778,789,2849,3616,5516,3861,16631
New Hampshire,North Haverhill,1043,175,243,268,121,116,923
New Hampshire,West Stewartstown,329,26,159,48,17,0,250
New Hampshire,Warner,517,0,114,134,30,53,331
New Hampshire,Londonderry,11465,389,1911,2645,1869,1082,7896
New Hampshire,Walpole,519,24,64,87,211,80,466
New Hampshire,Union,216,52,72,16,15,0,155
New Hampshire,Hudson,7591,403,1671,1905,1018,366,5363
New Hampshire,Peterborough,2846,98,364,538,680,715,2395
New Hampshire,Lancaster,1814,61,501,436,174,129,1301
New Hampshire,Whitefield,1010,133,291,213,124,6,767
New Hampshire,Hampton Beach,2603,114,531,575,474,372,2066
New Hampshire,Hancock,242,0,21,66,58,70,215
New Hampshire,Lincoln,865,27,246,217,88,31,609
New Hampshire,Loudon,769,32,418,161,77,12,700
New Hampshire,Melvin Village,215,0,30,75,39,50,194
New Hampshire,Milton,530,34,181,166,25,21,427
New Hampshire,Milton Mills,301,47,50,59,40,0,196
New Hampshire,Mountain Lakes,522,41,129,144,85,58,457
New Hampshire,Newfields,327,16,54,76,59,37,242
New Hampshire,New Hampton,324,12,33,46,55,32,178
New Hampshire,New London,1400,17,51,137,72,103,380
New Hampshire,North Walpole,680,25,89,204,122,77,517
New Hampshire,North Woodstock,350,25,114,61,54,24,278
New Hampshire,Plainfield,219,9,65,33,46,27,180
New Hampshire,Sanbornville,581,49,203,224,16,15,507
New Hampshire,Seabrook Beach,841,0,230,173,244,90,737
New Hampshire,Hooksett,5082,124,1024,1182,954,505,3789
New Hampshire,Woodsville,903,94,336,106,72,19,627
New Hampshire,Lebanon,13619,586,2153,1900,2329,3159,10127
New Hampshire,Raymond,2994,106,693,677,414,185,2075
New Hampshire,Epping,1907,219,439,439,186,162,1445
New Hampshire,Troy,990,41,356,159,142,72,770
New Hampshire,Tilton Northfield,3156,266,950,770,267,139,2392
New Jersey,Brookdale,9539,250,1451,1453,2091,1441,6686
New Jersey,East Franklin,7170,642,1584,1072,626,418,4342
New Jersey,Westwood borough,11145,558,1762,1563,2580,1469,7932
New Jersey,Tenafly borough,14687,267,648,729,3097,4144,8885
New Jersey,Ramsey borough,14963,211,1267,1649,4537,2642,10306
New Jersey,Mountainside borough,6820,201,1044,1032,1481,1169,4927
New Jersey,Andover borough,594,36,144,116,103,23,422
New Jersey,Tinton Falls borough,17731,679,2251,3824,3792,2790,13336
New Jersey,Oakhurst,3451,180,606,666,602,444,2498
New Jersey,Long Branch,30611,3538,6407,4860,3637,2393,20835
New Jersey,Keansburg borough,9788,1263,2538,1773,948,274,6796
New Jersey,Buttzville,102,0,0,102,0,0,102
New Jersey,Byram Center,28,0,9,10,0,0,19
New Jersey,Clyde,243,8,87,46,31,30,202
New Jersey,Columbia,261,16,62,68,64,16,226
New Jersey,Delaware,149,5,68,48,11,0,132
New Jersey,Delaware Park,413,0,90,70,79,92,331
New Jersey,Pr,30728,691,1336,1542,4442,10378,18389
New Jersey,Highland Lakes,4840,143,1110,1051,906,358,3568
New Jersey,Whitesboro,2528,182,532,256,203,60,1233
New Jersey,Leisure Village West,3260,297,1305,823,638,124,3187
New Jersey,Mercerville,12574,795,2536,2750,1936,912,8929
New Jersey,Martinsville,11541,219,1110,1598,2626,2412,7965
New Jersey,Marksboro,146,4,17,21,15,0,57
New Jersey,Lopatcong Overlook,761,19,97,162,186,79,543
New Jersey,Kingston Estates,6346,301,934,790,1455,910,4390
New Jersey,Kenvil,3179,255,722,695,374,223,2269
New Jersey,Juliustown,344,28,67,76,47,8,226
New Jersey,Johnsonburg,58,0,0,6,3,17,26
New Jersey,Hutchinson,116,5,27,27,16,8,83
New Jersey,Hope,144,25,29,31,27,11,123
New Jersey,Harmony,457,32,178,78,41,15,344
New Jersey,Harlingen,230,0,18,17,38,77,150
New Jersey,Hancocks Bridge,248,5,50,90,16,1,162
New Jersey,Hamilton Square,12542,560,2255,2421,2361,1298,8895
New Jersey,Middlebush,2738,174,593,458,395,341,1961
New Jersey,Hainesburg,42,0,14,25,0,0,39
New Jersey,Griggstown,747,68,136,50,181,143,578
New Jersey,Greenwich,2538,51,189,446,465,361,1512
New Jersey,Green Knoll,6720,309,873,935,1411,1255,4783
New Jersey,Great Meadows,42,1,18,16,0,4,39
New Jersey,Cape May Court House,4787,400,1115,1094,866,291,3766
New Jersey,Millville,27950,3118,7426,5397,1954,1060,18955
New Jersey,Franklin Park,14612,578,1642,2368,3403,2726,10717
New Jersey,Franklin Center,4615,98,955,686,1246,1048,4033
New Jersey,Finderne,5976,198,1317,1148,1118,429,4210
New Jersey,Elwood,1217,135,261,218,124,56,794
New Jersey,Ellisburg,4048,394,641,684,996,416,3131
New Jersey,Finesville,240,0,53,56,17,24,150
New Jersey,East Rocky Hill,343,0,65,109,92,50,316
New Jersey,East Millstone,513,37,45,101,92,119,394
New Jersey,Groveville,2234,134,443,446,277,180,1480
New Jersey,Mountain Lake,510,20,141,102,53,60,376
New Jersey,Mount Hermon,116,6,18,27,20,3,74
New Jersey,New Village,421,35,96,122,19,5,277
New Jersey,Florence,4423,358,1063,1096,412,220,3149
New Jersey,Yardville,7148,341,1779,1646,1056,538,5360
New Jersey,Weston,2725,107,570,424,751,601,2453
New Jersey,Voorhees,1692,129,220,291,216,198,1054
New Jersey,Vienna,1296,66,257,291,97,89,800
New Jersey,Vernon Center,1538,67,269,481,242,90,1149
New Jersey,Upper Pohatcong,1568,84,429,381,227,44,1165
New Jersey,Upper Montclair,11744,172,347,747,2874,3446,7586
New Jersey,Ten Mile Run,1518,0,31,79,408,503,1021
New Jersey,Upper Stewartsville,148,27,41,23,8,22,121
New Jersey,Succasunna,8681,215,1246,1775,2076,1020,6332
New Jersey,Stewartsville,514,16,112,122,56,0,306
New Jersey,Smithville,7835,322,1566,2121,1139,763,5911
New Jersey,Skillman,359,0,34,64,84,61,243
New Jersey,Six Mile Run,2663,182,109,189,686,499,1665
New Jersey,Singac,4447,339,1256,564,827,382,3368
New Jersey,Silver Lake CDP (Warren County),300,3,88,68,60,9,228
New Jersey,Panther Valley,3623,57,678,613,969,542,2859
New Jersey,Pedricktown,362,29,90,103,33,0,255
New Jersey,Pine Lake Park,8811,399,2570,1470,995,343,5777
New Jersey,Pleasant Plains,379,15,0,33,65,112,225
New Jersey,Port Colden,132,16,32,84,0,0,132
New Jersey,Port Murray,33,16,17,0,0,0,33
New Jersey,West New York,52477,9570,10430,6640,7313,3647,37600
New Jersey,Quinton,617,42,207,112,69,19,449
New Jersey,Robbinsville,2720,65,279,283,819,536,1982
New Jersey,Robertsville,11840,320,1365,1580,2530,1977,7772
New Jersey,Roebling,3817,106,866,926,569,142,2609
New Jersey,Ross Corner,62,0,0,0,62,0,62
New Jersey,Short Hills,13134,203,265,399,2799,4512,8178
New Jersey,Silver Lake CDP (Essex County),3998,446,941,800,337,194,2718
New Jersey,Richwood,3427,68,308,579,613,617,2185
New Jersey,Clearbrook Park,2810,332,1227,527,483,241,2810
New Jersey,Guttenberg,11436,1661,2410,1582,1708,1067,8428
New Jersey,River Edge borough,11530,494,1153,1476,2787,1873,7783
New Jersey,East Orange,64400,5745,15943,13273,5407,2468,42836
New Jersey,McGuire AFB,5246,50,283,1211,572,299,2415
New Jersey,Roseland borough,5849,147,676,713,1598,1229,4363
New Jersey,Seabrook Farms,1996,217,348,536,155,17,1273
New Jersey,Kenilworth borough,8160,638,1799,1637,1241,395,5710
New Jersey,Plainfield,50508,8493,11071,7390,3660,2153,32767
New Jersey,Elizabeth,128153,21319,31167,18419,7576,3188,81669
New Jersey,Totowa borough,10828,678,2705,1928,1932,702,7945
New Jersey,Prospect Park borough,5861,617,1360,908,471,168,3524
New Jersey,West Wildwood borough,376,41,156,78,28,25,328
New Jersey,Rio Grande,3078,369,828,609,156,60,2022
New Jersey,Ocean Acres,16803,567,3970,3371,2447,961,11316
New Jersey,Erma,1953,82,600,504,190,94,1470
New Jersey,Cape May Point borough,188,2,26,24,63,66,181
New Jersey,Pomona,7362,855,1249,1819,977,419,5319
New Jersey,Woodstown borough,3473,133,592,619,614,360,2318
New Jersey,North Cape May,3060,192,917,641,301,172,2223
New Jersey,Wharton borough,6521,619,1407,1195,676,518,4415
New Jersey,Long Valley,1773,29,233,371,328,192,1153
New Jersey,Butler borough,7701,237,1935,1341,1400,634,5547
New Jersey,Budd Lake,10414,516,1759,1555,2038,812,6680
New Jersey,Moorestown-Lenola,13800,262,1593,2130,3178,2331,9494
New Jersey,Salem,4811,642,1340,789,167,55,2993
New Jersey,West Cape May borough,1103,69,181,187,225,144,806
New Jersey,Ocean City,11202,385,2070,1934,2681,1537,8607
New Jersey,Rockaway borough,6404,331,1226,1283,1153,396,4389
New Jersey,North Caldwell borough,6621,166,418,650,1849,1498,4581
New Jersey,Essex Fells borough,2205,22,127,134,618,606,1507
New Jersey,Rahway,29370,2426,7153,5363,4050,1882,20874
New Jersey,Sussex borough,1854,197,599,313,145,40,1294
New Jersey,Wildwood,5073,521,1571,925,406,251,3674
New Jersey,Phillipsburg,14415,1666,3673,2657,1258,519,9773
New Jersey,Society Hill,3671,128,314,414,772,678,2306
New Jersey,Dover,18091,2644,4167,3542,1519,564,12436
New Jersey,Broadway,235,102,41,63,9,0,215
New Jersey,Bridgeville,57,0,27,0,30,0,57
New Jersey,Brainards,194,9,42,51,15,5,122
New Jersey,Bradley Gardens,14417,503,1593,1853,2856,3008,9813
New Jersey,Blawenburg,185,0,0,25,77,31,133
New Jersey,Blairstown,370,94,146,58,33,0,331
New Jersey,Blackwells Mills,842,4,5,27,270,189,495
New Jersey,Belleplain,468,60,176,76,37,10,359
New Jersey,Belle Mead,195,0,9,62,37,10,118
New Jersey,Beattystown,4451,270,1063,804,655,302,3094
New Jersey,Barclay,4330,93,406,480,1184,874,3037
New Jersey,Asbury,221,31,79,23,58,3,194
New Jersey,Anderson,402,15,92,63,107,0,277
New Jersey,Allamuchy,56,0,7,7,7,0,21
New Jersey,Zarephath,23,0,7,8,8,0,23
New Jersey,Woodland Park borough,12489,961,2922,1458,2082,1046,8469
New Jersey,Lake Como borough,1671,97,237,286,426,185,1231
New Jersey,Browns Mills,10719,510,2819,2644,681,245,6899
New Jersey,Audubon borough,8660,213,1993,1830,1576,674,6286
New Jersey,Swedesboro borough,2585,204,530,519,311,160,1724
New Jersey,Woodbury,9929,695,2187,1848,1329,593,6652
New Jersey,Ashland,8292,201,1320,1390,1880,1216,6007
New Jersey,Audubon Park borough,912,52,408,203,107,7,777
New Jersey,Newton,7895,616,2005,1809,935,474,5839
New Jersey,Blackwood,4702,284,1351,1052,463,190,3340
New Jersey,Hamburg borough,3152,128,635,865,489,175,2292
New Jersey,Hopatcong borough,14362,501,3799,3294,2085,926,10605
New Jersey,Newark,280463,45284,64213,44281,18764,7857,180399
New Jersey,Country Lake Estates,4166,369,997,923,237,41,2567
New Jersey,Fieldsboro borough,906,47,144,191,77,117,576
New Jersey,Caldwell borough,7971,308,1221,1048,2094,1043,5714
New Jersey,Westfield,30086,470,2222,2491,7530,6778,19491
New Jersey,Brookfield,808,55,273,310,146,24,808
New Jersey,Lake Mohawk,9208,204,1259,1545,2368,1109,6485
New Jersey,Yorketown,6565,139,957,1107,1441,722,4366
New Jersey,Woodbury Heights borough,2993,162,772,740,379,145,2198
New Jersey,Navesink,1426,31,136,324,364,168,1023
New Jersey,Burleigh,398,67,190,45,43,32,377
New Jersey,Atlantic City,38372,6759,8528,6039,2923,1258,25507
New Jersey,Ridgefield Park,12934,675,2298,2249,2504,1387,9113
New Jersey,Runnemede borough,8328,572,2144,1532,1082,469,5799
New Jersey,Union City,68362,13899,15204,7983,6554,2985,46625
New Jersey,Ridgewood,25269,563,1642,1764,6345,5847,16161
New Jersey,Edgewater borough,12184,329,1492,1057,4105,2258,9241
New Jersey,Dayton,7340,229,685,672,2021,1161,4768
New Jersey,Barrington borough,6741,396,1348,1457,1261,602,5064
New Jersey,Avalon borough,1409,18,221,288,406,335,1268
New Jersey,Netcong borough,3209,259,846,614,395,171,2285
New Jersey,New Brunswick,56084,9571,6321,4357,3163,2461,25873
New Jersey,Greentree,11453,348,916,1530,2802,2523,8119
New Jersey,Middlesex borough,13659,856,3038,3160,1682,906,9642
New Jersey,North Arlington borough,15724,1230,3715,2749,2534,1250,11478
New Jersey,Maywood borough,9654,453,2111,1810,1577,971,6922
New Jersey,Englewood Cliffs borough,5356,206,574,573,1412,1172,3937
New Jersey,Allendale borough,6762,102,356,790,1892,1216,4356
New Jersey,Pine Valley borough,4,0,0,0,2,2,4
New Jersey,Pine Hill borough,10443,655,2748,2130,1086,518,7137
New Jersey,Lawnside borough,2897,167,867,472,310,287,2103
New Jersey,Berlin borough,7547,466,1391,1427,1478,493,5255
New Jersey,Wenonah borough,2225,25,282,395,505,281,1488
New Jersey,Newfield borough,1572,122,418,303,162,139,1144
New Jersey,National Park borough,2983,237,965,585,184,63,2034
New Jersey,Metuchen borough,13858,376,1394,1937,3089,3092,9888
New Jersey,Highland Park borough,13992,346,1174,1465,2931,3775,9691
New Jersey,East Newark borough,2665,354,687,473,213,111,1838
New Jersey,Teterboro borough,107,17,29,18,3,2,69
New Jersey,Dumont borough,17694,966,3572,2600,3485,2070,12693
New Jersey,Norwood borough,5819,239,892,815,1406,901,4253
New Jersey,Lindenwold borough,17354,1871,4400,3692,1197,655,11815
New Jersey,Beachwood borough,11210,535,2681,2522,1133,360,7231
New Jersey,Paterson,145800,24246,38135,19063,7693,2158,91295
New Jersey,Lawrenceville,3546,22,414,529,940,919,2824
New Jersey,Penns Grove borough,4847,820,992,944,163,101,3020
New Jersey,Alloway,1410,18,402,264,146,66,896
New Jersey,North Wildwood,3849,292,1003,1151,536,234,3216
New Jersey,Diamond Beach,211,7,79,51,18,56,211
New Jersey,Morris Plains borough,5625,117,653,777,1388,1064,3999
New Jersey,Mendham borough,4945,81,456,584,1185,1179,3485
New Jersey,Madison borough,16042,394,1359,1463,3682,3329,10227
New Jersey,Cape May,3491,200,356,578,791,364,2289
New Jersey,Crandon Lakes,1228,58,276,238,164,80,816
New Jersey,Morristown,18769,1533,2725,2096,4565,3318,14237
New Jersey,Ramblewood,5765,224,777,1073,1331,783,4188
New Jersey,Presidential Lakes Estates,1836,83,561,390,125,75,1234
New Jersey,Linden,42033,4097,9470,9152,4389,2203,29311
New Jersey,Fanwood borough,7602,53,1054,726,1765,1457,5055
New Jersey,Somerdale borough,5407,315,1617,1165,717,314,4128
New Jersey,Woodlynne borough,2915,400,610,452,78,35,1575
New Jersey,Bergenfield borough,27372,1783,4533,4380,5652,2296,18644
New Jersey,Carlstadt borough,6191,499,1289,1043,1112,594,4537
New Jersey,Cliffside Park borough,24883,2031,5568,3482,5439,2825,19345
New Jersey,Trenton,83734,15096,19302,12900,4113,2154,53565
New Jersey,Branchville borough,896,59,237,178,73,52,599
New Jersey,Leonardo,2674,120,634,547,342,201,1844
New Jersey,Atlantic Highlands borough,4289,103,653,804,745,758,3063
New Jersey,Fairview,3835,110,591,734,852,346,2633
New Jersey,Monmouth Beach borough,3221,10,265,446,974,723,2418
New Jersey,Neptune City borough,4702,144,1251,952,603,368,3318
New Jersey,Ramtown,6076,93,1121,1073,1181,494,3962
New Jersey,Vernon Valley,1567,54,486,297,203,60,1100
New Jersey,Asbury Park,15674,1632,3553,2536,1735,1083,10539
New Jersey,Bloomingdale borough,8105,344,1724,1379,1469,634,5550
New Jersey,Hasbrouck Heights borough,12091,586,2123,2150,2274,1279,8412
New Jersey,Highlands borough,4818,411,1378,1092,708,547,4136
New Jersey,North Haledon borough,8446,370,2032,1554,1686,929,6571
New Jersey,Cedar Glen Lakes,1543,232,689,334,176,112,1543
New Jersey,Hawthorne borough,18802,1230,3840,3299,3405,1460,13234
New Jersey,Clifton,85169,6979,18940,13731,13082,6430,59162
New Jersey,Twin Rivers,7067,598,1384,856,1133,660,4631
New Jersey,Princeton Junction,2550,128,141,109,630,885,1893
New Jersey,Hightstown borough,5413,685,735,834,1004,643,3901
New Jersey,Old Bridge,23607,1135,4449,4692,4522,2190,16988
New Jersey,Passaic,70131,13802,13803,6630,4233,2218,40686
New Jersey,Perth Amboy,51832,9520,11547,6453,3325,1325,32170
New Jersey,Buena borough,4422,485,1083,870,478,147,3063
New Jersey,Island Heights borough,1457,42,273,292,294,234,1135
New Jersey,Dover Beaches South,1281,38,383,182,332,241,1176
New Jersey,Holiday Heights,1878,154,909,396,286,114,1859
New Jersey,Mystic Island,8717,598,2896,1821,783,448,6546
New Jersey,Tuckerton borough,3380,237,846,672,506,178,2439
New Jersey,Pompton Lakes borough,11049,478,3041,1500,1985,904,7908
New Jersey,Holiday City-Berkeley,12360,1679,5978,2908,1128,385,12078
New Jersey,Plainsboro Center,2752,0,139,169,596,1022,1926
New Jersey,Barnegat Light borough,421,7,97,114,110,72,400
New Jersey,Dover Beaches North,1713,50,441,323,403,331,1548
New Jersey,White Horse,8512,486,2322,1857,1204,564,6433
New Jersey,Allenhurst borough,502,9,59,110,109,95,382
New Jersey,Kendall Park,9346,151,1346,1272,2252,1255,6276
New Jersey,Watchung borough,6034,94,950,836,987,1327,4194
New Jersey,Rocky Hill borough,598,22,34,58,157,161,432
New Jersey,Millstone borough,500,16,100,56,87,48,307
New Jersey,Lambertville,3820,165,685,694,990,662,3196
New Jersey,High Bridge borough,3527,141,549,556,742,483,2471
New Jersey,Linwood,6826,198,1039,1201,1402,1018,4858
New Jersey,Absecon,8289,536,2013,1667,1046,640,5902
New Jersey,Woodbridge,19190,1208,3841,3553,3041,2068,13711
New Jersey,Spotswood borough,8293,443,2161,1991,1083,477,6155
New Jersey,South River borough,16091,1903,3700,2686,1831,847,10967
New Jersey,Hampton borough,1219,50,250,306,217,94,917
New Jersey,Spring Lake Heights borough,4595,57,551,889,1319,735,3551
New Jersey,Shark River Hills,3609,96,685,921,763,295,2760
New Jersey,Manasquan borough,5800,65,798,821,1389,1191,4264
New Jersey,Loch Arbour,178,0,11,29,29,57,126
New Jersey,Wanaque borough,11689,639,3038,2002,2074,877,8630
New Jersey,Haledon borough,8338,622,2002,1348,1150,353,5475
New Jersey,Mantoloking borough,337,6,10,35,147,97,295
New Jersey,North Middletown,3230,176,679,573,386,250,2064
New Jersey,North Beach Haven,2061,27,454,420,631,460,1992
New Jersey,Brooklawn borough,2023,178,621,335,211,40,1385
New Jersey,Lavallette borough,2161,60,424,503,556,351,1894
New Jersey,Leisure Village,4355,461,1632,1163,367,189,3812
New Jersey,Waretown,1933,82,748,356,202,103,1491
New Jersey,Kinnelon borough,10132,202,1192,1215,2314,1917,6840
New Jersey,Mount Arlington borough,5507,124,1092,1202,1027,755,4200
New Jersey,Whittingham,2662,105,734,640,695,390,2564
New Jersey,Margate City,6076,245,1061,1314,1435,1121,5176
New Jersey,Florham Park borough,11672,284,1039,994,2860,2348,7525
New Jersey,Cedar Glen West,1284,138,609,265,115,57,1184
New Jersey,Lincoln Park borough,10339,496,2277,1986,1849,948,7556
New Jersey,Wildwood Crest borough,3131,133,787,676,606,305,2507
New Jersey,Carneys Point,7151,947,1941,1533,552,190,5163
New Jersey,Allentown borough,1903,46,263,345,332,266,1252
New Jersey,Glen Gardner borough,1590,66,292,281,327,176,1142
New Jersey,Peapack and Gladstone borough,2566,55,306,342,491,385,1579
New Jersey,South Bound Brook borough,4550,268,1172,959,491,289,3179
New Jersey,Belford,1908,70,409,328,308,123,1238
New Jersey,Eatontown borough,12237,690,3112,2186,1851,1290,9129
New Jersey,Victory Gardens borough,1578,161,477,260,101,15,1014
New Jersey,South Toms River borough,3748,426,927,580,154,52,2139
New Jersey,Ocean Gate borough,1733,80,544,318,199,85,1226
New Jersey,Barnegat,2657,141,652,646,476,71,1986
New Jersey,Chesilhurst borough,1499,215,496,356,86,24,1177
New Jersey,Echelon,11586,923,1921,1892,2288,1244,8268
New Jersey,Morganville,5041,113,489,760,968,942,3272
New Jersey,Egg Harbor City,4153,481,1123,601,319,118,2642
New Jersey,Estell Manor,1752,91,445,356,205,120,1217
New Jersey,Folsom borough,1768,107,506,384,204,58,1259
New Jersey,Longport borough,828,27,134,155,236,168,720
New Jersey,Port Republic,1178,80,164,268,230,176,918
New Jersey,Ventnor City,10232,842,2697,1653,1296,944,7432
New Jersey,Frenchtown borough,1297,61,274,156,309,159,959
New Jersey,Bound Brook borough,10328,1193,2662,1788,764,515,6922
New Jersey,Manville borough,10283,625,3418,1893,808,288,7032
New Jersey,Belmar borough,5647,334,934,968,1510,744,4490
New Jersey,Bradley Beach borough,4223,371,507,771,980,691,3320
New Jersey,Cliffwood Beach,3015,97,866,767,347,199,2276
New Jersey,Fair Haven borough,5943,66,332,617,1559,1069,3643
New Jersey,Lakewood,55532,3457,5537,4950,3658,2744,20346
New Jersey,Little Silver borough,5864,30,394,811,1533,1233,4001
New Jersey,Pine Beach borough,2251,40,448,459,386,293,1626
New Jersey,Pine Ridge at Crestwood,2255,330,1016,606,173,97,2222
New Jersey,Deal borough,513,45,93,141,85,29,393
New Jersey,White House Station,2210,168,567,338,503,204,1780
New Jersey,Milford borough,1295,53,324,289,192,128,986
New Jersey,Lebanon borough,1945,29,342,329,414,229,1343
New Jersey,Califon borough,1194,21,153,192,279,154,799
New Jersey,Somers Point,10460,787,2466,1903,1485,584,7225
New Jersey,West Long Branch borough,7917,359,1155,1105,1036,887,4542
New Jersey,West Belmar,2379,140,499,328,526,233,1726
New Jersey,Strathmore,7742,193,981,1255,1765,1092,5286
New Jersey,Shrewsbury borough,4088,59,454,507,1151,643,2814
New Jersey,Sea Bright borough,1378,3,148,238,417,291,1097
New Jersey,Bernardsville borough,7698,113,499,789,2231,1629,5261
New Jersey,Leisuretowne,3349,214,1730,736,475,131,3286
New Jersey,Mullica Hill,3851,166,534,812,769,514,2795
New Jersey,Paulsboro borough,5937,469,1841,1355,485,110,4260
New Jersey,Westville borough,4185,278,1337,817,333,112,2877
New Jersey,Gibbsboro borough,2223,89,550,426,304,150,1519
New Jersey,Haddon Heights borough,7491,250,1071,1169,1934,1060,5484
New Jersey,Oceanport borough,5724,153,965,868,1456,736,4178
New Jersey,Oaklyn borough,3954,147,890,973,709,291,3010
New Jersey,Mountain Lakes borough,4274,6,87,254,888,1386,2621
New Jersey,Pemberton Heights,2593,122,671,470,309,87,1659
New Jersey,Far Hills borough,860,14,94,111,241,164,624
New Jersey,North Plainfield borough,21640,2057,4403,4362,2629,1282,14733
New Jersey,Brielle borough,4709,46,458,626,1311,732,3173
New Jersey,Hackettstown,9501,556,1823,1699,1390,773,6241
New Jersey,Olivet,1466,76,262,240,357,123,1058
New Jersey,Riverton borough,2704,70,456,450,589,377,1942
New Jersey,Pemberton borough,1416,106,312,338,178,97,1031
New Jersey,Lake Telemark,1107,0,181,183,256,120,740
New Jersey,Chester borough,1593,53,192,189,365,266,1065
New Jersey,Palmyra borough,7223,315,1810,1679,1080,398,5282
New Jersey,Bordentown,3840,159,848,752,534,573,2866
New Jersey,Summit,21921,698,1976,1588,4957,5465,14684
New Jersey,Oxford,1168,181,395,143,74,55,848
New Jersey,Chatham borough,8881,102,508,709,2308,1948,5575
New Jersey,Pennington borough,2527,40,196,196,564,747,1743
New Jersey,Roselle Park borough,13568,956,2576,2277,2431,1036,9276
New Jersey,New Providence borough,12808,208,1126,1235,3256,2583,8408
New Jersey,Ogdensburg borough,2314,91,689,485,254,140,1659
New Jersey,Red Bank borough,12120,1617,1635,1964,1969,1592,8777
New Jersey,Lincroft,6348,98,834,973,1166,1291,4362
New Jersey,Farmingdale borough,1398,60,339,279,179,99,956
New Jersey,East Freehold,4749,153,779,900,809,629,3270
New Jersey,Brass Castle,1657,64,388,336,142,107,1037
New Jersey,Villas,8783,823,2851,1786,815,341,6616
New Jersey,Seaside Park borough,1654,15,340,329,422,285,1391
New Jersey,Point Pleasant Beach borough,4545,136,790,781,1095,715,3517
New Jersey,Garwood borough,4334,141,872,822,774,499,3108
New Jersey,Mays Landing,2408,53,559,536,447,67,1662
New Jersey,Interlaken borough,758,11,83,115,206,209,624
New Jersey,Williamstown,14962,726,3790,3253,1652,988,10409
New Jersey,Mount Ephraim borough,4607,232,1382,1009,501,166,3290
New Jersey,Hopewell borough,1940,29,155,236,439,470,1329
New Jersey,Roselle borough,21582,1871,4943,4747,2101,859,14521
New Jersey,Marlton,9990,488,1905,1989,1978,1029,7389
New Jersey,Sewaren,2318,107,553,466,448,226,1800
New Jersey,Kingston,1254,22,121,248,336,258,985
New Jersey,Union Beach borough,5549,260,1586,933,615,221,3615
New Jersey,Franklin borough,4807,279,1397,944,557,188,3365
New Jersey,Madison Park,6941,496,1564,1539,1132,377,5108
New Jersey,Holiday City South,4329,463,1883,952,526,98,3922
New Jersey,Leisure Village East,3747,254,1326,857,904,345,3686
New Jersey,Pleasantville,20374,3007,4899,3513,1282,344,13045
New Jersey,South Amboy,8694,562,2164,1860,1022,628,6236
New Jersey,Hammonton,14284,1394,3278,2688,1655,818,9833
New Jersey,Northfield,8344,449,1721,1473,1441,686,5770
New Jersey,Rossmoor,2918,368,888,832,404,414,2906
New Jersey,Freehold borough,11855,2277,2213,1845,1062,587,7984
New Jersey,Spring Lake borough,2945,7,398,352,850,561,2168
New Jersey,Beckett,4983,56,951,776,1139,231,3153
New Jersey,Fort Dix,7753,898,2004,1865,671,256,5694
New Jersey,Medford Lakes borough,4031,46,450,700,911,634,2741
New Jersey,Boonton,8302,468,1267,1330,1895,838,5798
New Jersey,Stanhope borough,3377,132,733,525,693,280,2363
New Jersey,Glen Ridge borough,7573,116,527,640,1954,1509,4746
New Jersey,Beverly,2348,178,676,499,174,148,1675
New Jersey,Burlington,9814,701,2704,2059,780,559,6803
New Jersey,Allenwood,881,10,93,106,222,98,529
New Jersey,Clinton,2676,78,345,417,630,340,1810
New Jersey,Flemington borough,4624,640,942,634,645,349,3210
New Jersey,Somerset,24527,677,3506,4174,5622,3746,17725
New Jersey,Sayreville borough,44285,3171,10329,8130,7153,2977,31760
New Jersey,Port Reading,4139,305,1084,688,505,176,2758
New Jersey,Heathcote,6189,123,328,887,1836,1343,4517
New Jersey,Laurence Harbor,6904,537,1881,1279,885,504,5086
New Jersey,Collings Lakes,1601,150,552,337,38,29,1106
New Jersey,Clementon borough,4911,432,1053,1041,560,55,3141
New Jersey,Elmwood Park borough,20112,1352,5344,3255,2911,1071,13933
New Jersey,Hackensack,44381,4141,9420,7346,8079,3825,32811
New Jersey,Wrightstown borough,659,60,164,147,39,20,430
New Jersey,Keyport borough,7070,677,1853,1626,849,278,5283
New Jersey,Stone Harbor borough,955,23,110,140,296,228,797
New Jersey,Alpha borough,2100,172,658,431,234,86,1581
New Jersey,Iselin,18274,1175,3684,2888,3951,2273,13971
New Jersey,Dunellen borough,7284,420,1582,1375,1073,436,4886
New Jersey,Glassboro borough,19580,960,3211,2928,2478,1389,10966
New Jersey,Carteret borough,23682,2224,5801,4383,3033,995,16436
New Jersey,Brownville,2629,103,495,471,579,292,1940
New Jersey,Jersey City,261746,24395,42711,32562,50514,34605,184787
New Jersey,Fairton,988,86,385,143,44,21,679
New Jersey,Bayonne,65300,5482,14839,8933,11015,5047,45316
New Jersey,Saddle River borough,3212,153,385,380,745,804,2467
New Jersey,Gibbstown,3735,246,1274,699,348,139,2706
New Jersey,Victory Lakes,1888,168,583,404,108,136,1399
New Jersey,Cherry Hill Mall,13752,746,1864,2962,2415,1760,9747
New Jersey,Collingswood borough,13912,583,2591,2522,2832,1812,10340
New Jersey,Laurel Springs borough,1907,48,414,370,345,161,1338
New Jersey,Woodcliff Lake borough,5816,29,514,558,1696,1145,3942
New Jersey,Pitman borough,8830,267,1818,2057,1290,617,6049
New Jersey,Bellmawr borough,11415,1250,3198,2272,1015,462,8197
New Jersey,Glendora,4416,327,1674,1016,181,165,3363
New Jersey,Vineland,60357,9214,13759,10034,4945,2167,40119
New Jersey,Port Norris,872,144,324,181,35,0,684
New Jersey,Cranbury,2144,30,290,222,452,577,1571
New Jersey,Kearny,41567,5262,9716,6343,5492,2074,28887
New Jersey,Hoboken,53211,2293,3350,3103,20771,11585,41102
New Jersey,Upper Saddle River borough,8242,108,757,1008,1859,1430,5162
New Jersey,Ridgefield borough,11248,695,2570,1658,2099,917,7939
New Jersey,Montvale borough,8438,225,1061,1242,1721,1461,5710
New Jersey,Lodi borough,24498,2625,5745,4604,3185,1045,17204
New Jersey,Hillsdale borough,10395,298,1337,1695,2235,1516,7081
New Jersey,Emerson borough,7611,446,1142,1536,1133,1022,5279
New Jersey,Demarest borough,4959,89,360,477,1396,945,3267
New Jersey,Cresskill borough,8730,306,850,1002,2261,1473,5892
New Jersey,Merchantville borough,3726,200,737,763,545,322,2567
New Jersey,Haddonfield borough,11369,56,711,1054,3044,2899,7764
New Jersey,Magnolia borough,4289,175,1175,991,408,259,3008
New Jersey,Stratford borough,6967,205,1736,1223,1125,561,4850
New Jersey,Closter borough,8585,260,1192,737,2231,1470,5890
New Jersey,Strathmere,242,0,85,0,25,74,184
New Jersey,Silver Ridge,1044,119,509,271,73,72,1044
New Jersey,Ship Bottom borough,967,18,178,230,265,168,859
New Jersey,Leisure Knoll,2386,306,928,663,306,139,2342
New Jersey,Belvidere,2601,145,489,522,326,175,1657
New Jersey,Washington borough,6478,611,1561,1500,706,292,4670
New Jersey,Ringwood borough,12276,566,2045,1917,2536,1334,8398
New Jersey,Crestwood Village,8164,1130,3406,2295,763,441,8035
New Jersey,Manahawkin,2140,168,369,401,467,170,1575
New Jersey,Seaside Heights borough,2891,302,585,644,259,32,1822
New Jersey,Toms River,88712,4566,20631,17851,13062,6863,62973
New Jersey,Vista Center,2202,102,450,637,417,196,1802
New Jersey,Bay Head borough,996,11,105,185,269,226,796
New Jersey,Beach Haven borough,1091,11,167,204,356,191,929
New Jersey,Beach Haven West,3860,328,838,825,797,386,3174
New Jersey,Forked River,4701,197,1305,1046,458,438,3444
New Jersey,New Egypt,2407,100,871,401,304,53,1729
New Jersey,Clayton borough,8545,692,2157,1322,1180,549,5900
New Jersey,Point Pleasant borough,18523,449,3479,3809,3534,2086,13357
New Jersey,Leonia borough,9111,485,1104,1199,2290,1226,6304
New Jersey,Riverdale borough,4226,202,763,677,869,644,3155
New Jersey,White Meadow Lake,9383,99,1212,1477,2294,1406,6488
New Jersey,Sea Isle City,1955,58,443,434,419,327,1681
New Jersey,Woodbine borough,2490,743,644,291,74,32,1784
New Jersey,Elmer borough,1445,68,369,286,144,71,938
New Jersey,Pennsville,11311,815,3551,2673,754,417,8210
New Jersey,Rutherford borough,18427,515,2986,2549,4414,2658,13122
New Jersey,Bogota borough,8362,660,1778,1681,1109,590,5818
New Jersey,Springdale,13547,288,1331,1426,3044,3620,9709
New Jersey,Golden Triangle,4602,388,741,1154,460,419,3162
New Jersey,Moonachie borough,2739,298,741,461,309,173,1982
New Jersey,Old Tappan borough,5923,240,703,600,1508,1151,4202
New Jersey,Ho-Ho-Kus borough,4101,60,187,234,1340,895,2716
New Jersey,Haworth borough,3418,64,266,388,819,790,2327
New Jersey,Glen Rock borough,11826,150,632,1186,3090,2439,7497
New Jersey,Surf City borough,1292,22,250,275,348,228,1123
New Jersey,Oak Valley,3357,211,1305,668,201,71,2456
New Jersey,Shiloh borough,374,41,122,79,19,15,276
New Jersey,Rosenhayn,1360,197,438,195,70,54,954
New Jersey,Alpine borough,1513,83,124,86,495,303,1091
New Jersey,East Rutherford borough,9466,497,1845,1744,2333,715,7134
New Jersey,Englewood,28332,1992,5430,3965,4900,3993,20280
New Jersey,Oakland borough,13009,320,2050,1949,2824,1602,8745
New Jersey,Harvey Cedars borough,451,10,41,66,155,128,400
New Jersey,Garfield,31578,3071,8971,5213,3224,1080,21559
New Jersey,New Milford borough,16578,708,3249,2731,3496,1589,11773
New Jersey,Roosevelt borough,806,19,133,113,177,121,563
New Jersey,Palisades Park borough,20554,1839,4107,2716,5553,1323,15538
New Jersey,Bridgeton,24841,5340,5705,2936,579,216,14776
New Jersey,Princeton Meadows,13438,243,1114,1045,3399,3840,9641
New Jersey,Fair Lawn borough,33081,1216,4490,4825,7459,5020,23010
New Jersey,Fort Lee borough,36990,1718,5018,5095,10402,6580,28813
New Jersey,Franklin Lakes borough,10883,134,1045,1441,2933,2129,7682
New Jersey,Avenel,18831,987,6979,2520,2231,1399,14116
New Jersey,Corbin City,457,14,127,94,51,41,327
New Jersey,Rockleigh borough,558,62,145,90,79,78,454
New Jersey,Secaucus,19390,1538,3651,2521,4038,2584,14332
New Jersey,Colonia,17734,777,3982,3140,2977,1967,12843
New Jersey,South Plainfield borough,23906,1568,5222,4333,3943,2081,17147
New Jersey,Annandale,1485,60,166,189,389,229,1033
New Jersey,Bloomsbury borough,721,38,130,118,129,80,495
New Jersey,Stockton borough,655,17,142,79,130,94,462
New Jersey,Raritan borough,7797,453,1778,1210,1236,722,5399
New Jersey,Somerville borough,12121,797,1879,2028,2488,1232,8424
New Jersey,Avon-by-the-Sea borough,1761,29,195,343,473,369,1409
New Jersey,Englishtown borough,2078,84,431,470,323,125,1433
New Jersey,Tavistock borough,3,0,0,0,3,0,3
New Jersey,Hi-Nella borough,959,46,238,201,108,46,639
New Jersey,Fairview borough,14269,2987,3452,1954,1629,466,10488
New Jersey,Camden,74608,14350,15443,9881,2727,1228,43629
New Jersey,Turnersville,3596,47,539,623,816,282,2307
New Jersey,Laurel Lake,3503,519,1042,523,162,29,2275
New Jersey,Cedarville,955,166,208,142,27,0,543
New Jersey,Paramus borough,26613,1700,4302,4019,6054,3305,19380
New Jersey,Oradell borough,8134,190,872,1127,2118,1276,5583
New Jersey,Northvale borough,4854,207,765,695,1455,395,3517
New Jersey,Midland Park borough,7263,302,1485,1006,1382,821,4996
New Jersey,Gloucester City,11246,868,3119,1991,897,463,7338
New Jersey,Harrington Park borough,4761,75,359,635,1238,887,3194
New Jersey,Brigantine,8966,540,2105,2208,1676,900,7429
New Jersey,Monmouth Junction,3302,33,163,220,875,706,1997
New Jersey,Milltown borough,6993,225,1469,1440,1216,502,4852
New Jersey,Jamesburg borough,5947,242,1448,1178,941,208,4017
New Jersey,Helmetta borough,2283,123,595,500,310,186,1714
New Jersey,Little Ferry borough,10827,1063,2159,2316,1842,710,8090
New Jersey,Concordia,3377,237,912,841,866,492,3348
New Jersey,Fords,14948,959,3375,2678,2540,1139,10691
New Jersey,Matawan borough,8826,372,1411,1767,1789,1018,6357
New Jersey,Ocean Grove,3133,75,424,671,797,935,2902
New Jersey,Port Monmouth,3225,170,894,631,404,184,2283
New Jersey,Rumson borough,6805,54,432,700,1677,1230,4093
New Jersey,Sea Girt borough,1732,5,143,209,552,481,1390
New Jersey,Lakehurst borough,2683,237,701,520,224,102,1784
New Jersey,West Freehold,13759,377,2155,2464,2878,1624,9498
New Jersey,Park Ridge borough,8804,308,1062,1218,2357,1259,6204
New Jersey,Waldwick borough,9948,352,1254,1642,2501,1090,6839
New Jersey,Wallington borough,11580,800,3222,2103,1850,839,8814
New Jersey,Wood-Ridge borough,8511,268,1633,1578,1482,995,5956
New Jersey,Harrison,16180,1943,3141,1925,2164,2096,11269
New Jersey,Wanamassa,4628,102,1136,796,894,426,3354
New Mexico,Arrey,23,0,23,0,0,0,23
New Mexico,Arenas Valley,1647,146,171,565,146,63,1091
New Mexico,Aragon,64,12,52,0,0,0,64
New Mexico,Apache Creek,144,9,97,22,16,0,144
New Mexico,Anzac Village,72,0,5,40,0,13,58
New Mexico,Adelino,907,56,257,401,75,23,812
New Mexico,Animas,160,18,20,60,14,14,126
New Mexico,Alamillo,192,72,63,7,42,8,192
New Mexico,Abiquiu,246,0,122,51,54,0,227
New Mexico,Abeytas,177,0,0,0,15,11,26
New Mexico,Ruidoso Downs,2597,397,512,484,85,67,1545
New Mexico,Anton Chico,189,27,71,53,38,0,189
New Mexico,Peralta,3577,171,1060,897,256,168,2552
New Mexico,Salem,650,322,0,0,0,0,322
New Mexico,Ute Park,219,0,138,81,0,0,219
New Mexico,Mountainair,974,113,222,201,93,65,694
New Mexico,San Ysidro,193,42,51,56,8,0,157
New Mexico,Portales,11974,1171,1589,1741,1031,710,6242
New Mexico,Floyd,111,14,10,21,11,0,56
New Mexico,Lovington,11575,2134,2167,1851,397,164,6713
New Mexico,Arroyo Hondo,174,0,9,61,60,23,153
New Mexico,Artesia,12202,1272,2964,2325,710,383,7654
New Mexico,Rincon,413,59,70,0,0,0,129
New Mexico,Flora Vista,1799,215,534,708,91,0,1548
New Mexico,Mesquite,414,129,32,23,39,48,271
New Mexico,Tijeras,655,39,139,166,56,76,476
New Mexico,Carnuel,1724,199,491,340,174,190,1394
New Mexico,Albuquerque,559202,39104,85664,122711,72340,59381,379200
New Mexico,Pueblo,0,0,0,0,0,0,0
New Mexico,Española,10090,1286,2060,2018,528,408,6300
New Mexico,Anthony,9368,2088,1450,951,220,49,4758
New Mexico,Gallina,175,29,16,28,20,6,99
New Mexico,Rio Communities,4587,312,1191,1545,262,180,3490
New Mexico,Springer,811,22,271,210,94,67,664
New Mexico,Cuartelez,124,26,0,52,0,0,78
New Mexico,Pojoaque,2018,190,391,421,152,126,1280
New Mexico,Isleta Village Proper,389,71,76,112,29,0,288
New Mexico,Corona,103,22,17,24,14,16,93
New Mexico,Santa Teresa,5696,397,402,1257,663,341,3060
New Mexico,Vado,2579,750,359,323,84,11,1527
New Mexico,Estancia,1643,256,476,218,36,105,1091
New Mexico,Jemez Springs,205,2,34,45,45,51,177
New Mexico,La Jara,257,61,47,17,36,13,174
New Mexico,Grenville,17,0,0,6,9,0,15
New Mexico,Los Chaves,5890,630,1089,1291,550,368,3928
New Mexico,Tatum,772,118,202,159,21,27,527
New Mexico,Dora,134,13,38,29,4,6,90
New Mexico,Willard,202,46,57,29,0,0,132
New Mexico,Santa Ana Pueblo,602,49,167,166,25,14,421
New Mexico,Zia Pueblo,934,100,194,215,27,4,540
New Mexico,Torreon CDP (Torrance County),231,0,87,144,0,0,231
New Mexico,Vadito,295,39,71,61,6,8,185
New Mexico,Shiprock,8966,868,1728,2211,450,239,5496
New Mexico,Naschitti,328,40,97,73,26,4,240
New Mexico,Farmington,45582,3526,7232,11479,3461,2562,28260
New Mexico,Los Ranchos de Albuquerque,6131,333,658,1560,855,1293,4699
New Mexico,Kirtland,884,2,105,299,43,87,536
New Mexico,Youngsville,42,9,20,13,0,0,42
New Mexico,Los Alamos,12373,234,885,1753,2451,3654,8977
New Mexico,Wagon Mound,266,60,97,47,18,22,244
New Mexico,Cañada de los Alamos,416,10,130,34,0,65,239
New Mexico,Doña Ana,851,370,152,184,0,0,706
New Mexico,Napi Headquarters,744,117,148,146,9,0,420
New Mexico,Peña Blanca,605,78,128,96,14,29,345
New Mexico,Peñasco,663,44,207,142,49,28,470
New Mexico,Cannon AFB,2523,6,74,519,294,20,913
New Mexico,Young Place,214,28,74,27,0,0,129
New Mexico,Winston,64,24,26,14,0,0,64
New Mexico,Windmill,85,3,24,28,0,6,61
New Mexico,White Signal,272,16,23,70,27,73,209
New Mexico,Whites City,173,0,63,40,0,0,103
New Mexico,West Hammond,2787,311,736,605,87,87,1826
New Mexico,Weed,0,0,0,0,0,0,0
New Mexico,Watrous,124,12,0,79,0,0,91
New Mexico,Villanueva,362,150,16,58,70,0,294
New Mexico,Ventura,403,29,162,77,0,40,308
New Mexico,Velarde,119,0,0,40,79,0,119
New Mexico,Waterflow,1769,54,408,459,63,80,1064
New Mexico,Veguita,80,0,21,59,0,0,80
New Mexico,Virden,152,7,25,45,18,9,104
New Mexico,Tyrone,551,29,21,206,41,62,359
New Mexico,Dexter,1091,275,189,159,34,18,675
New Mexico,Rio Lucio,474,100,133,77,31,9,350
New Mexico,Tularosa,2931,342,747,740,249,250,2328
New Mexico,Church Rock,909,121,210,203,18,10,562
New Mexico,Tohatchi,825,60,170,168,42,47,487
New Mexico,Las Vegas,13341,1788,2491,2540,1203,895,8917
New Mexico,Mosquero,71,3,20,13,8,0,44
New Mexico,Williamsburg,448,45,103,122,48,1,319
New Mexico,Lordsburg,2539,452,739,404,106,43,1744
New Mexico,Logan,848,29,364,139,31,72,635
New Mexico,Tucumcari,4958,645,1358,944,210,177,3334
New Mexico,Tse Bonito,176,82,94,0,0,0,176
New Mexico,Dulce,2663,183,575,573,109,67,1507
New Mexico,Questa,2019,184,462,614,68,37,1365
New Mexico,Valencia,1826,322,543,425,67,212,1569
New Mexico,Elephant Butte,1366,87,404,535,134,98,1258
New Mexico,Picuris Pueblo,115,7,58,32,3,0,100
New Mexico,Taos Ski Valley,95,2,4,32,22,5,65
New Mexico,Hurley,1439,133,366,279,74,52,904
New Mexico,Nageezi,261,41,69,38,0,0,148
New Mexico,Chamisal,336,46,109,88,20,15,278
New Mexico,Silver City,9783,917,1475,2160,1244,892,6688
New Mexico,Arroyo Seco,973,59,215,59,212,117,662
New Mexico,Kingston,0,0,0,0,0,0,0
New Mexico,Blanco,85,10,67,8,0,0,85
New Mexico,Madrone,682,121,219,96,0,18,454
New Mexico,Lyden,138,0,117,21,0,0,138
New Mexico,McCartys Village,72,4,17,3,17,0,41
New Mexico,McIntosh,1089,55,296,392,65,23,831
New Mexico,Malaga,148,56,57,23,0,0,136
New Mexico,Manzano Springs,229,0,9,58,43,0,110
New Mexico,Mayhill,59,0,42,2,11,0,55
New Mexico,Luna,43,0,0,35,0,8,43
New Mexico,Middle Frisco,21,17,4,0,0,0,21
New Mexico,Mimbres,536,24,172,206,77,27,506
New Mexico,Monterey Park,1493,418,95,95,0,0,608
New Mexico,Monument,96,0,21,25,5,9,60
New Mexico,Moquino,43,18,25,0,0,0,43
New Mexico,Mora,907,9,176,427,0,0,612
New Mexico,Morningside,857,76,51,150,34,0,311
New Mexico,Mountain View,135,44,77,14,0,0,135
New Mexico,Midway,841,114,206,217,28,0,565
New Mexico,Lumberton,186,0,80,2,2,3,87
New Mexico,Luis Lopez,191,0,141,0,0,17,158
New Mexico,Lower Frisco,0,0,0,0,0,0,0
New Mexico,Gallup,22105,2490,3557,4139,1399,1552,13137
New Mexico,Lamy,180,11,56,15,12,50,144
New Mexico,La Mesa,571,156,166,93,0,31,446
New Mexico,La Mesilla,2384,92,484,703,293,247,1819
New Mexico,La Plata,515,33,113,152,32,41,371
New Mexico,Las Maravillas,1668,128,245,423,103,61,960
New Mexico,Las Nutrias,82,2,40,0,0,0,42
New Mexico,Las Palomas,306,31,63,64,65,0,223
New Mexico,La Union,869,140,256,114,81,20,611
New Mexico,La Villita,1166,91,189,287,45,57,669
New Mexico,Lee Acres,6084,936,1076,1375,260,287,3934
New Mexico,Lemitar,459,27,207,35,98,0,367
New Mexico,Livingston Wheeler,851,155,138,178,23,35,529
New Mexico,Llano del Medio,156,74,44,38,0,0,156
New Mexico,Loco Hills,22,11,11,0,0,0,22
New Mexico,Los Luceros,483,0,104,66,29,0,199
New Mexico,Los Ojos,52,0,26,0,0,26,52
New Mexico,Nadine,328,16,119,91,8,16,250
New Mexico,Nambe,1814,137,381,438,187,146,1289
New Mexico,Nara Visa,47,0,29,18,0,0,47
New Mexico,Navajo Dam,329,11,72,92,52,46,273
New Mexico,Alamo,742,296,184,63,4,7,554
New Mexico,Socorro,8554,961,1481,1305,701,554,5002
New Mexico,Bloomfield,7996,810,1359,1713,298,361,4541
New Mexico,Raton,6145,498,1912,1415,296,267,4388
New Mexico,Grants,9063,1189,1847,2172,613,309,6130
New Mexico,Paguate,420,17,105,135,25,37,319
New Mexico,Chaparral,14793,3409,2013,2023,646,143,8234
New Mexico,Skyline-Ganipa,1208,66,276,285,34,29,690
New Mexico,Agua Fria,2959,685,667,388,162,98,2000
New Mexico,Cedar Crest,709,22,53,312,103,112,602
New Mexico,Laguna,1151,65,305,274,63,12,719
New Mexico,Las Cruces,101742,7914,13128,20563,11990,8162,61757
New Mexico,Hope,104,30,8,27,6,0,71
New Mexico,Causey,80,21,9,15,10,4,59
New Mexico,Bernalillo,9315,1435,2192,1876,683,426,6612
New Mexico,Rio Rancho,94765,4585,15470,24416,12324,6880,63675
New Mexico,Belen,7106,840,1534,1516,360,411,4661
New Mexico,Tesuque,837,32,135,214,191,188,760
New Mexico,Crownpoint,2500,300,349,629,144,116,1538
New Mexico,San Ildefonso Pueblo,742,52,153,200,60,37,502
New Mexico,Jaconita,426,53,110,73,70,41,347
New Mexico,Newkirk,0,0,0,0,0,0,0
New Mexico,Nogal,133,0,29,31,17,1,78
New Mexico,North Hobbs,6068,899,1348,1256,360,276,4139
New Mexico,North Hurley,134,0,20,65,8,25,118
New Mexico,North Light Plant,348,60,120,33,0,24,237
New Mexico,North San Ysidro,0,0,0,0,0,0,0
New Mexico,Oasis,63,0,5,29,20,0,54
New Mexico,Ohkay Owingeh,1356,48,373,397,51,11,880
New Mexico,Organ,200,0,0,147,0,0,147
New Mexico,Orogrande,91,33,0,40,0,0,73
New Mexico,Pajarito Mesa,289,123,26,0,0,0,149
New Mexico,Paradise Hills,5079,225,890,1243,698,436,3492
New Mexico,Pastura,8,0,8,0,0,0,8
New Mexico,Peak Place,412,67,96,40,11,3,217
New Mexico,Roy,184,30,66,49,18,6,169
New Mexico,Vaughn,151,34,86,25,6,0,151
New Mexico,Chimayo,2459,119,461,660,158,100,1498
New Mexico,Los Cerrillos,260,70,51,60,5,32,218
New Mexico,Atoka,1019,162,369,110,47,42,730
New Mexico,Black Rock,1684,138,283,291,53,66,831
New Mexico,Hagerman,914,105,236,149,62,3,555
New Mexico,Cliff,184,0,84,71,7,0,162
New Mexico,Cobre,24,0,0,0,24,0,24
New Mexico,Cochiti Lake,522,10,65,137,119,92,423
New Mexico,Conchas Dam,16,0,16,0,0,0,16
New Mexico,Cordova,759,73,282,111,66,0,532
New Mexico,Costilla,92,53,39,0,0,0,92
New Mexico,Cotton City,288,71,51,58,15,0,195
New Mexico,City of the Sun,47,0,0,47,0,0,47
New Mexico,Coyote,87,7,46,34,0,0,87
New Mexico,Cubero,266,26,48,77,0,13,164
New Mexico,Cuyamungue Grant,188,36,56,6,29,12,139
New Mexico,Datil,14,0,0,6,8,0,14
New Mexico,Dixon,794,335,21,61,11,162,590
New Mexico,Duran,11,0,2,3,1,0,6
New Mexico,East Pecos,583,61,120,107,0,105,393
New Mexico,Edith Endave,432,15,127,71,19,44,276
New Mexico,Cruzville,182,3,88,38,0,0,129
New Mexico,Chili,789,89,0,411,64,42,606
New Mexico,Chical,111,37,22,23,6,0,88
New Mexico,Chamizal,76,10,0,0,0,66,76
New Mexico,Bent,56,0,56,0,0,0,56
New Mexico,Berino,1610,487,232,141,51,19,930
New Mexico,Bibo,150,0,52,0,50,8,110
New Mexico,Bluewater Acres,205,39,11,87,0,9,146
New Mexico,Bluewater Village,277,0,91,67,38,0,196
New Mexico,Brazos,92,0,92,0,0,0,92
New Mexico,Buckhorn,170,0,96,41,18,15,170
New Mexico,Caballo,58,0,20,0,38,0,58
New Mexico,Canjilon,363,9,150,66,0,0,225
New Mexico,Cañon,303,0,106,0,10,31,147
New Mexico,Cañones,37,12,8,0,0,0,20
New Mexico,Canova,83,39,21,23,0,0,83
New Mexico,Capulin,54,2,20,10,0,0,32
New Mexico,Cedar Hill,772,62,120,228,155,41,606
New Mexico,Cedro,322,0,47,117,46,45,255
New Mexico,Chamberino,666,170,104,65,47,55,441
New Mexico,Chamita,1042,104,333,245,33,17,732
New Mexico,El Cerro,2507,137,559,540,294,238,1768
New Mexico,El Cerro Mission,4734,868,945,839,228,15,2895
New Mexico,El Duende,454,39,101,183,1,2,326
New Mexico,El Rito,1110,24,285,262,265,0,836
New Mexico,Jacona,377,25,95,85,52,35,292
New Mexico,Keeler Farm,1804,470,313,227,7,50,1067
New Mexico,Twin Forks,200,0,17,56,65,32,170
New Mexico,La Cueva,142,10,35,47,19,31,142
New Mexico,La Hacienda,487,80,81,16,14,0,191
New Mexico,La Huerta,1497,26,366,433,99,86,1010
New Mexico,La Joya,12,0,0,12,0,0,12
New Mexico,Lake Roberts,37,0,0,0,25,0,25
New Mexico,Lake Roberts Heights,51,0,0,25,12,14,51
New Mexico,Lake Valley,92,12,25,6,2,37,82
New Mexico,La Madera,22,0,22,0,0,0,22
New Mexico,Alamogordo,31230,2418,5902,8273,2672,1799,21064
New Mexico,Holloman AFB,3955,18,263,785,329,126,1521
New Mexico,Mescalero,1361,209,314,278,79,15,895
New Mexico,Chama,995,95,319,194,82,54,744
New Mexico,Meadow Lake,4253,838,859,729,98,53,2577
New Mexico,Taos Pueblo,1518,100,354,557,77,23,1111
New Mexico,Indian Hills,1105,112,336,310,50,50,858
New Mexico,Roswell,48186,6404,8271,10111,3687,1806,30279
New Mexico,Hot Springs Landing,67,0,0,67,0,0,67
New Mexico,Hillsboro,121,0,14,47,33,11,105
New Mexico,Ensenada,28,0,0,28,0,0,28
New Mexico,Escondida,31,0,0,31,0,0,31
New Mexico,Escudilla Bonita,75,0,33,18,16,8,75
New Mexico,Fairacres,1309,306,102,257,105,52,822
New Mexico,Faywood,44,28,0,9,0,7,44
New Mexico,Fence Lake,93,0,52,25,0,0,77
New Mexico,Garfield,0,0,0,0,0,0,0
New Mexico,Gila,344,0,60,116,57,5,238
New Mexico,Glen Acres,171,38,7,72,10,18,145
New Mexico,Glenwood,38,13,0,25,0,0,38
New Mexico,Golden,21,0,0,0,0,14,14
New Mexico,Hernandez,652,134,113,145,21,3,416
New Mexico,Hachita,34,0,12,0,15,7,34
New Mexico,Hanover,211,10,30,41,31,10,122
New Mexico,Happy Valley,752,65,268,125,22,0,480
New Mexico,Highland Meadows,534,11,99,127,37,0,274
New Mexico,High Rolls,767,9,90,167,144,128,538
New Mexico,Homestead,33,0,0,33,0,0,33
New Mexico,Truchas,229,10,64,75,25,19,193
New Mexico,Hatch,1489,371,159,145,87,72,834
New Mexico,Tome,2172,190,560,449,91,167,1457
New Mexico,Chilili,63,33,24,6,0,0,63
New Mexico,Texico,1229,220,193,170,36,11,630
New Mexico,Melrose,595,60,145,206,28,19,458
New Mexico,Grady,134,23,29,28,4,9,93
New Mexico,Magdalena,599,51,171,89,8,63,382
New Mexico,Santa Fe,83847,6938,14395,14326,12547,12694,60900
New Mexico,La Puebla,1005,126,292,147,160,50,775
New Mexico,Pueblitos,370,57,83,75,52,19,286
New Mexico,Pueblito,167,46,70,12,3,5,136
New Mexico,Ponderosa Pine,1057,14,78,282,206,251,831
New Mexico,Polvadera,225,27,119,69,10,0,225
New Mexico,Pleasanton,193,0,24,85,51,5,165
New Mexico,Playas,44,0,0,5,0,0,5
New Mexico,Placitas CDP (Sandoval County),4441,133,589,1154,1214,933,4023
New Mexico,Placitas CDP (Doña Ana County),591,159,37,73,0,0,269
New Mexico,Pinos Altos,365,0,36,119,9,91,255
New Mexico,Pinon,0,0,0,0,0,0,0
New Mexico,Ranchos de Taos,2460,273,399,443,374,217,1706
New Mexico,Santa Rosa,3426,467,1105,671,202,95,2540
New Mexico,Mesita,857,49,148,324,49,10,580
New Mexico,North Acomita Village,192,15,46,74,0,6,141
New Mexico,Mesilla,2138,198,309,308,404,279,1498
New Mexico,Hobbs,38052,5944,7063,6053,1973,1270,22303
New Mexico,Crystal,357,25,75,79,29,13,221
New Mexico,Elida,209,31,44,28,13,7,123
New Mexico,Santo Domingo Pueblo,2379,305,548,423,49,26,1351
New Mexico,Clayton,3104,564,1004,565,167,85,2385
New Mexico,Chupadero,248,18,14,9,78,83,202
New Mexico,Eldorado at Santa Fe,5999,70,370,1189,1767,1988,5384
New Mexico,Pecan Park,0,0,0,0,0,0,0
New Mexico,Pie Town,93,0,9,19,37,0,65
New Mexico,Ponderosa,288,21,44,90,42,0,197
New Mexico,Sheep Springs,268,37,70,49,9,4,169
New Mexico,Cedar Grove,603,24,122,184,73,83,486
New Mexico,Cuyamungue,476,28,110,110,55,18,321
New Mexico,Edgewood,6067,178,1199,1724,735,426,4262
New Mexico,El Rancho,1088,73,221,279,109,94,776
New Mexico,Madrid,201,0,31,62,49,12,154
New Mexico,Puerto de Luna,57,19,10,28,0,0,57
New Mexico,Pulpotio Bareas,283,0,0,143,0,0,143
New Mexico,Quemado,69,0,28,41,0,0,69
New Mexico,Loving,1212,225,367,216,22,11,841
New Mexico,Rancho Grande,52,0,0,37,9,6,52
New Mexico,Rivers,0,0,0,0,0,0,0
New Mexico,Rodeo,68,6,32,16,0,14,68
New Mexico,Rodey,359,105,55,0,0,0,160
New Mexico,Rosedale,313,54,120,55,32,52,313
New Mexico,Rowe,150,0,65,43,0,28,136
New Mexico,Sacramento,118,36,14,0,29,0,79
New Mexico,Ribera,307,77,49,120,0,10,256
New Mexico,Casa Colorada,69,4,10,35,0,0,49
New Mexico,Carlsbad,28838,2415,6939,5943,1965,1372,18634
New Mexico,Paraje,831,103,224,209,51,12,599
New Mexico,El Valle de Arroyo Seco,1721,263,424,251,24,22,984
New Mexico,Reserve,669,28,279,131,25,10,473
New Mexico,Sanostee,434,79,100,75,3,10,267
New Mexico,North Valley,12242,1180,2645,2645,1428,1271,9169
New Mexico,Fort Sumner,1228,161,370,268,33,17,849
New Mexico,Lake Sumner,154,0,37,41,8,7,93
New Mexico,Seama,336,11,121,127,0,0,259
New Mexico,Maxwell,259,20,55,46,25,9,155
New Mexico,Pinehill,62,0,14,27,0,0,41
New Mexico,University Park,3121,0,18,249,83,41,391
New Mexico,Sunland Park,16602,3328,2582,2065,982,213,9170
New Mexico,Clovis,39239,4334,6700,8460,3093,1660,24247
New Mexico,Angel Fire,732,33,38,193,155,153,572
New Mexico,Encinal,203,30,83,46,9,0,168
New Mexico,Milan,3636,473,700,1017,196,150,2536
New Mexico,San Acacia,83,8,50,20,5,0,83
New Mexico,Thoreau,1666,285,309,287,30,12,923
New Mexico,Zuni Pueblo,7590,1179,1886,1530,180,48,4823
New Mexico,San Felipe Pueblo,2194,424,411,351,55,30,1271
New Mexico,Regina,57,15,32,0,0,0,47
New Mexico,Pueblo of Sandia Village,377,15,70,127,18,7,237
New Mexico,Jemez Pueblo,2031,185,502,495,48,20,1250
New Mexico,Cuba,756,118,206,105,36,23,488
New Mexico,Eunice,3059,486,571,504,143,25,1729
New Mexico,Carrizozo,947,94,229,230,59,45,657
New Mexico,Twin Lakes,1008,111,287,166,36,17,617
New Mexico,Ramah,359,2,52,83,58,32,227
New Mexico,San Jon,235,37,44,47,17,6,151
New Mexico,Timberon,301,0,56,197,48,0,301
New Mexico,Columbus,1165,479,140,100,35,32,786
New Mexico,Bayard,2419,290,500,439,168,92,1489
New Mexico,Truth or Consequences,5968,856,1357,1559,431,399,4602
New Mexico,Corrales,8544,312,828,1518,2018,2054,6730
New Mexico,Algodones,826,94,227,135,91,54,601
New Mexico,Encino,54,6,38,10,0,0,54
New Mexico,Red River,418,4,30,115,86,35,270
New Mexico,Taos,6021,324,1055,1632,829,622,4462
New Mexico,Santa Clara,1783,296,419,368,88,35,1206
New Mexico,Lake Arthur,380,73,77,62,11,17,240
New Mexico,Boles Acres,1899,125,468,686,87,120,1486
New Mexico,House,33,0,7,14,5,4,30
New Mexico,Torreon CDP (Sandoval County),215,24,57,36,13,2,132
New Mexico,Cundiyo,35,6,17,0,0,12,35
New Mexico,South Valley,41011,6993,9696,7645,2342,1301,27977
New Mexico,Aztec,6567,732,1487,1537,333,295,4384
New Mexico,Beclabito,303,35,81,83,13,9,221
New Mexico,Newcomb,368,41,77,70,37,26,251
New Mexico,Cochiti,471,7,128,115,26,7,283
New Mexico,Upper Fruitland,1672,306,416,340,87,11,1160
New Mexico,Glorieta,543,88,92,121,42,69,412
New Mexico,Manzano,0,0,0,0,0,0,0
New Mexico,Tajique,263,0,19,43,24,0,86
New Mexico,Des Moines,98,5,15,27,10,0,57
New Mexico,Radium Springs,1731,257,278,191,290,187,1203
New Mexico,Capitan,1441,41,360,376,69,55,901
New Mexico,Sombrillo,232,13,18,91,87,2,211
New Mexico,Eagle Nest,263,3,53,67,64,18,205
New Mexico,La Cienega,3526,555,884,583,225,173,2420
New Mexico,Rock Springs,410,31,110,43,2,0,186
New Mexico,Cimarron,983,120,162,236,77,56,651
New Mexico,Yah-ta-hey,648,53,78,144,0,23,298
New Mexico,Acomita Lake,517,54,169,117,15,0,355
New Mexico,Jal,2032,400,497,346,82,7,1332
New Mexico,Brimhall Nizhoni,383,74,111,76,0,5,266
New Mexico,Moriarty,2223,228,547,441,124,30,1370
New Mexico,Rio en Medio,205,29,51,29,26,0,135
New Mexico,Nenahnezad,671,80,128,162,27,10,407
New Mexico,White Sands,1137,6,66,178,148,65,463
New Mexico,Trout Valley,0,0,0,0,0,0,0
New Mexico,Santa Cruz,261,64,58,59,3,0,184
New Mexico,White Rock,5809,49,396,970,1086,1427,3928
New Mexico,Folsom,29,0,13,5,2,0,20
New Mexico,Bosque Farms,3827,274,805,893,451,263,2686
New Mexico,Jarales,2060,268,397,521,133,47,1366
New Mexico,Cloudcroft,606,16,93,216,92,82,499
New Mexico,Nakaibito,352,58,94,58,22,2,234
New Mexico,Santa Clara Pueblo,789,69,133,174,50,67,493
New Mexico,Galisteo,275,5,46,46,51,56,204
New Mexico,Deming,14292,2951,2962,1947,755,448,9063
New Mexico,Navajo,1498,164,295,200,26,7,692
New Mexico,Alcalde,198,8,41,59,13,3,124
New Mexico,Pecos,1594,272,473,410,17,23,1195
New Mexico,Ojo Amarillo,643,34,154,137,13,15,353
New Mexico,Ruidoso,7757,338,1809,1998,1381,602,6128
New Mexico,Los Lunas,15428,1468,3027,3456,1447,763,10161
New Mexico,La Luz,1472,217,258,515,84,112,1186
New Mexico,San Antonio,11,0,11,0,0,0,11
New Mexico,Pueblo Pintado,404,38,50,115,7,3,213
New Mexico,Sena,151,55,34,0,0,0,89
New Mexico,San Fidel,439,86,0,75,2,0,163
New Mexico,San Jose CDP (Rio Arriba County),632,82,163,173,18,11,447
New Mexico,San Jose CDP (San Miguel County),217,18,59,18,40,48,183
New Mexico,San Lorenzo,148,0,83,57,8,0,148
New Mexico,San Luis,204,33,96,7,7,0,143
New Mexico,San Mateo,341,0,79,41,56,54,230
New Mexico,San Miguel,1054,242,154,227,72,71,766
New Mexico,San Pablo,1046,138,118,200,82,56,594
New Mexico,San Pedro,93,0,7,39,30,17,93
New Mexico,San Rafael,1251,244,277,290,41,22,874
New Mexico,San Ysidro,2091,271,205,385,449,82,1392
New Mexico,Sausal,1944,120,406,350,130,58,1064
New Mexico,Seboyeta,157,43,49,0,0,25,117
New Mexico,Sedillo,911,0,123,223,282,160,788
New Mexico,San Antonito CDP (Socorro County),11,0,0,0,11,0,11
New Mexico,Soham,80,55,0,0,25,0,80
New Mexico,South Acomita Village,47,6,23,12,6,0,47
New Mexico,Spencerville,1746,142,308,537,108,25,1120
New Mexico,Sunshine,203,12,49,76,10,3,150
New Mexico,Talpa,636,0,175,142,74,47,438
New Mexico,Tecolote,205,96,9,39,0,10,154
New Mexico,Tecolotito,233,72,0,32,0,20,124
New Mexico,Tesuque Pueblo,260,30,48,72,17,7,174
New Mexico,Tierra Amarilla,653,46,148,233,28,20,475
New Mexico,San Cristobal,259,54,16,121,51,0,242
New Mexico,Sandia Park,141,0,8,52,23,58,141
New Mexico,Sandia Knolls,1566,36,299,347,342,210,1234
New Mexico,San Antonito CDP (Bernalillo County),1179,0,62,116,438,172,788
New Mexico,Sandia Heights,3366,24,167,512,824,1431,2958
New York,Middletown,27644,2826,6448,5535,2253,1341,18403
New York,New Windsor,9185,493,2400,2185,1021,529,6628
New York,Walden,6726,407,1503,1293,511,441,4155
New York,West Point,6670,0,100,278,496,882,1756
New York,Chester,3981,314,889,900,481,185,2769
New York,Fishkill,1957,109,305,350,332,364,1460
New York,Myers Corner,6620,272,1251,1141,1257,937,4858
New York,Pine Plains,1347,56,373,361,63,76,929
New York,Arlington,3556,203,524,480,277,260,1744
New York,Philmont,1165,77,191,286,180,66,800
New York,Brighton,36447,1129,3087,4955,7253,9539,25963
New York,Rochester,207778,25916,36246,37935,19050,13810,132957
New York,Stony Point,12869,566,2472,2815,1717,1312,8882
New York,Greenwood Lake,3094,356,624,790,343,199,2312
New York,Mechanicstown,6957,771,1759,1650,568,307,5055
New York,Canton,6501,142,624,439,512,806,2523
New York,Bardonia,3839,138,487,507,1036,543,2711
New York,Piermont,2543,125,246,268,663,752,2054
New York,Sloatsburg,3111,77,520,680,463,360,2100
New York,Massena,10090,705,2574,1963,917,932,7091
New York,Potsdam,9281,232,655,526,551,1107,3071
New York,Unadilla,1074,71,274,246,86,45,722
New York,Highland,5620,525,1163,1150,844,364,4046
New York,Lincoln Park,2147,196,565,544,279,118,1702
New York,Marlboro,3565,189,858,809,478,323,2657
New York,New Paltz,7175,45,290,357,592,834,2118
New York,Pine Hill,166,13,69,22,26,11,141
New York,Angelica,759,49,235,167,59,50,560
New York,West Haverstraw,10253,1283,1754,2382,661,454,6534
New York,Upper Nyack,2174,38,181,278,424,566,1487
New York,Florida,2836,117,611,673,325,213,1939
New York,Phoenix,2440,215,513,700,194,50,1672
New York,Oriskany Falls,818,78,220,157,72,20,547
New York,Holland Patent,338,4,95,81,32,40,252
New York,Clark Mills,1588,52,386,482,214,114,1248
New York,Woodsburgh,755,9,70,51,174,235,539
New York,Westbury,15320,1675,2213,2843,2267,2159,11157
New York,South Floral Park,1986,123,351,460,244,148,1326
New York,Plandome Manor,785,7,37,57,210,212,523
New York,Woodmere,17467,532,1266,2004,2900,3870,10572
New York,Turin,265,5,80,40,12,7,144
New York,Silver Creek,2360,121,524,562,287,130,1624
New York,Jamestown,29799,2844,7261,6711,2038,1382,20236
New York,Falconer,2391,170,611,662,142,106,1691
New York,Phelps,1737,86,382,515,121,124,1228
New York,Sandy Creek,789,21,223,214,39,32,529
New York,Bloomfield,1467,66,289,375,236,98,1064
New York,Hoosick Falls,3411,136,984,821,435,130,2506
New York,Albany,97889,6309,14791,15445,11446,11513,59504
New York,Walton,3160,389,809,529,152,170,2049
New York,Sidney,4009,320,1104,678,341,171,2614
New York,Richfield Springs,1075,103,301,207,90,51,752
New York,Milford,380,27,79,87,36,49,278
New York,Cherry Valley,555,17,143,89,81,59,389
New York,Celoron,953,126,318,202,69,34,749
New York,Tuxedo Park,591,8,33,74,187,145,447
New York,Massapequa,21861,575,3646,4010,4301,2808,15340
New York,East Meadow,37358,2315,7459,6874,5688,4542,26878
New York,Balmville,3093,192,749,686,354,244,2225
New York,Washingtonville,5748,282,890,1299,741,495,3707
New York,New York,8443713,1089218,1421617,1195418,1292814,924431,5923498
New York,Middle Island,10216,529,2618,2325,1167,923,7562
New York,Ravena,3228,202,1020,450,305,148,2125
New York,Corinth,2515,238,792,452,134,71,1687
New York,Clayville,247,25,56,50,15,26,172
New York,South Dayton,673,58,181,121,37,27,424
New York,Cattaraugus,959,94,249,164,77,63,647
New York,Wainscott,321,11,31,54,67,66,229
New York,Setauket-East Setauket,13442,268,1298,1986,2467,3402,9421
New York,Old Field,812,10,27,87,147,317,588
New York,Northwest Harbor,3503,38,667,541,997,790,3033
New York,Northville,1455,12,333,435,177,181,1138
New York,Lloyd Harbor,3676,21,255,346,851,1050,2523
New York,Huntington Station,33259,4188,5367,4661,4509,3290,22015
New York,Huntington,17341,401,1655,2450,3939,4260,12705
New York,Clifton Springs,2359,183,644,542,149,139,1657
New York,Fabius,336,10,61,82,37,35,225
New York,Thomaston,2624,86,231,249,495,720,1781
New York,Camillus,1194,46,263,274,154,90,827
New York,Sylvan Beach,832,98,226,179,83,47,633
New York,Sherrill,3031,72,592,919,364,287,2234
New York,Remsen,418,10,167,113,30,2,322
New York,Rockville Centre,24442,785,2918,3108,5066,5058,16935
New York,Plainedge,9206,373,1940,1462,1462,1067,6304
New York,Oyster Bay,6176,449,1216,876,1211,881,4633
New York,Old Brookville,1695,31,100,168,369,428,1096
New York,North Valley Stream,19202,1377,4021,3856,2972,1767,13993
New York,Manhasset,8138,289,1017,1071,1712,1566,5655
New York,Lynbrook,19552,903,3500,4066,3399,2388,14256
New York,Locust Valley,3173,186,538,466,666,326,2182
New York,Levittown,51539,2846,11241,10397,6992,4810,36286
New York,Hicksville,42649,2635,8939,7740,7048,4038,30400
New York,Yorkville,2607,120,555,663,271,139,1748
New York,Deposit,1685,148,532,352,76,38,1146
New York,Searingtown,4547,198,367,647,1015,984,3211
New York,Port Washington North,3209,259,363,407,701,623,2353
New York,North Ballston Spa,1539,153,419,269,185,96,1122
New York,East Greenbush,4611,114,650,891,776,1026,3457
New York,Thornwood,4103,284,506,489,970,541,2790
New York,White Plains,58040,5190,7528,8126,10588,10854,42286
New York,Antwerp,543,34,151,150,21,14,370
New York,Southampton,3263,63,581,560,823,616,2643
New York,Olean,13805,1033,3531,2804,1428,1149,9945
New York,Yorkshire,1191,180,436,264,45,35,960
New York,Schuylerville,1552,88,323,324,173,84,992
New York,Glens Falls,14359,894,3604,2991,1733,1259,10481
New York,Cortland West,1245,76,225,254,228,201,984
New York,Hamburg,9618,128,1329,1843,1844,1482,6626
New York,Harris Hill,5737,114,818,1194,1034,838,3998
New York,Roslyn Harbor,936,7,59,96,190,311,663
New York,Lake Erie Beach,3740,241,1086,896,313,307,2843
New York,Cayuga Heights,3722,34,116,169,495,1599,2413
New York,Westvale,4964,35,671,1231,763,727,3427
New York,Attica,3190,143,672,759,241,107,1922
New York,Gainesville,232,12,74,58,16,1,161
New York,Amsterdam,17927,2140,3851,4112,1058,693,11854
New York,Ames,132,18,27,31,15,9,100
New York,Morrisonville,1386,41,413,296,129,137,1016
New York,Fultonville,595,64,134,111,22,49,380
New York,Duanesburg,435,0,50,117,165,49,381
New York,Fair Haven,882,27,214,172,136,104,653
New York,Rouses Point,2185,180,516,575,177,165,1613
New York,Cohoes,16599,1380,4183,3474,1843,980,11860
New York,Plainview,25902,670,2828,3097,6096,5667,18358
New York,Lancaster,10152,398,2583,2520,1167,591,7259
New York,Harbor Isle,1163,14,166,298,180,184,842
New York,Saddle Rock,758,25,77,103,161,162,528
New York,Greenvale,1705,49,186,257,303,431,1226
New York,Sparkill,1785,73,239,212,387,256,1167
New York,South Lima,239,23,52,55,45,27,202
New York,Smithville Flats,365,20,118,59,16,36,249
New York,Scottsburg,99,0,54,13,11,7,85
New York,Scio,595,23,140,187,29,48,427
New York,Schroon Lake,699,37,134,177,65,97,510
New York,Savannah,596,69,137,120,21,12,359
New York,Sanborn,1132,84,307,283,90,71,835
New York,Salt Point,147,14,61,9,11,23,118
New York,Salisbury Mills,305,14,42,91,26,21,194
New York,St. Regis Falls,452,34,120,105,21,21,301
New York,Rushford,462,58,109,104,14,7,292
New York,Rosendale Hamlet,1078,51,280,317,153,74,875
New York,Romulus,410,22,136,100,7,5,270
New York,Rodman,182,3,68,40,14,16,141
New York,Springwater Hamlet,414,50,91,110,21,15,287
New York,Stony Brook University,8938,77,199,199,316,135,926
New York,Strykersville,681,27,171,162,48,47,455
New York,Sunset Bay,635,70,177,155,57,25,484
New York,Williamson,2561,228,702,517,115,133,1695
New York,West Valley,547,5,101,142,39,35,322
New York,West Chazy,489,35,107,102,84,18,346
New York,Websters Crossing,34,9,14,5,0,0,28
New York,Water Mill,1906,36,366,272,513,454,1641
New York,Watchtower,2147,57,870,584,223,22,1756
New York,Washington Mills,1603,46,255,431,213,136,1081
New York,Rhinecliff,454,14,32,22,83,109,260
New York,Wanakah,2904,69,515,961,452,249,2246
New York,Verona,952,85,241,201,77,0,604
New York,University at Buffalo,6173,0,15,79,164,109,367
New York,Tuscarora,69,0,41,28,0,0,69
New York,Titusville,562,45,68,172,175,59,519
New York,Three Mile Bay,215,14,66,46,20,5,151
New York,Thousand Island Park,64,0,12,34,18,0,64
New York,SUNY Oswego,3746,0,0,13,0,0,13
New York,Wadsworth,341,52,69,19,40,12,192
New York,Willsboro,861,76,276,135,65,90,642
New York,Retsof,171,3,64,22,20,0,109
New York,Prattsville,199,24,71,48,19,3,165
New York,Montrose,3187,58,637,718,631,275,2319
New York,Mineville,1335,200,389,209,121,53,972
New York,Merritt Park,1776,15,198,201,383,391,1188
New York,Marion,1373,125,421,262,131,134,1073
New York,Malden-on-Hudson,291,54,145,0,27,21,247
New York,Madrid,680,36,183,129,63,36,447
New York,Machias,432,12,112,103,11,24,262
New York,Lorraine,107,11,57,11,0,0,79
New York,Long Lake,379,20,65,107,58,34,284
New York,Livonia Center,330,6,60,21,103,57,247
New York,Linwood,85,0,79,0,6,0,85
New York,Lime Lake,845,86,251,160,41,56,594
New York,Lakeville,1002,94,364,176,48,14,696
New York,Kysorville,189,46,28,37,3,3,117
New York,Keuka Park,975,0,33,18,7,93,151
New York,Mountain Lodge Park,1914,291,384,392,166,59,1292
New York,North Creek,592,98,119,129,26,91,463
New York,North Gates,9353,930,2278,2120,1060,571,6959
New York,North Rose,425,58,117,129,14,29,347
New York,Prattsburgh,937,67,286,81,60,49,543
New York,Pottersville,294,0,125,57,25,0,207
New York,Port Gibson,373,36,76,137,26,10,285
New York,Plessis,175,0,48,36,8,0,92
New York,Pine Valley,748,64,273,110,30,36,513
New York,Pike,240,9,64,74,15,6,168
New York,Piffard,284,8,71,98,10,27,214
New York,Pultneyville,660,42,142,117,72,82,455
New York,Pierrepont Manor,204,46,24,0,5,0,75
New York,Paul Smiths,632,0,0,0,0,0,0
New York,Pamelia Center,372,20,53,126,40,51,290
New York,Oxbow,109,28,24,15,2,0,69
New York,Ontario,1817,243,300,603,177,114,1437
New York,Parishville,674,29,102,166,71,48,416
New York,Old Forge,454,44,148,119,33,39,383
New York,Oak Beach-Captree,39,0,0,0,8,31,39
New York,Pavilion,614,12,176,146,87,21,442
New York,Wilmington,819,40,223,162,121,63,609
New York,Winthrop,149,0,30,13,19,42,104
New York,York Hamlet,399,0,180,90,65,25,360
New York,Oakdale,7231,290,1128,1860,992,1089,5359
New York,Montauk,3655,181,710,802,978,298,2969
New York,Melville,17872,676,2170,2946,3671,3870,13333
New York,Orient,782,23,154,205,156,131,669
New York,Mattituck,4704,160,1000,916,882,718,3676
New York,Lindenhurst,27053,1796,6858,5863,2896,1863,19276
New York,Hauppauge,19580,479,3338,3638,3809,2787,14051
New York,Great River,1373,13,186,174,232,316,921
New York,West Glens Falls,7005,335,1786,1549,433,768,4871
New York,Stillwater,1954,90,373,532,160,90,1245
New York,Fort Edward,3307,310,824,798,242,52,2226
New York,Flanders,4787,418,978,809,359,294,2858
New York,Shinnecock Hills,2502,90,494,245,580,469,1878
New York,South Huntington,10000,399,1919,1835,1878,1347,7378
New York,Riverhead,14067,2008,3788,2691,1055,750,10292
New York,Quogue,803,10,63,111,177,251,612
New York,Ridge,13511,926,3973,2958,1067,1337,10261
New York,Ronkonkoma,18302,635,4093,3939,2568,1629,12864
New York,Bedford,2074,43,168,213,460,478,1362
New York,Sharon Springs,539,57,117,121,59,25,379
New York,Sherman,752,65,180,131,61,20,457
New York,Farnham,474,34,114,133,49,13,343
New York,Sherburne,1414,114,334,306,158,133,1045
New York,Town Line,1764,54,439,506,209,106,1314
New York,Medford,24247,1509,5381,5136,3154,1636,16816
New York,Bohemia,9293,471,2188,1869,902,836,6266
New York,North Lindenhurst,10584,980,2638,2448,962,473,7501
New York,Holley,1743,161,410,502,87,54,1214
New York,Milton CDP (Ulster County),1371,52,242,323,215,179,1011
New York,Lake Mohegan,6013,236,1019,1145,1083,689,4172
New York,Jefferson Valley-Yorktown,14441,484,2195,2308,2500,2666,10153
New York,Harrison,27956,1139,3125,3193,4999,4045,16501
New York,Greenville CDP (Greene County),597,52,89,140,102,50,433
New York,Catskill,3861,472,1307,637,352,175,2943
New York,Spencer,782,65,205,168,68,36,542
New York,Greenwich,1962,70,401,349,231,172,1223
New York,Margaretville,543,67,133,166,36,51,453
New York,Hancock,1070,139,375,193,39,27,773
New York,Franklin,399,13,48,123,39,52,275
New York,Lake Luzerne,977,175,124,269,133,42,743
New York,Beaver Dam Lake,1654,38,272,357,312,184,1163
New York,Port Henry,1114,118,354,248,85,72,877
New York,Macedon,1984,180,426,482,247,183,1518
New York,Herrings,112,9,52,31,0,9,101
New York,Hermon,403,45,86,123,24,13,291
New York,Barneveld,319,0,50,58,77,43,228
New York,Limestone,492,24,112,113,30,4,283
New York,Salem,690,39,189,135,63,71,497
New York,Forestville,828,22,233,169,44,28,496
New York,Prospect,319,16,65,95,33,14,223
New York,Lyons,3414,263,926,894,95,190,2368
New York,Altmar,442,64,135,46,5,4,254
New York,Worcester,949,110,165,175,120,63,633
New York,Woodsville,105,9,31,21,0,8,69
New York,Witherbee,267,20,53,113,0,0,186
New York,Keeseville,2971,251,919,663,220,80,2133
New York,Island Park,4807,253,1615,936,449,421,3674
New York,Loch Sheldrake,1236,132,198,149,107,90,676
New York,Quiogue,844,33,185,210,107,37,572
New York,Round Lake,736,18,140,127,188,111,584
New York,Yonkers,199745,25034,34630,33361,25750,19649,138424
New York,Shrub Oak,2452,151,306,416,527,478,1878
New York,Bridgewater,529,35,124,113,26,11,309
New York,Wells,654,27,148,181,34,90,480
New York,Virgil,495,21,115,78,53,22,289
New York,Thendara,66,0,38,28,0,0,66
New York,Niskayuna,4882,6,444,734,936,1105,3225
New York,Taconic Shores,627,35,181,90,108,66,480
New York,Edwards,448,26,113,94,29,8,270
New York,Copake Hamlet,221,8,57,27,65,53,210
New York,Copake Falls,303,0,154,47,0,7,208
New York,Seneca Falls,6032,452,1517,1171,882,406,4428
New York,Perrysburg,395,49,125,70,3,37,284
New York,East Randolph,519,18,93,152,7,20,290
New York,Mastic Beach,11953,990,3382,2367,931,430,8100
New York,Randolph,1189,102,316,271,77,73,839
New York,Lyndonville,724,46,193,161,44,34,478
New York,Heritage Hills,4176,120,652,1069,1219,868,3928
New York,Laurel,1080,58,198,191,79,243,769
New York,North Boston,2835,15,627,1058,290,241,2231
New York,Dunkirk,11950,1149,3364,2447,707,538,8205
New York,Panama,412,18,128,97,11,14,268
New York,Croghan,621,53,168,131,41,53,446
New York,Lowville,3225,205,787,676,316,251,2235
New York,Montour Falls,1774,171,487,405,122,75,1260
New York,Lodi,351,29,98,70,19,34,250
New York,Waterloo,4959,369,1452,1242,386,210,3659
New York,Alfred,4317,2,23,102,125,203,455
New York,Canaseraga,524,22,156,134,32,22,366
New York,Houghton,1761,19,114,65,151,230,579
New York,Islandia,3345,243,701,801,402,178,2325
New York,East Hampton,1034,45,125,165,266,273,874
New York,Dering Harbor,0,0,0,0,0,0,0
New York,Commack,36936,839,5583,6417,7075,5777,25691
New York,Gowanda,2820,240,817,639,137,178,2011
New York,Clarence Center,3125,9,275,355,860,573,2072
New York,Angola,2199,109,563,520,226,118,1536
New York,Voorheesville,2806,27,332,508,516,505,1888
New York,Coxsackie,2685,247,675,644,208,101,1875
New York,Hunter,478,33,140,153,78,48,452
New York,Glasco,2615,289,524,751,190,141,1895
New York,Kingston,23210,2369,5319,4268,2554,2005,16515
New York,Plattekill,969,185,131,113,99,52,580
New York,Tillson,1653,126,184,336,325,219,1190
New York,Saranac Lake,5552,309,917,1473,705,665,4069
New York,Calverton,7154,561,2255,2042,593,369,5820
New York,Albion,5439,821,1443,1175,246,82,3767
New York,Baywood,7389,575,1893,1624,643,254,4989
New York,Brightwaters,3069,46,359,447,689,631,2172
New York,Brookhaven,3531,384,578,641,438,428,2469
New York,East Patchogue,22637,2089,5298,4633,2358,1865,16243
New York,Westmere,7001,116,947,1465,1100,1189,4817
New York,Melrose Park,2330,111,274,552,349,302,1588
New York,Meridian,327,18,46,85,30,15,194
New York,Medina,5839,491,1392,1541,537,315,4276
New York,Fairview CDP (Westchester County),3194,352,675,647,191,170,2035
New York,Bay Shore,30685,3311,5104,5136,3390,3152,20093
New York,Granville,2450,223,712,601,123,146,1805
New York,Nelsonville,699,15,122,72,122,123,454
New York,Cheektowaga,74026,4168,19625,18321,8085,4778,54977
New York,Sackets Harbor,1654,54,231,305,374,215,1179
New York,Redwood,624,56,184,111,21,5,377
New York,Delhi,3178,96,358,256,216,297,1223
New York,High Falls,664,44,202,204,65,23,538
New York,Carthage,3473,171,798,874,91,145,2079
New York,Black River,1210,25,235,287,161,114,822
New York,Ellicottville,283,14,63,63,44,36,220
New York,Cragsmoor,359,9,49,48,93,91,290
New York,Stony Brook,12641,210,975,1863,2535,3140,8723
New York,Shelter Island Heights,1049,0,57,132,260,320,769
New York,Rocky Point,12902,580,2474,2617,1566,1441,8678
New York,Poquott,992,22,54,109,193,314,692
New York,Salamanca,5553,516,1421,960,308,152,3357
New York,Rye Brook,9459,521,767,951,2179,2143,6561
New York,Tuckahoe,6587,331,624,1196,1157,1350,4658
New York,Elma Center,3043,88,627,526,486,490,2217
New York,Middleport,1783,79,447,475,86,65,1152
New York,Copake Lake,580,55,234,47,27,112,475
New York,Newport,531,33,90,169,41,40,373
New York,Little Falls,4735,342,1238,826,487,387,3280
New York,Warrensburg,3193,343,784,783,267,109,2286
New York,Skaneateles,2411,10,150,395,593,652,1800
New York,Lakeland,2517,141,775,593,296,149,1954
New York,Shortsville,1275,86,302,386,144,48,966
New York,Victory,604,58,175,113,35,15,396
New York,Preston-Potter Hollow,289,22,125,30,30,9,216
New York,Hillcrest,7418,944,1121,1511,1082,471,5129
New York,Peekskill,24008,3540,4788,3664,2794,1736,16522
New York,Mount Vernon,68035,7483,13673,12705,7970,5605,47436
New York,Mamaroneck,19213,1671,2572,2349,3602,3356,13550
New York,Carmel Hamlet,6345,306,1181,1274,965,865,4591
New York,North Hornell,768,22,203,163,114,135,637
New York,Avoca,960,47,270,216,103,40,676
New York,Mount Ivy,6925,588,1062,1487,1033,450,4620
New York,Westhampton Beach,1653,38,303,259,340,375,1315
New York,Leeds,433,58,43,51,108,8,268
New York,Dansville,4572,483,1086,918,222,303,3012
New York,Garden City South,4322,143,771,653,591,776,2934
New York,East Massapequa,18331,687,3644,3490,3347,2158,13326
New York,Cedarhurst,6661,157,945,786,839,970,3697
New York,Baldwin,25134,1637,3768,5229,3964,2437,17035
New York,Atlantic Beach,1398,27,193,291,327,283,1121
New York,Pleasantville,7214,378,505,972,1140,1634,4629
New York,Larchmont,6092,34,113,438,1236,1938,3759
New York,Chittenango,4920,157,965,1226,554,396,3298
New York,Centre Island,472,9,40,56,124,124,353
New York,Mount Kisco,10894,1330,1499,1458,1594,1892,7773
New York,Bronxville,6394,103,280,350,1226,1876,3835
New York,Briarcliff Manor,7697,222,505,739,1636,2086,5188
New York,Oakfield,1749,109,468,423,105,73,1178
New York,Tannersville,992,35,292,112,145,81,665
New York,Glens Falls North,8807,251,1755,2064,1101,1103,6274
New York,Great Neck,10203,648,1201,1135,1619,1705,6308
New York,Kings Point,5187,287,576,502,922,726,3013
New York,Lido Beach,3009,94,251,298,686,913,2242
New York,Matinecock,897,12,40,52,277,166,547
New York,North Babylon,16739,755,4168,3667,1970,1430,11990
New York,North Bellport,11593,1377,2492,2135,656,470,7130
New York,Ocean Beach,24,0,3,11,2,8,24
New York,Endicott,12872,1073,3175,2729,1058,595,8630
New York,Endwell,11641,508,1933,2792,1942,1262,8437
New York,Brewster Hill,1945,151,452,414,341,101,1459
New York,Wyoming,383,13,88,107,37,18,263
New York,East Marion,954,53,207,233,178,142,813
New York,Seaford,15113,317,2462,2961,2742,1924,10406
New York,Nelliston,565,63,169,114,33,21,400
New York,Mannsville,351,15,95,82,19,22,233
New York,Menands,3946,89,269,501,926,772,2557
New York,East Nassau,602,23,132,122,75,46,398
New York,North Merrick,12232,364,1427,2162,2205,2039,8197
New York,Munsey Park,2719,14,129,93,717,773,1726
New York,Mill Neck,1011,15,70,102,291,251,729
New York,Firthcliffe,5178,185,893,856,853,799,3586
New York,Nunda,1231,127,325,252,77,72,853
New York,East Farmingdale,6143,292,1436,1013,679,424,3844
New York,Freeport,43128,5607,8688,6510,5055,3338,29198
New York,Roscoe,546,13,164,80,69,89,415
New York,Narrowsburg,338,29,50,89,70,29,267
New York,Central Square,1855,75,558,396,240,112,1381
New York,Johnstown,8307,548,1829,1973,848,570,5768
New York,Tarrytown,11459,698,1241,1650,2089,2658,8336
New York,Scotts Corners,704,9,89,56,154,241,549
New York,Rye,15862,454,811,1350,3730,3675,10020
New York,Amenia,1107,260,213,164,116,45,798
New York,Brinckerhoff,2430,127,467,571,405,270,1840
New York,Dover Plains,1016,197,266,199,82,17,761
New York,Lake Grove,11130,429,2117,2337,1710,1380,7973
New York,Fairview CDP (Dutchess County),5332,389,752,1192,461,426,3220
New York,Millerton,871,101,178,222,149,41,691
New York,Staatsburg,403,0,124,77,87,56,344
New York,Avon,3261,76,662,730,434,403,2305
New York,Gardnertown,5200,450,1114,1050,380,368,3362
New York,Otisville,1255,80,206,315,128,99,828
New York,Port Jervis,8614,992,2401,1845,682,433,6353
New York,Manorville,14405,559,2651,3030,1628,1509,9377
New York,Floral Park,16209,686,2111,2801,3303,2538,11439
New York,Mechanicville,5144,277,1222,1301,567,143,3510
New York,Cooperstown,1886,49,206,384,337,567,1543
New York,Fire Island,249,34,31,50,25,28,168
New York,Shoreham,437,13,38,76,44,156,327
New York,Shirley,28698,2630,7103,5175,1886,1592,18386
New York,Shelter Island,1695,61,301,183,319,356,1220
New York,Garden City,22533,215,1348,1986,5622,5177,14348
New York,St. James,13155,492,1995,2369,1984,2366,9206
New York,Port Jefferson Station,7808,390,1300,1756,1124,1021,5591
New York,North Great River,3934,206,960,850,584,258,2858
New York,Mount Sinai,11529,632,1665,2361,1758,1592,8008
New York,Moriches,3277,234,528,952,292,465,2471
New York,Islip Terrace,5529,227,1269,1090,625,396,3607
New York,Islip,17921,1086,3718,3233,2629,1860,12526
New York,Huntington Bay,1366,7,87,193,408,355,1050
New York,Remsenburg-Speonk,1974,33,513,401,358,253,1558
New York,Lattingtown,1827,52,167,223,495,386,1323
New York,Westhampton,2898,110,473,515,515,403,2016
New York,Smithtown,26298,896,3713,4802,4742,4371,18524
New York,Malone,5694,704,1454,923,472,384,3937
New York,Chateaugay,729,56,194,182,51,60,543
New York,Lake George,1034,106,229,283,116,86,820
New York,Hudson Falls,7133,416,1972,1901,456,267,5012
New York,Cambridge,1806,141,432,242,239,207,1261
New York,Woodstock,2135,53,373,444,571,271,1712
New York,Waterford,2091,197,452,466,334,99,1548
New York,West Hurley,1871,84,429,331,239,481,1564
New York,Wallkill,2050,76,538,459,245,153,1471
New York,Stone Ridge,1156,37,236,234,183,159,849
New York,Saugerties South,1825,96,407,515,210,147,1375
New York,Port Ewen,3442,155,926,940,330,244,2595
New York,Napanoch,1004,16,336,265,97,38,752
New York,Accord,521,46,164,79,45,28,362
New York,Athens,1559,112,459,398,131,131,1231
New York,Aquebogue,1690,27,459,342,255,324,1407
New York,Bridgehampton,1322,76,213,198,307,207,1001
New York,Little Valley,1180,121,399,209,56,20,805
New York,Centerport,5251,84,534,888,1098,1205,3809
New York,Allegany,1922,42,265,305,214,251,1077
New York,Sag Harbor,2184,140,376,324,546,420,1806
New York,Franklinville,1575,130,395,342,96,86,1049
New York,Hillside,831,64,121,150,91,212,638
New York,North Collins,1226,102,304,243,82,56,787
New York,East Atlantic Beach,1971,25,295,301,420,457,1498
New York,Malverne Park Oaks,458,0,17,151,50,86,304
New York,Phoenicia,249,21,46,62,23,85,237
New York,Oceanside,31185,987,5597,5067,5683,4518,21852
New York,Baxter Estates,1065,63,127,116,267,250,823
New York,Stannards,586,26,150,144,70,80,470
New York,Laurens,180,6,41,57,22,4,130
New York,Natural Bridge,306,54,100,117,0,0,271
New York,Brownville,1047,67,270,185,127,85,734
New York,West Babylon,42918,3270,10877,8463,4710,2961,30281
New York,Dix Hills,26819,614,2788,3648,5389,6184,18623
New York,Angola on the Lake,1819,121,533,480,162,70,1366
New York,Northampton,603,31,105,136,80,141,493
New York,Verplanck,1310,54,355,232,172,86,899
New York,Unionville,724,49,172,149,60,59,489
New York,East Rockaway,9802,325,1762,1769,1662,1594,7112
New York,Bellmore,15730,682,2160,2415,3315,2687,11259
New York,Bellerose,1178,27,108,141,253,255,784
New York,Barnum Island,2247,290,528,568,257,258,1901
New York,Munsons Corners,2998,184,603,368,363,238,1756
New York,McGraw,879,80,262,221,34,45,642
New York,Bay Park,1614,38,448,320,182,84,1072
New York,Village Green,3810,172,738,1094,592,305,2901
New York,Fairmount,9997,316,2168,2318,1443,1141,7386
New York,Whitesboro,3665,208,996,852,402,204,2662
New York,Vernon,1138,73,281,313,118,61,846
New York,New Hartford,1731,25,238,366,312,305,1246
New York,Williamsville,5247,81,605,920,1210,1164,3980
New York,Northwest Ithaca,1289,86,238,223,189,318,1054
New York,Woodridge,819,50,143,172,52,35,452
New York,Garden City Park,8081,442,1503,1305,1612,1076,5938
New York,Canajoharie,1863,196,510,372,117,101,1296
New York,Duane Lake,260,0,38,32,54,44,168
New York,East Glenville,6371,189,1063,1483,962,863,4560
New York,Newburgh,28282,4300,5675,3388,1307,1029,15699
New York,Montgomery,4537,327,1028,746,636,286,3023
New York,Wurtsboro,1104,73,272,242,117,75,779
New York,Smallwood,615,70,120,74,107,51,422
New York,Monroe,8578,692,1047,1412,1230,876,5257
New York,Liberty,4136,678,927,873,166,150,2794
New York,Minetto,1047,32,193,221,191,161,798
New York,Washington Heights,2337,19,427,564,168,227,1405
New York,Lacona,741,36,186,169,58,41,490
New York,Highland Falls,3827,136,641,660,697,578,2712
New York,Goshen,5354,222,883,902,879,694,3580
New York,Monticello,6476,797,1589,1364,596,230,4576
New York,Mexico,1569,69,382,368,145,103,1067
New York,Cleveland,679,31,214,180,35,31,491
New York,Northville,1212,53,258,279,67,70,727
New York,Scotia,7715,257,1559,1702,1122,644,5284
New York,Maybrook,3368,227,624,921,352,244,2368
New York,Sound Beach,8093,282,1373,1642,1747,896,5940
New York,Argyle,555,32,165,79,42,39,357
New York,Sayville,16007,877,2702,2728,2617,2531,11455
New York,Carle Place,4867,430,941,875,830,507,3583
New York,Bethpage,17215,829,3450,2738,3655,1974,12646
New York,Bayville,6708,189,1276,1292,1065,1162,4984
New York,Oxford,1430,85,317,314,112,140,968
New York,Rensselaer,9290,737,2320,1574,1044,861,6536
New York,Averill Park,1330,127,157,410,151,130,975
New York,Zena,1119,14,169,202,240,220,845
New York,Shokan,1200,120,203,200,209,121,853
New York,Hurley,3152,85,486,836,516,510,2433
New York,Gardiner,698,16,93,194,67,211,581
New York,Ellenville,4043,518,749,757,209,253,2486
New York,Red Oaks Mill,3202,119,529,832,406,516,2402
New York,Kennedy,363,50,117,98,0,19,284
New York,Pawling,2085,131,521,343,234,256,1485
New York,Crown Heights,2834,108,455,685,499,196,1943
New York,Rifton,231,0,28,126,28,28,210
New York,Saugerties,3872,258,783,856,504,323,2724
New York,Walker Valley,1215,0,316,216,122,45,699
New York,Geneva,12888,967,2073,2067,1037,899,7043
New York,Selden,19770,1195,4493,4404,2108,1394,13594
New York,Riverside,3151,678,1075,667,178,15,2613
New York,Port Jefferson,7871,223,957,1383,953,2418,5934
New York,North Haven,919,10,121,116,236,217,700
New York,North Bay Shore,21045,3437,3937,3318,1019,589,12300
New York,Mastic,14678,1365,3754,2530,962,453,9064
New York,Lake Ronkonkoma,20780,1133,4744,4402,2214,1641,14134
New York,Poland,385,15,73,88,56,18,250
New York,Jamesport,1085,41,268,176,228,146,859
New York,Cayuga,489,30,119,134,42,29,354
New York,Aurora,655,13,40,51,45,85,234
New York,Sloan,3584,384,923,895,350,92,2644
New York,Green Island,2591,191,716,588,264,67,1826
New York,Wellsville,4466,387,1018,1105,373,334,3217
New York,Cuba,1534,73,381,359,142,100,1055
New York,Bolivar,965,93,280,210,46,67,696
New York,Weedsport,1846,124,395,503,155,95,1272
New York,Wading River,8034,278,1270,1650,1253,1334,5785
New York,Palenville,897,24,117,193,151,117,602
New York,Cairo,1015,96,158,389,71,34,748
New York,Ballston Spa,5443,296,984,1312,872,456,3920
New York,Fleischmanns,214,34,48,19,13,42,156
New York,Speculator,348,90,83,99,17,18,307
New York,West Carthage,1511,131,337,322,138,110,1038
New York,Hammond,242,29,54,65,9,19,176
New York,Harrisville,613,42,170,128,65,19,424
New York,Clinton,1636,19,150,265,285,438,1157
New York,Alden,2580,64,654,693,284,183,1878
New York,Sodus Point,893,31,266,259,91,95,742
New York,Hillside Lake,1045,29,168,297,73,106,673
New York,Churchville,2230,77,294,584,369,268,1592
New York,West Nyack,3876,53,621,885,574,679,2812
New York,Cold Brook,344,13,111,48,17,6,195
New York,Chatham,1655,103,273,452,200,232,1260
New York,Spencerport,3620,31,684,777,666,419,2577
New York,Milton CDP (Saratoga County),3111,49,511,554,633,508,2255
New York,Hewlett Neck,456,1,21,29,96,130,277
New York,Jericho,13827,384,918,1613,3518,3373,9806
New York,Lawrence,6535,46,147,770,1306,1737,4006
New York,Newark Valley,1095,41,206,227,91,66,631
New York,Apalachin,1146,60,425,214,128,35,862
New York,West Hampton Dunes,69,0,0,12,24,21,57
New York,Bergen,1118,20,212,280,139,81,732
New York,Whitney Point,908,94,219,150,80,64,607
New York,Binghamton,45503,4383,9102,8482,3947,3391,29305
New York,Norwood,1624,107,373,431,128,144,1183
New York,Haviland,3246,177,701,798,481,270,2427
New York,Livonia,1361,33,196,327,183,163,902
New York,Sinclairville,797,75,208,130,47,45,505
New York,Jamestown West,2512,202,448,608,345,337,1940
New York,North Hills,5639,76,634,818,1357,2024,4909
New York,New Cassel,14648,2459,2784,1863,1341,713,9160
New York,Mineola,19132,1330,3538,3585,3330,2596,14379
New York,Merrick,19966,538,2205,2839,4208,4323,14113
New York,Manorhaven,6620,272,841,868,1241,1106,4328
New York,Castorland,365,37,89,71,27,4,228
New York,Katonah,1895,0,119,83,490,537,1229
New York,Westmoreland,787,0,67,225,46,45,383
New York,Hunt,109,25,33,13,2,0,73
New York,Northport,7348,87,840,1263,1959,1326,5475
New York,North Patchogue,7561,483,1675,1751,873,337,5119
New York,Napeague,112,0,18,31,13,26,88
New York,West Islip,27149,1048,5159,5427,3828,3602,19064
New York,Eastport,2091,65,316,492,319,350,1542
New York,Cutchogue,3178,83,394,802,615,442,2336
New York,Brentwood,62942,11947,13998,8268,3707,1634,39554
New York,Greenlawn,13978,867,2017,2434,2319,1761,9398
New York,Wyandanch,11612,1383,2801,1782,681,373,7020
New York,Old Bethpage,5522,139,674,705,1178,1173,3869
New York,North Lynbrook,417,21,82,79,49,70,301
New York,Muttontown,3655,48,318,352,866,1077,2661
New York,Long Beach,33509,1421,5752,5903,6490,6117,25683
New York,Laurel Hollow,1993,28,139,134,366,554,1221
New York,Great Neck Plaza,6957,355,881,1205,1767,1648,5856
New York,Bainbridge,1442,76,263,291,157,116,903
New York,Schoharie,850,89,266,169,56,57,637
New York,Esperance,394,6,104,123,15,18,266
New York,North Wantagh,11802,485,2271,2404,2007,1486,8653
New York,Cobleskill,4540,266,758,465,407,294,2190
New York,Armonk,4381,78,136,410,1008,1217,2849
New York,Dobbs Ferry,11027,277,1175,1383,2025,2608,7468
New York,Northeast Ithaca,2881,29,157,209,541,888,1824
New York,Hammondsport,492,4,90,153,93,40,380
New York,Cohocton,899,59,196,213,40,54,562
New York,Warsaw,3300,332,813,1012,198,145,2500
New York,Syracuse,143293,15845,23196,23513,12853,10852,86259
New York,Marcellus,1893,38,314,447,319,215,1333
New York,Tully,1057,87,164,212,130,108,701
New York,Wayland,1810,143,554,374,91,115,1277
New York,Crompond,2307,63,290,378,415,382,1528
New York,South Corning,1157,66,287,280,138,104,875
New York,Albertson,5254,271,653,780,985,1060,3749
New York,Cortland,18828,979,3096,3265,1600,1191,10131
New York,Earlville,1153,78,285,206,97,91,757
New York,Cazenovia,2853,100,381,366,349,278,1474
New York,Valley Stream,37609,2466,5817,7619,5820,4172,25894
New York,Sea Cliff,5051,123,446,816,1064,1230,3679
New York,Baiting Hollow,1654,11,345,350,221,398,1325
New York,Asharoken,443,0,32,67,123,117,339
New York,Bath,5572,445,1898,1219,369,306,4237
New York,Westfield,2982,384,636,634,257,291,2202
New York,Lakewood,2872,63,538,733,384,397,2115
New York,Cassadaga,516,17,160,150,40,43,410
New York,Deferiet,300,16,49,73,26,9,173
New York,Clayton,2018,47,471,576,189,160,1443
New York,Weston Mills,1384,95,493,297,74,81,1040
New York,Colonie,7793,464,1429,1972,1140,823,5828
New York,Union Springs,1170,59,262,289,69,77,756
New York,Wynantskill,3328,147,590,1060,282,219,2298
New York,Victor,2733,117,327,598,476,427,1945
New York,Beacon,14279,837,2908,3046,2130,1527,10448
New York,Depauville,382,31,134,116,0,17,298
New York,Middleville,570,48,166,94,39,25,372
New York,Herkimer,6899,674,1689,1798,362,313,4836
New York,Dolgeville,2581,154,608,595,79,221,1657
New York,Heuvelton,719,38,214,177,34,46,509
New York,Pomona,2955,144,283,481,590,588,2086
New York,New City,34652,1232,3829,5372,7656,6593,24682
New York,Montebello,4616,55,600,406,861,1279,3201
New York,Kaser,5179,470,638,264,15,21,1408
New York,Haverstraw,12081,2077,2097,1908,1125,472,7679
New York,Schaghticoke,647,67,167,164,26,26,450
New York,Evans Mills,472,48,97,127,39,23,334
New York,Odessa,504,26,141,115,52,51,385
New York,Watkins Glen,2016,189,443,487,192,111,1422
New York,Richburg,450,19,145,95,9,7,275
New York,Dundee,1624,115,479,330,118,73,1115
New York,Shenorock,2179,60,338,527,313,206,1444
New York,Mahopac,8426,531,1389,1646,1304,1027,5897
New York,Rapids,1198,66,310,137,177,79,769
New York,Arcade,2182,168,612,407,149,109,1445
New York,Pelham,6949,420,916,759,1091,1384,4570
New York,Croton-on-Hudson,8183,377,676,1130,1405,1858,5446
New York,Ardsley,4534,64,581,535,901,1156,3237
New York,West Hills,5338,144,570,901,1323,991,3929
New York,Lansing,3535,292,285,283,515,1215,2590
New York,Groton,2050,146,423,586,208,90,1453
New York,Burdett,437,14,115,84,65,39,317
New York,West Seneca,45332,1960,10270,11380,6397,3783,33790
New York,Orchard Park,3154,23,416,429,743,719,2330
New York,Lackawanna,17859,2085,4474,3427,1069,654,11709
New York,Holland,1190,68,325,320,150,0,863
New York,Belmont,807,43,217,169,67,71,567
New York,Interlaken,591,47,116,121,69,65,418
New York,Schenectady,65482,7086,15138,12731,6253,3540,44748
New York,Chestnut Ridge,8057,408,1284,1205,1085,1120,5102
New York,Fulton,11419,1016,2762,2532,789,531,7630
New York,Jeffersonville,363,18,82,91,30,33,254
New York,Scotchtown,9174,518,1560,2613,832,518,6041
New York,Spring Valley,32281,5316,5282,4969,1930,1037,18534
New York,Orangeburg,4200,201,504,565,802,682,2754
New York,Nanuet,17775,1255,2592,3350,3744,2094,13035
New York,Grand View-on-Hudson,307,1,15,27,99,102,244
New York,Germantown,898,33,138,281,129,80,661
New York,Claverack-Red Mills,543,18,63,130,37,129,377
New York,Spackenkill,4239,97,545,751,851,687,2931
New York,Harriman,2926,152,521,599,418,203,1893
New York,Pleasant Valley,1367,93,354,303,143,181,1074
New York,Caledonia,2102,132,476,606,201,90,1505
New York,Wellsburg,518,46,152,110,46,2,356
New York,Horseheads,6510,407,1347,1521,764,536,4575
New York,Elmira Heights,4032,305,1041,907,353,207,2813
New York,Palmyra,3383,289,758,744,318,221,2330
New York,Star Lake,802,109,229,180,38,44,600
New York,Suffern,10926,621,1789,2187,1743,1641,7981
New York,Pearl River,16495,840,2053,2998,2942,2431,11264
New York,Lima,2369,122,346,604,250,193,1515
New York,Nyack,7188,647,960,1055,1323,1447,5432
New York,Kiryas Joel,23536,2107,2525,1015,326,15,5988
New York,Waterville,1598,58,445,304,239,119,1165
New York,West Bay Shore,4853,121,768,830,744,900,3363
New York,Cape Vincent,652,14,159,136,88,50,447
New York,Mooers,420,33,86,207,37,17,380
New York,Stewart Manor,2191,64,283,335,490,409,1581
New York,Holbrook,26286,1058,5568,5498,3619,2822,18565
New York,Gordon Heights,3667,285,779,662,229,214,2169
New York,Fort Salonga,9776,178,1239,1683,1894,1868,6862
New York,Fishers Island,183,6,99,2,36,25,168
New York,Orange Lake,6348,159,1183,1731,1200,513,4786
New York,Farmingville,15495,856,3389,3680,1835,1002,10762
New York,East Moriches,5359,128,1109,1317,415,718,3687
New York,Scarsdale,17805,202,436,565,3396,6733,11332
New York,Port Chester,29418,5635,5074,3743,3526,1786,19764
New York,Pelham Manor,5595,68,385,239,1180,1446,3318
New York,Lockport,20580,1615,4206,5590,1829,1143,14383
New York,Gasport,1520,40,433,356,80,47,956
New York,Painted Post,1727,63,268,317,243,282,1173
New York,Gang Mills,4495,100,443,691,762,922,2918
New York,Hamilton,3860,51,241,231,205,513,1241
New York,Greece,14826,1067,3785,3684,1680,1006,11222
New York,Rhinebeck,2583,164,432,483,421,564,2064
New York,Millbrook,1421,112,167,330,257,214,1080
New York,Constableville,287,16,89,77,14,9,205
New York,Fredonia,10637,64,1699,1309,1278,1275,5625
New York,Cherry Creek,481,18,126,112,29,15,300
New York,Silver Springs,875,117,305,150,21,11,604
New York,West Hempstead,20116,1205,3300,3615,2858,2387,13365
New York,University Gardens,4202,168,445,502,1012,863,2990
New York,Uniondale,31828,4205,5414,4501,2774,2273,19167
New York,Russell Gardens,932,39,54,70,215,308,686
New York,Copenhagen,765,37,174,185,40,43,479
New York,Roosevelt,16229,2500,3710,2600,1194,663,10667
New York,Oyster Bay Cove,2170,21,137,259,551,612,1580
New York,Roslyn,2852,65,329,300,761,840,2295
New York,North Amityville,18817,2404,4575,2668,1514,764,11925
New York,New Suffolk,212,6,24,61,57,37,185
New York,Nesconset,13893,416,1926,2174,2685,2309,9510
New York,Whitehall,2274,263,765,417,82,20,1547
New York,Dresden,331,15,84,75,25,17,216
New York,Livingston Manor,1223,252,220,169,90,6,737
New York,Port Washington,15600,502,1481,1784,3677,3536,10980
New York,Lyons Falls,543,33,200,104,33,26,396
New York,Middleburgh,1521,115,351,425,125,117,1133
New York,Palatine Bridge,637,52,196,149,67,47,511
New York,Port Dickinson,1812,33,361,454,196,169,1213
New York,Mohawk,2578,147,723,504,197,136,1707
New York,Lisle,215,15,85,46,5,2,153
New York,Le Roy,4220,193,999,956,397,284,2829
New York,Johnson City,14575,990,3293,3133,1442,884,9742
New York,Glen Cove,27226,3708,5148,3042,3883,3196,18977
New York,Troy,49610,3847,8984,9937,4839,3037,30644
New York,Nassau,1048,48,215,281,147,79,770
New York,Dexter,1022,84,233,229,44,42,632
New York,Nichols,601,29,153,159,31,32,404
New York,Webster,5565,317,788,1298,803,690,3896
New York,Honeoye Falls,2742,65,324,572,426,444,1831
New York,Brockport,8350,276,868,945,763,511,3363
New York,Stottville,1359,165,320,155,93,87,820
New York,Hudson,6339,724,1440,1191,704,546,4605
New York,Elba,645,24,142,161,49,45,421
New York,Fort Plain,1739,185,505,427,112,53,1282
New York,Ithaca,30568,721,1726,1729,3006,4311,11493
New York,Richmondville,869,74,226,207,54,59,620
New York,Hannibal,511,22,161,121,38,14,356
New York,Blauvelt,5620,150,627,676,1102,888,3443
New York,Scottsville,2014,87,334,459,275,261,1416
New York,Irondequoit,50427,2705,10874,11051,8065,5187,37882
New York,West Elmira,4827,97,697,1038,903,992,3727
New York,Van Etten,678,28,153,170,51,8,410
New York,Elmira,27695,2798,7159,5096,1483,1091,17627
New York,Newark,8937,787,2110,2251,709,455,6312
New York,Rensselaer Falls,361,24,62,77,15,28,206
New York,Gouverneur,3751,276,1127,907,103,164,2577
New York,Viola,6917,465,712,743,681,889,3490
New York,South Nyack,3517,85,427,413,614,684,2223
New York,Mount Morris,2757,240,645,641,187,209,1922
New York,New Square,8133,718,1133,384,86,8,2329
New York,Malverne,8535,291,1303,1449,1843,1398,6284
New York,Lake Success,3102,225,441,279,670,675,2290
New York,Hewlett Harbor,1090,3,80,95,305,281,764
New York,Hewlett Bay Park,366,9,22,52,78,97,258
New York,Ransomville,1601,54,307,436,151,91,1039
New York,North Tonawanda,30596,1692,7737,7849,3445,2293,23016
New York,Niagara Falls,48661,4095,12717,10353,3399,2699,33263
New York,Kensington,1184,27,88,91,237,402,845
New York,Plandome,1251,7,35,84,332,341,799
New York,Ilion,7852,388,1843,1744,620,624,5219
New York,Corfu,707,39,202,172,68,53,534
New York,Ogdensburg,10748,1275,3035,2372,852,452,7986
New York,Brocton,1319,107,416,322,87,87,1019
New York,Freeville,394,19,47,92,115,54,327
New York,Bemus Point,301,25,35,97,67,30,254
New York,Redford,361,14,118,48,14,19,213
New York,Cumberland Head,1395,71,258,310,230,287,1156
New York,Au Sable Forks,426,49,137,111,14,3,314
New York,Port Byron,1006,94,309,209,39,23,674
New York,Putnam Lake,3519,265,837,649,532,285,2568
New York,Sodus,1687,122,458,368,68,43,1059
New York,Lake Carmel,8114,459,2027,1601,1221,688,5996
New York,Riverside,514,28,203,126,24,11,392
New York,Hornell,8308,636,2413,1470,553,376,5448
New York,Addison,1753,70,442,405,93,84,1094
New York,Miller Place,11755,175,1514,2235,1721,1715,7360
New York,Geneseo,8096,263,412,544,383,541,2143
New York,Big Flats,5212,153,681,1491,886,611,3822
New York,Clyde,2111,232,465,398,64,71,1230
New York,Waddington,938,33,279,178,130,105,725
New York,Cold Spring,1862,48,207,363,426,425,1469
New York,Frankfort,2376,177,528,642,208,160,1715
New York,Chappaqua,1459,0,74,85,429,438,1026
New York,Wheatley Heights,4921,178,807,926,705,601,3217
New York,Elwood,11439,382,2016,1905,2122,1348,7773
New York,Cold Spring Harbor,5164,104,506,473,1134,1378,3595
New York,Centereach,32028,1724,6670,6370,3764,2925,21453
New York,Bayport,8392,407,1081,1898,1273,1388,6047
New York,Amagansett,750,54,177,127,174,136,668
New York,Hartsdale,4822,162,463,480,1308,1599,4012
New York,East Quogue,4797,223,856,1087,484,788,3438
New York,East Northport,20136,644,3216,3907,3437,2904,14108
New York,Candor,645,31,158,156,62,24,431
New York,East Islip,13563,497,2573,2414,1859,1926,9269
New York,Copiague,23716,3589,5784,4118,2042,1240,16773
New York,Central Islip,31846,5134,6816,5063,2362,1201,20576
New York,Babylon,12089,325,1927,2129,2470,1929,8780
New York,Amityville,9452,503,1792,2083,1597,967,6942
New York,Burke,225,11,67,45,21,13,157
New York,South Glens Falls,3595,266,1037,926,284,105,2618
New York,Hyde Park,1982,76,352,423,264,301,1416
New York,Brushton,456,45,139,86,29,25,324
New York,Coram,39977,2048,8898,8444,4978,3799,28167
New York,Crugers,1489,240,440,212,192,180,1264
New York,Golden's Bridge,1813,16,77,295,423,427,1238
New York,Hawthorne,4510,336,748,651,763,768,3266
New York,West Sayville,4806,152,1066,849,729,522,3318
New York,Alexander,589,9,147,133,50,30,369
New York,Wappingers Falls,5663,654,1391,1148,493,300,3986
New York,Wolcott,1694,165,499,264,72,68,1068
New York,Red Creek,684,39,173,111,21,24,368
New York,Millport,443,39,149,82,8,9,287
New York,Tuckahoe,984,31,140,288,141,117,717
New York,Terryville,12340,1133,2174,2260,1643,1164,8374
New York,Richville,282,17,73,64,10,12,176
New York,Springs,6912,506,1018,1129,1523,1083,5259
New York,Deer Park,27273,1894,5951,5511,3699,1992,19047
New York,Center Moriches,8395,399,1751,2007,560,773,5490
New York,Bellport,2008,32,248,523,294,509,1606
New York,Belle Terre,681,12,63,86,112,228,501
New York,Kings Park,16707,664,2870,3451,2887,2252,12124
New York,Holtsville,19365,989,4254,4406,2591,1632,13872
New York,Hampton Bays,14280,1134,3108,2603,2182,1526,10553
New York,Halesite,2671,31,324,426,635,642,2058
New York,East Shoreham,6484,231,855,1184,853,1115,4238
New York,Frewsburg,1664,69,474,378,254,136,1311
New York,Ripley,787,61,299,173,49,20,602
New York,New Berlin,927,115,261,159,75,73,683
New York,Friendship,1169,74,320,276,58,56,784
New York,DeRuyter,457,16,105,120,20,41,302
New York,Monsey,22073,1773,3099,1853,591,469,7785
New York,Congers,8406,467,1216,1580,1270,1256,5789
New York,Airmont,8776,610,1245,1340,1098,991,5284
New York,Pittsford,1667,3,88,212,418,492,1213
New York,Hilton,5858,168,1203,1359,529,590,3849
New York,Fairport,5349,172,450,1316,1060,1206,4204
New York,Lorenz Park,2150,150,583,494,231,127,1585
New York,Springville,4306,194,1368,818,463,287,3130
New York,Kinderhook,1366,38,251,280,238,291,1098
New York,Valatie,1728,121,409,355,225,128,1238
New York,Galeville,4557,469,1222,1040,382,178,3291
New York,Baldwinsville,7550,346,1491,2109,1191,529,5666
New York,Bellerose Terrace,2055,159,518,297,284,171,1429
New York,Sleepy Hollow,10138,1659,1435,1246,1226,1228,6794
New York,Corning,10789,514,2306,2318,1221,1413,7772
New York,Cove Neck,254,1,19,42,67,61,190
New York,Canisteo,2262,77,670,444,166,155,1512
New York,Ghent,529,15,67,80,85,52,299
New York,Tonawanda,14873,760,4082,3789,1696,937,11264
New York,Canastota,4605,114,1189,908,326,324,2861
New York,Tonawanda,57280,2694,11637,12673,8898,6357,42259
New York,Niverville,1262,0,165,283,165,238,851
New York,Warwick,6779,313,1496,1376,964,798,4947
New York,Vails Gate,3122,246,622,867,229,129,2093
New York,Sand Ridge,557,68,235,82,0,26,411
New York,Mayfield,795,27,163,238,79,40,547
New York,Gloversville,14938,1717,3750,3347,656,682,10152
New York,Broadalbin,1466,72,337,426,135,59,1029
New York,Brewerton,3931,217,926,1079,292,233,2747
New York,Rotterdam,20274,1115,5093,5031,2170,1101,14510
New York,Delanson,376,14,48,104,37,22,225
New York,Tribes Hill,868,42,160,266,85,33,586
New York,Fort Johnson,839,50,129,177,73,41,470
New York,Castile,945,44,265,222,75,39,645
New York,Seneca Knolls,2002,42,687,688,16,152,1585
New York,Nedrow,2316,215,401,681,129,140,1566
New York,Minoa,3474,50,660,790,342,435,2277
New York,Manlius,4520,130,597,817,1025,766,3335
New York,Lyncourt,3856,255,821,1028,345,94,2543
New York,Jordan,1435,83,293,354,176,79,985
New York,Almond,494,9,82,129,43,55,318
New York,Portville,965,49,209,176,103,94,631
New York,Youngstown,2047,42,421,482,253,194,1392
New York,Lewiston,2592,59,543,600,584,343,2129
New York,East Hills,7113,49,397,467,1732,2120,4765
New York,Watervliet,10120,913,2337,2463,1058,495,7266
New York,Plattsburgh,19515,1291,3056,3238,1621,1928,11134
New York,Peru,1512,52,207,454,192,282,1187
New York,North Massapequa,18609,534,3702,3738,3170,1972,13116
New York,North Bellmore,20269,673,3849,2951,3633,3261,14367
New York,Manhasset Hills,3594,163,327,381,784,840,2495
New York,Lakeview,6317,369,973,1295,671,562,3870
New York,Farmingdale,8842,398,1978,1753,1767,924,6820
New York,Hewlett,6484,271,1272,980,1300,1142,4965
New York,Hempstead,55399,10167,10400,8169,4155,2666,35557
New York,Harbor Hills,475,0,41,36,99,93,269
New York,Franklin Square,32329,2269,6606,6385,4571,2593,22424
New York,East Norwich,2902,42,435,380,554,537,1948
New York,Brookville,3564,11,149,254,674,628,1716
New York,Wampsville,650,75,201,127,44,22,469
New York,Munnsville,497,21,119,74,44,16,274
New York,Greene,1704,63,364,409,165,146,1147
New York,Herricks,4074,108,599,480,1035,656,2878
New York,Glenwood Landing,3910,32,371,463,908,860,2634
New York,Great Neck Gardens,1183,0,0,88,411,206,705
New York,Inwood,9804,1677,1988,1524,733,413,6335
New York,Penn Yan,4818,413,1474,966,510,223,3586
New York,Trumansburg,1805,33,327,293,404,361,1418
New York,Newfield Hamlet,465,0,96,148,88,67,399
New York,Glen Head,4983,206,590,650,914,1061,3421
New York,Mattydale,6102,479,1669,1318,437,107,4010
New York,Liverpool,2174,62,426,509,417,325,1739
New York,Fayetteville,4133,137,377,770,768,930,2982
New York,Rome,32338,3216,7873,7024,2977,1868,22958
New York,Oriskany,1246,69,396,271,164,70,970
New York,New York Mills,3381,169,964,764,388,209,2494
New York,Woodbury,8603,388,1105,791,2068,2214,6566
New York,Williston Park,7294,358,1070,1246,1210,1147,5031
New York,Upper Brookville,1607,47,155,226,345,405,1178
New York,South Valley Stream,6930,342,736,1011,1608,1103,4800
New York,South Hempstead,3123,56,404,442,635,529,2066
New York,Plandome Heights,949,2,36,56,234,312,640
New York,Old Westbury,4742,45,274,261,844,937,2361
New York,North New Hyde Park,15726,1017,2503,1949,2977,2675,11121
New York,Massapequa Park,17120,455,3218,2956,3172,2048,11849
New York,South Lockport,7315,564,1851,1842,673,318,5248
New York,Alexandria Bay,831,36,250,215,81,89,671
New York,East Ithaca,2041,33,172,161,428,565,1359
New York,Glen Park,568,37,134,120,47,20,358
New York,Lake Katrine,2533,267,808,584,317,146,2122
New York,Auburn,26779,2906,5484,6903,2494,1561,19348
New York,Ovid,531,32,110,131,17,58,348
New York,Valley Falls,483,7,117,115,52,38,329
New York,Solvay,6364,609,1370,1416,681,463,4539
New York,Ossining,25174,4281,4012,3846,3000,2847,17986
New York,Sands Point,2857,99,72,175,744,862,1952
New York,Oneida Castle,598,21,158,183,70,21,453
New York,East Hampton North,4468,392,1012,815,520,490,3229
New York,Waverly,4214,308,1388,771,229,163,2859
New York,Tupper Lake,3710,274,1092,970,234,185,2755
New York,Greenport,1945,305,481,310,271,218,1585
New York,Chenango Bridge,2916,119,615,526,424,421,2105
New York,Nissequogue,1574,30,98,271,261,443,1103
New York,Windsor,972,56,224,258,92,68,698
New York,Hopewell Junction,454,0,47,61,56,52,216
New York,Leicester,516,18,126,132,59,31,366
New York,Barker,588,34,168,112,36,22,372
New York,Jefferson Heights,968,112,337,261,109,28,847
New York,Stamford,1374,164,380,273,110,77,1004
New York,Saltaire,8,0,0,2,4,0,6
New York,Cornwall-on-Hudson,2927,100,374,531,457,464,1926
New York,Fillmore,497,6,139,122,23,59,349
New York,Sagaponack,260,18,18,23,115,31,205
New York,Schenevus,485,19,119,136,45,32,351
New York,South Blooming Grove,3145,82,656,781,270,246,2035
New York,Irvington,6539,77,420,733,1202,1723,4155
New York,Lyon Mountain,282,23,139,46,4,12,224
New York,Chazy,523,17,162,102,28,36,345
New York,Chautauqua,380,2,0,18,34,66,120
New York,Akron,2857,120,552,741,307,204,1924
New York,Billington Heights,1384,45,285,230,357,241,1158
New York,Depew,15164,628,4421,3821,1612,773,11255
New York,East Aurora,6193,156,984,1130,1318,976,4564
New York,Eden,3244,39,755,779,486,293,2352
New York,Naples,1033,58,287,285,80,76,786
New York,Head of the Harbor,1463,9,142,237,301,375,1064
New York,Saratoga Springs,27772,1065,3187,4068,5863,5477,19660
New York,Owego,3827,288,750,853,374,330,2595
New York,Fort Ann,343,9,133,71,29,10,252
New York,Morristown,292,46,74,64,30,21,235
New York,New Hempstead,5354,218,832,795,621,575,3041
New York,Tappan,6996,375,1105,1011,1313,1063,4867
New York,Wesley Hills,5858,275,217,638,808,1249,3187
New York,Norfolk,1441,43,394,222,75,95,829
New York,Poughkeepsie,30356,3676,5608,6276,3002,2117,20679
New York,Tivoli,1100,61,91,185,199,170,706
New York,Horseheads North,2747,25,586,706,357,184,1858
New York,Southport,6940,295,2543,1417,402,295,4952
New York,Yaphank,6390,387,1561,1404,743,584,4679
New York,Buchanan,2132,93,393,462,344,233,1525
New York,Eastchester,19983,719,2390,2415,4144,4564,14232
New York,Elmsford,4993,743,727,735,603,628,3436
New York,Greenville CDP (Westchester County),7336,169,414,439,1256,2469,4747
New York,Caroga Lake,590,3,148,160,86,74,471
New York,Central Bridge,328,0,128,62,0,0,190
New York,Chadwicks,1366,77,340,378,145,55,995
New York,Ticonderoga,3120,193,700,765,213,189,2060
New York,Elbridge,1004,39,212,359,99,57,766
New York,Westport,404,10,128,56,85,69,348
New York,Andes,243,8,47,65,58,25,203
New York,Eggertsville,15546,503,1748,2820,2704,2836,10611
New York,Elizabethtown,716,59,147,189,70,77,542
New York,Erin,396,28,160,86,5,13,292
New York,Felts Mills,396,0,113,118,13,14,258
New York,Fishers Landing,65,0,32,28,5,0,65
New York,Fort Covington Hamlet,1530,61,415,315,94,79,964
New York,Fowlerville,150,0,50,20,9,9,88
New York,Freedom Plains,336,11,70,78,59,17,235
New York,Gates,5035,352,1049,1459,511,190,3561
New York,Gilgo,206,0,35,25,30,116,206
New York,Glen Aubrey,292,17,127,57,8,4,213
New York,Gorham,687,0,91,216,78,56,441
New York,Edmeston,671,21,128,173,51,55,428
New York,Grandyle Village,4873,178,763,1048,757,663,3409
New York,Groveland Station,260,19,71,56,25,8,179
New York,Guilford,283,0,127,96,11,0,234
New York,Hadley,868,68,281,187,93,27,656
New York,Hailesboro,767,59,222,161,41,42,525
New York,Hall,128,5,23,37,27,12,104
New York,Hamlin,5453,284,1237,1240,517,246,3524
New York,Hannawa Falls,882,43,138,201,92,134,608
New York,Hartwick,641,21,97,161,102,58,439
New York,Hemlock,423,49,94,164,16,0,323
New York,Henderson,151,15,43,45,5,6,114
New York,Honeoye,854,16,198,186,18,13,431
New York,Hortonville,162,12,46,77,27,0,162
New York,Greigsville,338,28,91,23,0,26,168
New York,East Avon,740,55,239,51,95,61,501
New York,Downsville,472,78,104,150,18,5,355
New York,Calcium,3841,137,645,524,559,152,2017
New York,Bedford Hills,3522,743,440,320,482,386,2371
New York,Belfast,715,49,203,116,33,61,462
New York,Belleville,306,20,65,56,9,45,195
New York,Binghamton University,6149,0,0,63,0,39,102
New York,Bliss,521,22,139,137,47,16,361
New York,Blodgett Mills,236,33,55,12,30,41,171
New York,Bloomville,160,4,49,30,23,17,123
New York,Bolton Landing,507,41,139,167,80,22,449
New York,Brasher Falls,734,46,254,85,45,27,457
New York,Breesport,614,16,130,206,34,35,421
New York,Busti,334,0,41,84,41,17,183
New York,Byersville,29,3,6,10,0,4,23
New York,Campbell,713,79,167,167,44,68,525
New York,Chestertown,515,78,190,107,54,24,453
New York,Clarence,2756,95,555,470,372,473,1965
New York,Clarkson,4365,121,722,764,585,748,2940
New York,Colton,400,25,88,109,30,44,296
New York,Conesus Hamlet,455,3,47,130,60,25,265
New York,Conesus Lake,2374,31,454,777,457,368,2087
New York,Coopers Plains,416,0,118,156,45,0,319
New York,Cranberry Lake,170,15,34,25,40,35,149
New York,Crystal Beach,801,106,197,167,45,109,624
New York,Cumminsville,145,28,60,57,0,0,145
New York,Cuylerville,226,14,43,36,69,31,193
New York,Dalton,337,14,87,84,28,39,252
New York,Durhamville,966,0,207,203,64,0,474
New York,Davenport Center,222,39,89,31,11,0,170
New York,Woodbury,10735,372,1265,2030,1550,1431,6648
New York,East Syracuse,2968,249,779,700,249,86,2063
New York,DeKalb Junction,652,78,146,112,57,10,403
New York,Camden,2570,182,621,603,185,105,1696
New York,Forest Home,616,5,25,38,84,245,397
New York,West Sand Lake,2714,215,625,446,277,353,1916
New York,Madison,468,56,138,68,28,23,313
New York,Norwich,6813,608,1732,1293,491,508,4632
New York,Andover,818,34,240,224,76,25,599
New York,Morrisville,1939,45,183,184,70,52,534
New York,Hagaman,1495,30,344,479,153,138,1144
New York,South Hill,6468,73,274,286,392,667,1692
New York,Savona,840,45,245,190,43,10,533
New York,North Syracuse,6740,445,1720,1648,904,438,5155
New York,Bridgeport,1568,149,483,412,61,71,1176
New York,Mayville,1412,105,329,365,116,114,1029
New York,South Farmingdale,14953,468,2940,3156,2190,1553,10307
New York,Walton Park,2707,71,384,582,376,310,1723
New York,Pine Bush,1462,144,320,441,114,68,1087
New York,Fort Montgomery,1586,32,210,299,284,269,1094
New York,Yorktown Heights,1390,0,388,210,339,224,1161
New York,Greenport West,2245,177,419,524,336,432,1888
New York,Elmont,36028,3149,6990,7662,4966,2304,25071
New York,Olcott,1132,21,302,360,57,42,782
New York,Newfane,3764,429,1069,777,294,219,2788
New York,Rushville,654,60,122,187,39,34,442
New York,Dannemora,3947,774,1826,517,62,36,3215
New York,Champlain,1018,97,228,156,101,50,632
New York,Salisbury,11753,734,1833,2079,2411,1409,8466
New York,Lake Placid,2244,126,392,487,374,107,1486
New York,Canandaigua,10348,335,1726,2456,1491,1341,7349
New York,Manchester,1786,98,480,452,145,78,1253
New York,Port Leyden,660,34,183,144,24,13,398
New York,Homer,3134,209,550,709,417,298,2183
New York,Clintondale,1343,65,307,218,370,52,1012
New York,Adams Center,1451,131,380,263,142,151,1067
New York,Thiells,5186,285,723,984,975,601,3568
New York,Red Hook,1963,134,232,238,230,347,1181
New York,West Winfield,752,60,206,171,90,70,597
New York,Valley Cottage,9637,478,1353,1823,2012,1543,7209
New York,Hillburn,996,91,186,198,94,69,638
New York,Callicoon,224,0,70,92,13,19,194
New York,New Hyde Park,9846,606,1229,1547,1967,1200,6549
New York,Great Neck Estates,2841,112,195,200,484,841,1832
New York,Plattsburgh West,1370,169,539,188,58,38,992
New York,East Rochester,6603,322,1097,1406,899,577,4301
New York,Blue Point,4882,117,920,795,864,614,3310
New York,La Fargeville,688,52,119,105,56,49,381
New York,Hastings-on-Hudson,7964,92,752,609,1677,2347,5477
New York,Batavia,14719,1053,3480,3300,1289,1141,10263
New York,Eatons Neck,1474,0,146,270,327,346,1089
New York,Fort Drum,13109,152,949,2431,830,488,4850
New York,Chaumont,827,47,200,170,56,44,517
New York,Flower Hill,4795,163,234,339,1310,1089,3135
New York,East Williston,2576,27,194,249,524,615,1609
New York,Moravia,1340,74,322,360,111,66,933
New York,Cato,665,16,145,173,33,22,389
New York,South Fallsburg,2538,488,377,384,65,185,1499
New York,Point Lookout,1008,9,147,222,148,240,766
New York,Rock Hill,1417,27,169,356,271,248,1071
New York,Pulaski,2093,176,434,587,146,78,1421
New York,Otego,917,25,158,228,115,85,611
New York,Morris,537,7,92,123,79,40,341
New York,Watertown,26057,1654,5814,5730,2125,1527,16850
New York,Theresa,679,41,168,189,37,44,479
New York,Hobart,453,32,111,117,50,31,341
New York,Philadelphia,1115,86,219,259,72,59,695
New York,Ellisburg,241,8,49,70,22,4,153
New York,Adams,1661,95,325,321,127,146,1014
New York,St. Bonaventure,1947,59,182,145,65,74,525
New York,Delevan,1007,74,248,224,59,14,619
New York,Village of the Branch,1770,17,239,239,290,429,1214
New York,Castleton-on-Hudson,1393,68,298,241,216,160,983
New York,Southold,6117,182,1155,1479,1166,752,4734
New York,Patchogue,12398,821,2614,2548,1662,1167,8812
New York,Noyack,4327,82,663,505,984,687,2921
New York,North Sea,4522,118,671,1093,1190,527,3599
New York,Kerhonkson,2373,216,470,428,161,188,1463
New York,East Kingston,737,28,255,164,54,0,501
New York,Galway,221,0,58,38,24,25,145
New York,Country Knolls,2120,5,156,285,453,547,1446
New York,West End,1887,186,393,361,350,261,1551
New York,Gilbertsville,355,29,77,77,55,52,290
New York,Oneonta,13834,396,1407,1580,1303,1353,6039
New York,Utica,60675,7710,12034,11724,4367,2554,38389
New York,Peconic,747,37,261,159,136,119,712
New York,Hampton Manor,2235,151,470,633,167,165,1586
New York,Poestenkill,893,46,224,389,17,30,706
New York,Windham,287,26,119,102,17,11,275
New York,Parish,498,18,140,113,53,23,347
New York,Oswego,17588,1286,3450,3428,1565,1547,11276
New York,Constantia,1177,152,274,403,130,18,977
New York,St. Johnsville,1907,161,477,440,104,84,1266
New York,Fonda,838,42,171,215,43,42,513
New York,Dryden,2092,147,263,368,314,325,1417
New York,Perry,3594,196,950,854,352,86,2438
New York,Peach Lake,1804,62,191,309,378,323,1263
New York,New Rochelle,79205,8472,10972,10247,11293,12621,53605
New York,Lincolndale,1475,52,216,256,213,289,1026
New York,Kenmore,15191,724,2330,4004,2472,1918,11448
New York,Buffalo,257518,26893,45662,50225,25477,19088,167345
New York,Blasdell,2629,154,798,681,197,76,1906
New York,Valhalla,3551,201,620,566,617,448,2452
New York,Altamont,1755,69,233,264,308,308,1182
New York,Baldwin Harbor,7690,287,1131,1425,1488,1041,5372
New York,Marathon,843,49,265,178,31,43,566
New York,Oneida,10980,807,2711,2502,1247,617,7884
New York,Smyrna,230,26,77,42,18,9,172
New York,Afton,986,86,324,222,58,47,737
New York,Brewster,2087,440,369,328,160,117,1414
New York,Parc,240,5,5,11,0,6,27
New York,Altona,759,131,325,122,16,3,597
New York,Mariaville Lake,370,11,84,33,45,85,258
New York,Wilson,1099,54,235,327,92,139,847
New York,Bloomingburg,392,24,150,51,13,0,238
New York,Roslyn Estates,1188,13,63,105,249,366,796
New York,Arkport,853,40,134,231,84,56,545
New York,Boonville,2063,138,622,486,117,88,1451
New York,Great Bend,1100,60,281,143,111,28,623
New York,Roslyn Heights,6591,340,513,928,1384,1304,4469
New York,Saddle Rock Estates,577,10,0,44,78,204,336
New York,Syosset,19559,644,1492,2532,4271,4056,12995
New York,Wantagh,18078,370,2871,3188,3277,2470,12176
North Carolina,North Wilkesboro,4201,870,624,842,407,142,2885
North Carolina,Carrboro,21216,780,1436,2297,4266,5401,14180
North Carolina,Walnut Creek,1130,10,95,196,285,262,848
North Carolina,Rennert,386,73,87,65,16,5,246
North Carolina,Holly Springs,33341,900,2603,5516,7863,3586,20468
North Carolina,Durham,264310,21533,28648,40659,45574,40822,177236
North Carolina,Norlina,1101,112,307,311,77,17,824
North Carolina,Columbia,898,227,204,166,27,16,640
North Carolina,Ramseur,1738,271,329,406,79,16,1101
North Carolina,Prospect,858,71,175,174,117,37,574
North Carolina,Pilot Mountain,1483,174,300,272,176,117,1039
North Carolina,Flat Rock,1257,246,269,369,54,0,938
North Carolina,Albemarle,15889,1792,3335,3743,1196,551,10617
North Carolina,Vann Crossroads,285,16,0,36,59,0,111
North Carolina,Stedman,1325,27,328,334,148,63,900
North Carolina,Laurinburg,15253,1703,3083,2947,1167,782,9682
North Carolina,Falcon,209,6,43,60,31,1,141
North Carolina,Raynham,53,6,17,16,4,0,43
North Carolina,Trinity,6621,731,1353,1649,754,148,4635
North Carolina,Denton,1820,280,398,327,130,71,1206
North Carolina,West Canton,1257,133,315,330,63,28,869
North Carolina,Raemon,182,36,36,24,20,0,116
North Carolina,Deercroft,484,10,76,179,75,40,380
North Carolina,Delco,242,72,45,77,12,0,206
North Carolina,Denver,3171,223,609,885,241,185,2143
North Carolina,Edneyville,2478,163,510,404,333,81,1491
North Carolina,Efland,709,15,224,208,120,25,592
North Carolina,Engelhard,511,136,134,35,9,0,314
North Carolina,Evergreen,230,18,29,112,8,0,167
North Carolina,Fairfield,197,0,141,44,12,0,197
North Carolina,Ayden,5112,439,895,1472,263,218,3287
North Carolina,Saratoga,502,41,184,100,21,8,354
North Carolina,Macclesfield,555,126,131,93,20,3,373
North Carolina,Concord,89729,6024,13886,17807,14165,7322,59204
North Carolina,Smithfield,12117,1996,2302,2520,1219,545,8582
North Carolina,South Rosemary,2288,381,769,288,95,55,1588
North Carolina,Roanoke Rapids,14937,1863,3051,2735,1254,807,9710
North Carolina,Godwin,113,9,27,24,13,0,73
North Carolina,Whiteville,5450,426,1110,1277,559,300,3672
North Carolina,Norman,98,25,25,20,0,2,72
North Carolina,Oxford,8648,1182,2113,1809,866,413,6383
North Carolina,Rockwell,1811,183,474,387,238,89,1371
North Carolina,Skippers Corner,2583,251,420,800,279,82,1832
North Carolina,Ogden,7692,74,902,1794,1824,869,5463
North Carolina,Bent Creek,1474,38,282,462,179,139,1100
North Carolina,Barker Ten Mile,939,49,160,184,230,115,738
North Carolina,Roxboro,8283,1127,1971,1621,470,160,5349
North Carolina,Rolesville,6957,134,724,1267,1347,812,4284
North Carolina,Severn,237,27,60,83,2,2,174
North Carolina,Creedmoor,4429,270,770,701,665,479,2885
North Carolina,Calypso,462,77,97,132,17,0,323
North Carolina,Boonville,1174,101,227,319,134,39,820
North Carolina,Piney Green,14061,743,2183,2681,1197,416,7220
North Carolina,Granite Falls,4638,545,707,1036,514,337,3139
North Carolina,Buies Creek,2450,8,68,160,117,121,474
North Carolina,Pollocksville,485,18,47,169,26,10,270
North Carolina,Dunn,9635,1284,2379,2011,771,370,6815
North Carolina,Belville,2328,139,356,729,386,112,1722
North Carolina,Stokesdale,5367,230,915,1111,700,558,3514
North Carolina,Belwood,966,98,281,227,39,45,690
North Carolina,Jamestown,4007,124,618,808,811,502,2863
North Carolina,Marietta,138,14,46,30,11,10,111
North Carolina,Minnesott Beach,424,14,53,171,86,61,385
North Carolina,Hendersonville,13809,984,2296,3677,2372,1404,10733
North Carolina,Fallston,533,59,116,155,37,10,377
North Carolina,Matthews,31400,1131,3411,5567,8000,3782,21891
North Carolina,Morganton,16466,2549,2617,3348,1753,1315,11582
North Carolina,Walstonburg,182,26,46,40,18,0,130
North Carolina,St. Stephens,9254,1036,1959,1865,943,273,6076
North Carolina,Kill Devil Hills,7035,441,1298,1920,878,446,4983
North Carolina,Barker Heights,1381,174,268,445,72,16,975
North Carolina,Davis,304,0,114,86,14,19,233
North Carolina,Pleasant Hill,851,251,129,176,151,30,737
North Carolina,Mocksville,5184,626,1252,967,431,220,3496
North Carolina,Cary,163266,4659,11607,21442,42508,32626,112842
North Carolina,Creswell,203,22,40,38,20,1,121
North Carolina,Chapel Hill,59561,1186,2421,4193,8943,14309,31052
North Carolina,Farmville,4710,359,805,1054,443,284,2945
North Carolina,Jonesville,2390,329,501,510,56,66,1462
North Carolina,Seven Springs,70,8,18,22,5,0,53
North Carolina,Rex,0,0,0,0,0,0,0
North Carolina,Proctorville,142,12,29,45,5,12,103
North Carolina,Orrum,63,9,25,12,3,1,50
North Carolina,McDonald,109,14,29,28,7,6,84
North Carolina,Hamlet,6362,826,1111,1252,424,148,3761
North Carolina,Fairmont,2655,387,762,495,174,114,1932
North Carolina,Brevard,7785,563,1472,1733,1157,800,5725
North Carolina,South Henderson,956,201,216,177,36,0,630
North Carolina,Henderson,14986,2175,3229,2527,1085,493,9509
North Carolina,Wingate,4078,341,351,594,327,138,1751
North Carolina,Dobson,1584,218,265,358,142,71,1054
North Carolina,Richfield,549,64,111,120,42,15,352
North Carolina,Lucama,1200,291,251,140,29,14,725
North Carolina,Kenly,1956,339,397,318,119,32,1205
North Carolina,Mar-Mac,3290,492,551,885,238,94,2260
North Carolina,Elroy,3719,547,787,791,193,48,2366
North Carolina,Knightdale,15198,817,1798,3548,2718,1202,10083
North Carolina,Dana,3585,630,718,799,255,61,2463
North Carolina,Cove Creek,1058,89,220,199,187,105,800
North Carolina,Cordova,1862,242,629,293,24,180,1368
North Carolina,Murphy,1920,209,449,477,238,108,1481
North Carolina,Dillsboro,247,4,29,68,59,51,211
North Carolina,Middlesex,966,118,233,198,67,5,621
North Carolina,Five Points,896,16,115,307,95,73,606
North Carolina,Teachey,392,59,68,107,36,6,276
North Carolina,Polkton,3187,683,882,794,75,6,2440
North Carolina,Castalia,418,69,148,83,22,14,336
North Carolina,Saxapahaw,1355,220,269,374,163,88,1114
North Carolina,McFarlan,97,16,26,35,2,2,81
North Carolina,Banner Elk,1445,53,61,175,95,109,493
North Carolina,Surf City,3264,100,468,763,575,372,2278
North Carolina,Washington,9649,963,1812,2100,741,599,6215
North Carolina,Kings Grant,9051,739,1555,2146,1261,551,6252
North Carolina,Woodland,880,93,217,153,32,49,544
North Carolina,Madison,2463,262,656,625,188,89,1820
North Carolina,Wentworth,2724,279,677,631,217,118,1922
North Carolina,East Spencer,1537,277,377,331,81,5,1071
North Carolina,Salisbury,33652,2910,6548,7670,3254,1837,22219
North Carolina,Mint Hill,26168,1030,4031,6095,5315,1987,18458
North Carolina,Spindale,4231,502,918,974,269,110,2773
North Carolina,Garland,1052,247,191,108,30,6,582
North Carolina,Newton Grove,546,99,89,140,52,23,403
North Carolina,Hightsville,777,69,308,216,117,18,728
North Carolina,Silver City,912,89,260,166,56,14,585
North Carolina,Atkinson,338,45,95,79,9,8,236
North Carolina,Wilkesboro,3505,618,547,677,309,314,2465
North Carolina,Mulberry,2327,298,412,698,150,54,1612
North Carolina,Cricket,1944,488,268,491,129,55,1431
North Carolina,Liberty,2657,487,537,509,185,41,1759
North Carolina,Archdale,11538,1205,2525,2907,951,648,8236
North Carolina,Falkland,76,1,22,19,0,2,44
North Carolina,Holly Ridge,2256,97,366,503,519,152,1637
North Carolina,East Rockingham,3289,537,795,572,115,67,2086
North Carolina,Hoffman,693,95,137,181,13,10,436
North Carolina,Greensboro,288719,19252,41702,57558,44667,26193,189372
North Carolina,Summerfield,11044,303,1272,1834,2691,1245,7345
North Carolina,Sneads Ferry,2797,116,397,692,411,149,1765
North Carolina,Whitsett,1018,78,204,241,165,60,748
North Carolina,Walkertown,5043,564,1241,1012,539,160,3516
North Carolina,Enfield,2322,477,654,277,62,65,1535
North Carolina,Halifax,148,4,20,36,36,4,100
North Carolina,Scotland Neck,1380,272,469,214,84,20,1059
North Carolina,Littleton,607,92,126,142,56,27,443
North Carolina,Clayton,20324,1143,3032,4890,2798,1316,13179
North Carolina,Princeton,944,125,204,205,50,52,636
North Carolina,Selma,6577,1250,996,1271,313,175,4005
North Carolina,Beech Mountain,581,21,70,162,141,115,509
North Carolina,Ronda,589,134,109,69,17,7,336
North Carolina,Bethania,392,13,111,121,54,15,314
North Carolina,Half Moon,7669,363,1625,2096,804,195,5083
North Carolina,Warsaw,3131,495,714,580,112,55,1956
North Carolina,Conetoe,294,65,73,62,9,3,212
North Carolina,Ossipee,488,96,105,100,37,5,343
North Carolina,Red Cross,759,89,256,187,51,11,594
North Carolina,Wallburg,3029,129,696,849,301,159,2134
North Carolina,Chimney Rock Village,140,6,31,34,23,7,101
North Carolina,Advance,924,92,275,159,124,27,677
North Carolina,Aquadale,259,37,79,72,16,0,204
North Carolina,Archer Lodge,4771,367,893,1000,490,127,2877
North Carolina,Atlantic,458,68,149,138,24,22,401
North Carolina,Belvoir,596,0,206,165,21,0,392
North Carolina,Avon,665,129,85,202,89,20,525
North Carolina,North Topsail Beach,995,16,110,336,214,161,837
North Carolina,Bayview,284,36,58,88,11,38,231
North Carolina,Bennett,440,0,73,99,37,0,209
North Carolina,Blue Clay Farms,10,0,5,5,0,0,10
North Carolina,Broad Creek,2440,213,477,671,274,114,1749
North Carolina,Bunnlevel,592,30,221,114,20,22,407
North Carolina,Buxton,1319,85,161,405,133,49,833
North Carolina,Camden,740,178,18,194,57,36,483
North Carolina,Caroleen,841,115,362,101,154,9,741
North Carolina,Cherokee,2163,252,629,430,177,75,1563
North Carolina,Cliffside,185,8,62,44,22,0,136
North Carolina,Coinjock,398,56,84,166,7,0,313
North Carolina,Bell Arthur,156,13,39,40,39,13,144
North Carolina,Lexington,18897,3065,4161,3260,1175,645,12306
North Carolina,Misenheimer,754,21,25,51,34,56,187
North Carolina,Duck,581,5,55,155,166,125,506
North Carolina,Pinetops,1273,165,366,235,61,32,859
North Carolina,Bailey,450,57,96,86,60,2,301
North Carolina,Dortches,1085,83,252,233,127,76,771
North Carolina,Bayshore,4696,221,520,810,794,496,2841
North Carolina,Carolina Beach,6194,204,717,1601,1347,826,4695
North Carolina,Bolton,669,100,145,164,18,0,427
North Carolina,Biltmore Forest,1536,6,43,149,496,459,1153
North Carolina,Montreat,454,2,4,19,71,65,161
North Carolina,Hudson,3704,341,723,1001,343,152,2560
North Carolina,Sawmills,5159,1008,1303,1194,207,161,3873
North Carolina,Mills River,7173,328,1241,1693,1225,643,5130
North Carolina,Cove City,412,49,90,95,21,3,258
North Carolina,Dellview,6,0,0,6,0,0,6
North Carolina,Elon,11008,176,812,1321,1329,1178,4816
North Carolina,Fairview,3701,263,841,978,378,192,2652
North Carolina,Grantsboro,654,107,188,153,34,7,489
North Carolina,Midland,3499,289,765,768,436,153,2411
North Carolina,Butner,7699,1227,1463,1622,530,295,5137
North Carolina,Eastover,3697,267,897,853,376,213,2606
North Carolina,Midway,4815,346,856,1491,616,141,3450
North Carolina,Altamahaw,335,24,183,99,0,0,306
North Carolina,Bear Grass,86,6,13,35,4,8,66
North Carolina,Havelock,20330,498,2259,4108,1156,492,8513
North Carolina,Dover,233,28,68,51,25,2,174
North Carolina,Maggie Valley,1654,75,350,484,268,180,1357
North Carolina,Faith,830,67,195,151,98,68,579
North Carolina,Ellerbe,862,106,205,201,61,11,584
North Carolina,Shannon,331,96,32,19,6,9,162
North Carolina,Bethel,1753,323,386,340,198,106,1353
North Carolina,Rose Hill,2547,424,435,397,178,35,1469
North Carolina,Beulaville,1513,176,390,379,127,50,1122
North Carolina,Ashley Heights,484,49,150,77,7,0,283
North Carolina,Brogden,2337,337,643,449,170,29,1628
North Carolina,Raleigh,457159,24811,46872,77274,96799,54802,300558
North Carolina,New London,683,50,123,208,80,28,489
North Carolina,Bonnetsville,537,139,129,44,15,0,327
North Carolina,Wendell,6828,552,1134,1422,658,624,4390
North Carolina,Cedar Rock,251,2,11,84,81,27,205
North Carolina,Weaverville,3887,81,486,740,987,842,3136
North Carolina,Avery Creek,2307,24,230,546,558,321,1679
North Carolina,Pink Hill,437,71,87,104,27,6,295
North Carolina,Micro,672,58,202,175,14,0,449
North Carolina,South Weldon,878,68,221,98,11,0,398
North Carolina,Lewisville,13657,343,2190,2830,2832,1351,9546
North Carolina,Clemmons,20050,881,2258,3817,4321,2368,13645
North Carolina,Stovall,362,86,67,93,19,10,275
North Carolina,Stem,1048,73,130,340,106,32,681
North Carolina,Belhaven,1879,320,511,370,133,43,1377
North Carolina,Weldon,1679,258,342,355,139,74,1168
North Carolina,Glen Raven,3028,184,474,763,316,112,1849
North Carolina,Randleman,4111,568,926,850,293,56,2693
North Carolina,Autryville,207,47,53,53,9,1,163
North Carolina,Sharpsburg,2158,272,411,528,88,26,1325
North Carolina,Elm City,1360,177,397,221,51,26,872
North Carolina,Pikeville,649,52,157,168,76,5,458
North Carolina,Fremont,1196,194,360,246,110,32,942
North Carolina,Eureka,222,12,40,61,29,4,146
North Carolina,Black Creek,865,95,239,117,39,15,505
North Carolina,Faison,1227,159,162,201,140,40,702
North Carolina,Stoneville,1300,85,289,371,82,13,840
North Carolina,Sugar Mountain,570,9,51,154,124,76,414
North Carolina,Spring Lake,12284,463,1664,2495,1229,484,6335
North Carolina,Clyde,1129,93,191,338,146,55,823
North Carolina,Tarboro,11045,1598,2349,2562,813,668,7990
North Carolina,Mount Olive,4731,824,1042,754,273,153,3046
North Carolina,Harrells,143,17,38,39,11,4,109
North Carolina,Delway,23,12,0,11,0,0,23
North Carolina,Lake Lure,1557,51,211,458,364,225,1309
North Carolina,Hillsborough,7083,572,825,1213,1154,1151,4915
North Carolina,Warrenton,1056,174,201,238,142,53,808
North Carolina,Stallings,15240,673,1674,3202,3249,1426,10224
North Carolina,Gibson,482,63,114,140,16,17,350
North Carolina,Wilson,49230,6459,9137,9359,5520,2237,32712
North Carolina,Sanford,29274,3535,4928,6056,3070,1213,18802
North Carolina,Tabor City,3990,794,1042,927,123,130,3016
North Carolina,Pleasant Garden,4814,246,1547,1027,549,327,3696
North Carolina,Bermuda Run,2568,22,421,530,679,559,2211
North Carolina,Goldston,264,8,66,73,22,7,176
North Carolina,Lake Norman of Catawba,8241,445,1347,2156,1581,629,6158
North Carolina,Mount Pleasant,1904,124,420,457,201,78,1280
North Carolina,Fearrington Village,2780,14,289,328,842,1089,2562
North Carolina,Woodfin,6487,706,1154,1458,944,471,4733
North Carolina,Asheville,90531,5086,11658,18010,19147,12626,66527
North Carolina,Mount Gilead,1161,156,338,230,90,3,817
North Carolina,Webster,444,14,58,68,44,113,297
North Carolina,Cullowhee,6139,110,169,137,361,266,1043
North Carolina,McAdenville,717,61,159,112,144,50,526
North Carolina,Siler City,8106,1597,1557,1416,394,174,5138
North Carolina,Gastonia,75138,7714,14115,17352,8403,3644,51228
North Carolina,Lincolnton,10678,1550,2027,2269,1177,328,7351
North Carolina,Flat Rock,3298,84,207,691,1278,700,2960
North Carolina,Balfour,1406,193,257,246,249,64,1009
North Carolina,Ahoskie,4882,730,986,962,431,192,3301
North Carolina,Grover,710,68,215,170,40,17,510
North Carolina,Valdese,4418,484,1162,804,296,356,3102
North Carolina,Glen Alpine,1557,202,383,347,109,57,1098
North Carolina,St. James,5133,71,459,1043,1918,1474,4965
North Carolina,Carolina Shores,3944,176,1153,1328,565,301,3523
North Carolina,Dublin,354,39,48,107,18,10,222
North Carolina,Belmont,11768,794,1657,2045,2171,989,7656
North Carolina,Elizabeth City,17604,1557,3186,3533,1447,1117,10840
North Carolina,Hamilton,355,78,79,61,13,10,241
North Carolina,Butters,227,0,88,108,0,0,196
North Carolina,Lake Waccamaw,1622,202,275,375,194,105,1151
North Carolina,Fairplains,2172,303,563,385,241,78,1570
North Carolina,Greenville,91207,3869,10329,15999,11581,7180,48958
North Carolina,Goldsboro,34972,3196,7054,8193,3293,1549,23285
North Carolina,St. Pauls,1925,337,587,361,82,38,1405
North Carolina,Rowland,1119,196,306,213,47,51,813
North Carolina,Hayesville,407,67,61,83,31,16,258
North Carolina,Long View,4949,783,1078,1265,318,98,3542
North Carolina,Gamewell,3959,710,780,927,234,9,2660
North Carolina,Kinston,20659,2575,4747,4353,1595,930,14200
North Carolina,Cornelius,28649,540,2658,6222,7562,3716,20698
North Carolina,Four Oaks,2159,343,305,351,205,140,1344
North Carolina,Wilson's Mills,2552,305,398,502,120,37,1362
North Carolina,Forest City,7167,951,1198,1713,436,342,4640
North Carolina,Gaston,1172,234,374,185,17,20,830
North Carolina,Conway,650,61,154,93,49,27,384
North Carolina,Wrightsboro,5233,337,1653,1218,471,61,3740
North Carolina,Rocky Mount,54982,5836,12287,11196,4985,2513,36817
North Carolina,Nashville,5523,424,1035,1546,617,404,4026
North Carolina,West Jefferson,1485,223,368,349,123,68,1131
North Carolina,Lilesville,445,31,108,99,42,10,290
North Carolina,Red Oak,3411,165,647,838,614,258,2522
North Carolina,Benson,3651,582,657,695,512,299,2745
North Carolina,Tryon,1578,49,163,434,420,245,1311
North Carolina,Spencer,3231,484,626,640,297,132,2179
North Carolina,Locust,3351,336,842,794,390,126,2488
North Carolina,Tobaccoville,2617,161,617,811,329,79,1997
North Carolina,Toast,1410,196,307,369,29,100,1001
North Carolina,Zebulon,5166,647,636,1134,383,238,3038
North Carolina,Canton,4240,560,715,1340,201,137,2953
North Carolina,Indian Trail,37983,1541,5670,7433,5808,2698,23150
North Carolina,JAARS,459,0,10,82,149,55,296
North Carolina,Wesley Chapel,8633,357,839,1418,2099,609,5322
North Carolina,Waynesville,9898,1392,1751,2145,1102,989,7379
North Carolina,Ocracoke,564,77,116,93,76,41,403
North Carolina,Bowmore,62,8,6,29,0,0,43
North Carolina,Kernersville,24088,1592,4625,5418,3741,1647,17023
North Carolina,Taylorsville,2278,304,665,476,105,86,1636
North Carolina,Speed,73,19,40,3,0,2,64
North Carolina,Alamance,1069,27,164,287,192,93,763
North Carolina,Swepsonville,1844,125,298,516,236,145,1320
North Carolina,Peachland,496,49,128,60,20,12,269
North Carolina,Jefferson,1420,232,325,272,166,24,1019
North Carolina,Elk Park,725,55,171,203,11,13,453
North Carolina,Aurora,554,68,240,129,11,6,454
North Carolina,Bath,218,13,31,85,40,27,196
North Carolina,River Road,3352,295,664,967,489,294,2709
North Carolina,Wilmington,118094,6208,15874,23781,21288,10026,77177
North Carolina,Leggett,42,6,21,9,1,0,37
North Carolina,Wrightsville Beach,2536,15,105,365,844,379,1708
North Carolina,Hookerton,519,61,157,129,17,5,369
North Carolina,Seven Lakes,4404,24,661,892,1084,880,3541
North Carolina,Milton,199,27,35,38,36,12,148
North Carolina,Boiling Springs,4598,125,536,590,433,435,2119
North Carolina,Earl,231,33,78,68,8,4,191
North Carolina,Cofield,375,100,63,70,35,24,292
North Carolina,Maiden,3397,398,599,806,260,42,2105
North Carolina,Franklinton,2076,263,586,381,123,86,1439
North Carolina,Youngsville,1766,138,257,412,152,99,1058
North Carolina,Cashiers,78,14,21,14,26,0,75
North Carolina,Candor,1097,170,126,203,71,26,596
North Carolina,Marshall,691,63,136,166,100,69,534
North Carolina,Snow Hill,1604,299,286,406,100,82,1173
North Carolina,Carthage,2811,191,606,685,194,161,1837
North Carolina,Fairview,2968,219,439,717,425,201,2001
North Carolina,Cajah's Mountain,2722,445,665,580,243,75,2008
North Carolina,Lenoir,17899,2354,4267,3981,1362,631,12595
North Carolina,Westport,4119,92,513,715,1017,574,2911
North Carolina,Marion,7839,1324,1938,1465,635,211,5573
North Carolina,Bunn,323,40,60,85,26,2,213
North Carolina,Mount Holly,15305,1027,3004,3534,1868,972,10405
North Carolina,Stanley,3643,323,906,784,368,103,2484
North Carolina,Star,830,120,195,208,70,20,613
North Carolina,Pinebluff,1471,61,196,537,155,81,1030
North Carolina,Black Mountain,8137,365,1661,1423,1784,1283,6516
North Carolina,Maysville,1038,60,254,303,37,57,711
North Carolina,Garysburg,930,87,308,207,24,42,668
North Carolina,Mayodan,2754,407,658,587,187,45,1884
North Carolina,Rutherford College,1253,148,428,234,150,41,1001
North Carolina,Bogue,670,40,170,216,58,52,536
North Carolina,Emerald Isle,3699,50,623,875,778,708,3034
North Carolina,Edenton,4734,716,1237,879,456,211,3499
North Carolina,East Flat Rock,5036,901,1202,900,338,204,3545
North Carolina,Casar,255,42,69,45,10,8,174
North Carolina,Kingstown,510,136,174,76,10,6,402
North Carolina,Mooresboro,343,46,138,49,8,4,245
North Carolina,Etowah,7420,671,1646,2022,840,625,5804
North Carolina,Mooresville,37165,1456,5041,8175,6366,2873,23911
North Carolina,Sunset Beach,3826,79,690,957,1051,648,3425
North Carolina,Pine Level,2132,243,420,426,206,65,1360
North Carolina,Saluda,864,59,162,185,177,84,667
North Carolina,Mebane,15198,722,2148,3328,2414,1092,9704
North Carolina,Apex,48254,1143,3134,7153,12139,7250,30819
North Carolina,Roper,646,104,98,101,30,14,347
North Carolina,Macon,147,4,28,28,18,2,80
North Carolina,Mount Airy,10227,1423,1887,2314,1100,658,7382
North Carolina,King,6885,492,1908,1639,941,118,5098
North Carolina,Turkey,260,44,100,28,14,0,186
North Carolina,Keener,234,51,114,30,10,0,205
North Carolina,Ruth,531,117,122,121,27,17,404
North Carolina,Lumber Bridge,77,6,35,17,2,1,61
North Carolina,Lasker,169,14,53,42,4,12,125
North Carolina,Oak Island,7612,378,1477,2197,1504,1002,6558
North Carolina,Askewville,199,23,72,38,7,5,145
North Carolina,Reidsville,13909,2024,3717,2959,1140,418,10258
North Carolina,Raeford,4882,530,901,1172,334,292,3229
North Carolina,Bethlehem,4052,433,679,986,816,310,3224
North Carolina,Kure Beach,2271,64,382,571,503,416,1936
North Carolina,Green Level,2153,300,518,402,59,16,1295
North Carolina,Woodlawn,804,48,169,236,165,54,672
North Carolina,Morven,548,139,113,68,8,9,337
North Carolina,Chocowinity,903,126,200,251,32,18,627
North Carolina,Myrtle Grove,10563,354,1461,2425,2029,1268,7537
North Carolina,Sea Breeze,1861,0,284,428,561,263,1536
North Carolina,Boiling Spring Lakes,5888,501,1048,1619,493,224,3885
North Carolina,Silver Lake,6330,298,1239,1632,863,193,4225
North Carolina,Granite Quarry,2955,94,609,777,368,77,1925
North Carolina,Kannapolis,47553,4601,8066,11237,4472,1978,30354
North Carolina,Bostic,296,26,91,101,15,7,240
North Carolina,Clinton,8557,1184,1895,1687,798,465,6029
North Carolina,Ingold,597,36,57,91,0,14,198
North Carolina,Highlands,1186,55,180,286,186,250,957
North Carolina,Newton,13005,1565,2943,2699,1067,466,8740
North Carolina,Fairfield Harbour,2887,232,516,874,520,398,2540
North Carolina,Kitty Hawk,3462,69,608,944,585,474,2680
North Carolina,Huntersville,54572,1282,4743,10061,14122,6217,36425
North Carolina,Jackson,496,39,118,204,38,18,417
North Carolina,Foscoe,1616,117,197,399,277,220,1210
North Carolina,Gatesville,277,21,49,85,24,22,201
North Carolina,Fruitland,2407,183,472,593,249,148,1645
North Carolina,Salemburg,415,22,99,101,73,13,308
North Carolina,Trent Woods,4081,82,441,867,938,769,3097
North Carolina,Robersonville,1647,241,482,256,114,25,1118
North Carolina,Brunswick,878,133,274,248,38,15,708
North Carolina,Patterson Springs,882,128,162,155,17,8,470
North Carolina,Morehead City,9304,666,1699,2497,1474,836,7172
North Carolina,Salem,1872,163,403,696,184,102,1548
North Carolina,Cape Carteret,2376,17,433,592,349,341,1732
North Carolina,Cedar Point,1899,71,228,349,312,330,1290
North Carolina,Lattimore,443,37,62,81,36,22,238
North Carolina,Nags Head,2894,45,409,879,629,237,2199
North Carolina,Wanchese,1832,133,476,377,199,30,1215
North Carolina,Parmele,249,25,64,47,15,0,151
North Carolina,Colerain,268,15,61,49,24,19,168
North Carolina,Clarkton,739,84,141,215,37,43,520
North Carolina,Tar Heel,228,13,47,83,20,8,171
North Carolina,Connelly Springs,1588,357,426,263,116,18,1180
North Carolina,Beaufort,4314,309,684,1457,619,415,3484
North Carolina,Newport,4624,528,678,1291,431,243,3171
North Carolina,Yanceyville,2248,423,577,452,120,66,1638
North Carolina,Polkville,527,75,176,116,22,16,405
North Carolina,Roseboro,1249,188,248,352,109,47,944
North Carolina,Plain View,1657,132,524,368,203,33,1260
North Carolina,Ivanhoe,372,43,97,37,22,0,199
North Carolina,Kenansville,775,63,196,296,83,11,649
North Carolina,Hickory,40402,3524,6843,7969,5500,3324,27160
North Carolina,James City,5684,621,1037,1563,577,394,4192
North Carolina,Coats,2368,180,557,548,98,66,1449
North Carolina,Erwin,4956,608,1370,1105,314,125,3522
North Carolina,Jamesville,617,29,117,141,58,10,355
North Carolina,Oak City,272,66,53,67,21,5,212
North Carolina,Williamston,5375,441,1552,1121,446,344,3904
North Carolina,Davidson,12666,123,566,1256,3009,2537,7491
North Carolina,Cerro Gordo,176,32,27,36,13,12,120
North Carolina,Chadbourn,2412,414,504,501,184,33,1636
North Carolina,Pinehurst,15821,319,1744,3482,4274,3266,13085
North Carolina,Red Springs,3419,460,787,596,394,73,2310
North Carolina,Mountain Home,3851,243,834,896,614,234,2821
North Carolina,Lowesville,3034,215,594,910,467,156,2342
North Carolina,Old Fort,900,124,206,274,18,8,630
North Carolina,West Marion,1403,83,457,379,51,30,1000
North Carolina,Oak Ridge,6829,126,875,1143,1491,852,4487
North Carolina,Sedalia,513,61,106,178,31,46,422
North Carolina,Bladenboro,1934,241,435,436,109,49,1270
North Carolina,Burlington,52524,6939,9366,11397,6323,2576,36601
North Carolina,Lake Junaluska,3057,125,685,836,451,309,2406
North Carolina,Rockfish,3619,119,621,1102,405,132,2379
North Carolina,Harrellsville,116,2,33,26,10,0,71
North Carolina,Fletcher,7952,283,1321,1992,1513,508,5617
North Carolina,Bessemer City,5438,948,1416,1044,175,59,3642
North Carolina,Cherryville,5889,468,1300,1596,514,219,4097
North Carolina,Enochville,2990,344,756,763,142,49,2054
North Carolina,Landis,3092,233,704,895,329,83,2244
North Carolina,Rutherfordton,4044,368,758,1120,664,353,3263
North Carolina,Sims,510,65,56,119,42,16,298
North Carolina,Fountain,341,71,87,48,14,12,232
North Carolina,Hertford,2336,249,620,561,140,62,1632
North Carolina,Elrod,656,109,122,76,47,10,364
North Carolina,Pembroke,3044,282,303,456,234,132,1407
North Carolina,Burnsville,1990,233,356,566,236,120,1511
North Carolina,Moravian Falls,1997,78,642,559,204,111,1594
North Carolina,Seaboard,736,105,172,130,44,49,500
North Carolina,Richlands,2524,112,467,589,152,15,1335
North Carolina,Fair Bluff,594,142,185,132,56,17,532
North Carolina,Fayetteville,209867,10833,30259,52584,22454,11899,128029
North Carolina,Hope Mills,15762,679,2653,4249,1432,655,9668
North Carolina,Cooleemee,948,105,181,207,81,15,589
North Carolina,Stony Point,2301,224,775,292,35,25,1351
North Carolina,La Grange,2702,460,779,667,59,104,2069
North Carolina,Kelford,430,56,91,64,6,2,219
North Carolina,Middleburg,119,7,50,29,0,0,86
North Carolina,Graham,14670,1680,2728,3422,1444,404,9678
North Carolina,Haw River,2516,271,536,588,150,60,1605
North Carolina,Alliance,734,84,146,197,59,21,507
North Carolina,Catawba,512,76,130,141,41,4,392
North Carolina,Murraysville,15831,741,2884,3695,2224,1190,10734
North Carolina,Momeyer,279,51,87,44,19,6,207
North Carolina,Whispering Pines,3221,135,380,477,735,396,2123
North Carolina,Forest Oaks,3683,112,540,839,872,369,2732
North Carolina,McLeansville,897,80,280,204,15,101,680
North Carolina,Claremont,1609,104,348,355,205,82,1094
North Carolina,Conover,8300,820,1677,2088,762,358,5705
North Carolina,Bridgeton,275,12,92,55,57,15,231
North Carolina,New Bern,29958,2889,5070,7176,3604,2203,20942
North Carolina,River Bend,3065,126,609,1025,563,290,2613
North Carolina,Vanceboro,1291,140,258,260,57,18,733
North Carolina,Manteo,1852,110,301,382,368,176,1337
North Carolina,Whitakers,921,180,239,161,17,16,613
North Carolina,Angier,5376,538,983,1262,506,220,3509
North Carolina,Spruce Pine,2204,316,488,576,199,67,1646
North Carolina,Pineville,8574,293,1304,1725,1829,768,5919
North Carolina,Spring Hope,1603,229,286,311,148,48,1022
North Carolina,Welcome,4274,548,889,1007,523,145,3112
North Carolina,Princeville,2357,396,680,348,113,31,1568
North Carolina,Magnolia,1252,274,210,183,31,6,704
North Carolina,Sparta,1851,366,452,321,96,59,1294
North Carolina,Wadesboro,5351,664,1470,974,404,106,3618
North Carolina,Crossnore,174,17,14,20,10,8,69
North Carolina,Washington Park,584,16,42,133,151,88,430
North Carolina,Bakersville,468,82,70,127,37,11,327
North Carolina,Ansonville,735,94,347,121,33,0,595
North Carolina,Boardman,273,79,46,43,13,2,183
North Carolina,Biscoe,2490,413,422,243,104,47,1229
North Carolina,Rhodhiss,1009,166,350,103,23,4,646
North Carolina,Stantonsburg,683,124,197,118,69,22,530
North Carolina,East Bend,602,41,135,169,58,11,414
North Carolina,Hays,1304,255,426,267,75,0,1023
North Carolina,Jacksonville,73226,2509,8051,13605,4517,2414,31096
North Carolina,Bayboro,1213,148,345,430,11,24,958
North Carolina,Stonewall,279,15,56,105,4,2,182
North Carolina,Burgaw,4057,682,874,900,307,288,3051
North Carolina,Sandyfield,371,32,75,106,12,14,239
North Carolina,Linden,126,13,35,14,11,3,76
North Carolina,Harmony,592,102,145,105,26,17,395
North Carolina,Rural Hall,3137,241,859,781,351,75,2307
North Carolina,Statesville,26263,2845,4934,6038,2639,1184,17640
North Carolina,Gibsonville,7024,489,1033,1588,829,604,4543
North Carolina,Aulander,831,144,157,206,22,7,536
North Carolina,Lewiston Woodville,808,80,163,184,23,34,484
North Carolina,Elizabethtown,3525,561,626,674,536,137,2534
North Carolina,Swannanoa,4288,519,1298,661,539,152,3169
North Carolina,Pittsboro,4098,262,700,778,683,598,3021
North Carolina,Brookford,483,79,152,118,15,8,372
North Carolina,Brices Creek,4078,65,584,696,746,458,2549
North Carolina,Royal Pines,4921,128,591,1186,1088,557,3550
North Carolina,Vass,658,58,111,127,81,19,396
North Carolina,Southern Pines,13694,779,1417,2816,2946,2381,10339
North Carolina,Yadkinville,2908,383,674,668,131,64,1920
North Carolina,Wagram,777,89,212,184,48,10,543
North Carolina,Lansing,182,33,32,33,7,2,107
North Carolina,Pantego,211,14,36,52,12,30,144
North Carolina,Bryson City,1709,273,357,348,168,73,1219
North Carolina,Fuquay-Varina,25932,1139,3568,4632,5054,2187,16580
North Carolina,Franklinville,1106,155,312,174,38,11,690
North Carolina,White Plains,1150,132,367,233,73,27,832
North Carolina,Norwood,2800,272,793,595,145,80,1885
North Carolina,Stanfield,1498,165,260,347,140,88,1000
North Carolina,Hemby Bridge,2044,257,446,346,174,44,1267
North Carolina,Neuse Forest,1377,76,323,388,154,139,1080
North Carolina,Marshville,2644,420,761,484,94,12,1771
North Carolina,Unionville,6826,411,1995,1310,774,283,4773
North Carolina,Kittrell,199,15,39,68,10,0,132
North Carolina,Seagrove,348,53,81,89,13,13,249
North Carolina,Thomasville,26839,3661,6621,5302,1898,615,18097
North Carolina,Foxfire,1189,42,160,324,254,138,918
North Carolina,Everetts,139,31,43,19,1,0,94
North Carolina,Mountain View,3715,147,929,932,426,192,2626
North Carolina,Sylva,2672,220,396,512,370,210,1708
North Carolina,Hot Springs,603,101,128,92,67,14,402
North Carolina,Cameron,390,27,86,93,54,13,273
North Carolina,Mineral Springs,2956,182,613,617,462,281,2155
North Carolina,Southern Shores,2850,58,252,579,723,619,2231
North Carolina,Lillington,3509,538,1009,898,214,108,2767
North Carolina,Hassell,24,0,11,11,2,0,24
North Carolina,Castle Hayne,1023,102,261,238,135,0,736
North Carolina,Rich Square,898,122,312,185,64,21,704
North Carolina,Eden,15121,1964,3975,3242,1048,511,10740
North Carolina,Cleveland,1163,122,218,275,97,36,748
North Carolina,Broadway,1416,159,262,432,111,75,1039
North Carolina,Greenevers,742,178,140,168,38,10,534
North Carolina,Light Oak,1274,480,304,175,30,0,989
North Carolina,White Oak,260,17,76,57,21,4,175
North Carolina,Holden Beach,1012,17,90,239,278,209,833
North Carolina,Leland,19157,746,3080,4857,3652,1887,14222
North Carolina,China Grove,4177,507,1149,913,326,71,2966
North Carolina,Atlantic Beach,1736,66,218,571,303,304,1462
North Carolina,Shelby,20053,2375,4241,4028,2134,1312,14090
North Carolina,Waco,300,59,100,47,24,5,235
North Carolina,Gorman,906,59,407,92,71,27,656
North Carolina,Como,111,8,27,39,5,0,79
North Carolina,Murfreesboro,3069,265,325,629,216,192,1627
North Carolina,Winton,849,137,163,168,56,16,540
North Carolina,Laurel Park,2883,145,283,729,650,517,2324
North Carolina,Louisburg,3490,295,476,741,216,228,1956
North Carolina,Robbinsville,656,160,95,202,2,6,465
North Carolina,Forest Hills,273,0,8,27,37,75,147
North Carolina,Hildebran,2052,279,545,371,94,74,1363
North Carolina,Troy,3348,461,921,713,251,108,2454
North Carolina,Newland,856,145,168,175,58,26,572
North Carolina,Harkers Island,1361,164,353,296,163,40,1016
North Carolina,Franklin,3943,475,856,729,594,130,2784
North Carolina,Charlotte,841611,62293,98605,155061,158942,84524,559425
North Carolina,Trenton,408,52,69,70,20,10,221
North Carolina,Harrisburg,15269,381,1582,2989,2822,1503,9277
North Carolina,Northlakes,1586,32,282,391,304,148,1157
North Carolina,Mesic,203,26,58,62,6,7,159
North Carolina,Millers Creek,1661,380,447,462,58,55,1402
North Carolina,Boone,18795,698,712,1503,1407,1188,5508
North Carolina,Seven Devils,304,7,27,84,90,63,271
North Carolina,Vander,1218,130,263,279,58,142,872
North Carolina,Grandfather,84,0,1,6,36,26,69
North Carolina,Wade,729,36,145,211,51,17,460
North Carolina,Hobgood,395,38,112,58,36,6,250
North Carolina,Love Valley,97,27,34,34,1,0,96
North Carolina,Troutman,2634,201,433,633,374,120,1761
North Carolina,Drexel,1789,228,402,462,130,108,1330
North Carolina,Badin,2036,330,671,543,131,18,1693
North Carolina,Dundarrach,36,8,28,0,0,0,36
North Carolina,East Arcadia,622,61,159,138,26,2,386
North Carolina,Calabash,1680,157,475,505,172,49,1358
North Carolina,Sandy Creek,224,42,48,96,12,6,204
North Carolina,Icard,2468,455,658,591,80,21,1805
North Carolina,Winston-Salem,242125,19608,38427,45222,32069,21492,156818
North Carolina,Frisco,145,9,17,70,25,0,121
North Carolina,Winterville,9546,323,1353,2256,1537,1085,6554
North Carolina,Elkin,4179,494,805,953,351,244,2847
North Carolina,Pinnacle,1010,150,140,94,73,48,505
North Carolina,Porters Neck,7802,210,818,1354,2083,1413,5878
North Carolina,Potters Hill,632,24,140,195,14,0,373
North Carolina,Riegelwood,712,79,220,131,15,0,445
North Carolina,Robbins,1743,351,295,223,29,46,944
North Carolina,Rocky Point,1772,424,265,337,100,48,1174
North Carolina,Rodanthe,125,10,26,60,23,6,125
North Carolina,Rougemont,695,8,174,170,174,33,559
North Carolina,Ruffin,359,10,138,57,36,0,241
North Carolina,Salvo,70,0,0,19,35,16,70
North Carolina,Scotch Meadows,419,36,23,73,129,57,318
North Carolina,South Mills,499,7,143,213,0,0,363
North Carolina,Southmont,978,108,275,201,183,31,798
North Carolina,Spivey's Corner,511,60,65,115,73,0,313
North Carolina,Stokes,716,0,194,208,71,0,473
North Carolina,Sunbury,224,19,66,51,0,48,184
North Carolina,Swan Quarter,474,41,235,64,0,0,340
North Carolina,Tyro,3903,431,880,926,183,160,2580
North Carolina,Valle Crucis,223,15,25,25,60,32,157
North Carolina,Wakulla,90,0,0,16,18,0,34
North Carolina,Waves,54,0,10,31,13,0,54
North Carolina,Centerville,345,51,42,108,10,7,218
North Carolina,High Shoals,675,60,234,146,31,6,477
North Carolina,Fontana Dam,10,0,10,0,0,0,10
North Carolina,Valley Hill,2148,268,373,681,249,240,1811
North Carolina,East Laurinburg,295,40,102,44,3,0,189
North Carolina,Varnamtown,476,34,107,147,65,25,378
North Carolina,Pinetown,110,0,29,62,9,0,100
North Carolina,Southport,3585,213,730,912,584,218,2657
North Carolina,Old Hundred,420,107,14,102,0,0,223
North Carolina,Moncure,732,204,93,144,54,40,535
North Carolina,Germanton,967,199,380,134,0,0,713
North Carolina,Gerton,293,10,125,40,65,20,260
North Carolina,Glenville,61,0,27,15,0,19,61
North Carolina,Gloucester,514,19,183,112,37,15,366
North Carolina,Gulf,336,53,0,52,0,95,200
North Carolina,Hallsboro,391,31,218,73,47,6,375
North Carolina,Hampstead,5717,180,877,1363,986,600,4006
North Carolina,Hatteras,511,0,131,143,150,52,476
North Carolina,Henrietta,387,62,150,31,0,0,243
North Carolina,Hiddenite,388,66,136,93,20,0,315
North Carolina,Hobucken,99,6,29,16,0,0,51
North Carolina,Hollister,740,131,166,164,17,14,492
North Carolina,Hoopers Creek,984,43,284,312,98,68,805
North Carolina,Horse Shoe,2362,137,511,652,312,211,1823
North Carolina,Iron Station,743,141,214,151,11,0,517
North Carolina,Jackson Heights,739,210,292,145,0,0,647
North Carolina,Lake Royale,2884,150,382,740,414,374,2060
North Carolina,Lake Santeetlah,51,0,4,12,21,11,48
North Carolina,Laurel Hill,1096,148,302,177,87,41,755
North Carolina,Lowgap,415,167,59,70,0,0,296
North Carolina,Mamers,1016,50,193,164,61,85,553
North Carolina,Manns Harbor,907,78,235,245,55,4,617
North Carolina,Marble,362,38,31,111,0,15,195
North Carolina,Marshallberg,326,0,87,139,24,51,301
North Carolina,Maury,1349,242,383,415,47,7,1094
North Carolina,Northchase,3678,191,812,1041,554,73,2671
North Carolina,Millingport,426,54,92,121,28,28,323
North Carolina,Moyock,3717,196,323,1291,373,253,2436
North Carolina,Northwest,922,105,244,190,57,55,651
North Carolina,Morrisville,25007,755,1508,3145,6316,4999,16723
North Carolina,Bald Head Island,234,0,7,32,87,108,234
North Carolina,Peletier,821,67,228,209,57,28,589
North Carolina,Pine Knoll Shores,1368,12,131,391,396,248,1178
North Carolina,Lawndale,807,180,220,192,14,9,615
North Carolina,Caswell Beach,430,2,45,112,121,120,400
North Carolina,Cramerton,4312,247,842,867,736,308,3000
North Carolina,Dallas,4650,884,967,987,253,112,3203
North Carolina,Kings Mountain,10955,1071,2840,2104,680,399,7094
North Carolina,Watha,178,28,66,58,3,0,155
North Carolina,Lowell,3612,522,1017,684,147,125,2495
North Carolina,Ranlo,3556,343,732,733,337,186,2331
North Carolina,Spencer Mountain,0,0,0,0,0,0,0
North Carolina,Mars Hill,2746,82,308,373,282,254,1299
North Carolina,Aberdeen,7419,419,1112,1832,1196,427,4986
North Carolina,Taylortown,782,79,190,233,56,15,573
North Carolina,Parkton,507,56,134,119,38,7,354
North Carolina,Simpson,428,32,98,121,56,18,325
North Carolina,Pumpkin Center,1708,86,437,566,96,19,1204
North Carolina,Topsail Beach,376,17,46,61,113,99,336
North Carolina,Swansboro,3145,232,439,653,450,353,2127
North Carolina,St. Helena,388,26,59,135,43,30,293
North Carolina,Oriental,996,36,196,293,159,150,834
North Carolina,Wallace,3922,680,902,929,197,71,2779
North Carolina,Dobbins Heights,928,158,195,209,57,3,622
North Carolina,White Lake,1072,43,245,221,143,143,795
North Carolina,Blowing Rock,1202,21,136,248,432,223,1060
North Carolina,Arapahoe,524,58,147,186,19,4,414
North Carolina,Vandemere,271,32,110,64,12,4,222
North Carolina,Indian Beach,199,0,43,50,55,32,180
North Carolina,Shallotte,3961,306,900,1119,367,290,2982
North Carolina,Andrews,1830,328,305,323,127,65,1148
North Carolina,Navassa,1677,263,471,371,100,63,1268
North Carolina,Windsor,3523,745,880,776,216,173,2790
North Carolina,Rockingham,8994,984,1936,2095,792,337,6144
North Carolina,Ellenboro,695,91,189,158,48,10,496
North Carolina,Danbury,191,15,30,45,45,7,142
North Carolina,Maxton,2494,325,641,610,82,37,1695
North Carolina,Oakboro,1872,179,392,421,208,86,1286
North Carolina,Walnut Cove,1599,201,468,377,108,51,1205
North Carolina,Lake Park,3753,157,371,1162,722,362,2774
North Carolina,Ocean Isle Beach,705,5,92,185,225,136,643
North Carolina,Monroe,34679,4887,6528,6701,2402,1039,21557
North Carolina,Waxhaw,14383,250,1338,2300,3287,1422,8597
North Carolina,Weddington,10574,240,792,1637,2789,1502,6960
North Carolina,Asheboro,25859,3833,4753,5346,2167,930,17029
North Carolina,High Point,111035,11027,17564,21725,14413,7222,71951
North Carolina,Marvin,6298,107,313,523,1674,1041,3658
North Carolina,Rosman,487,114,111,63,32,11,331
North Carolina,Staley,297,35,85,81,7,3,211
North Carolina,Grifton,2863,362,482,716,128,93,1781
North Carolina,Bolivia,257,21,41,72,1,12,147
North Carolina,Kelly,373,69,117,35,0,0,221
North Carolina,Roxobel,375,89,94,87,11,2,283
North Carolina,Powellsville,249,60,82,34,19,1,196
North Carolina,Grimesland,483,42,157,128,39,21,387
North Carolina,Columbus,1094,122,227,314,82,58,803
North Carolina,Winfall,653,65,137,167,40,16,425
North Carolina,Wake Forest,40159,950,3945,6514,9049,4442,24900
North Carolina,Garner,28731,1633,4130,6481,5708,1933,19885
North Carolina,Plymouth,3542,611,761,838,104,49,2363
North Carolina,Lumberton,21198,2779,4228,3883,1648,993,13531
North Dakota,Ross,97,15,7,39,0,0,61
North Dakota,Hebron,868,63,207,202,87,43,602
North Dakota,Flasher,369,59,59,87,27,25,257
North Dakota,LaMoure,762,63,161,179,82,29,514
North Dakota,Medora,138,0,26,34,38,17,115
North Dakota,Dazey,60,5,39,10,3,0,57
North Dakota,New Leipzig,199,18,49,75,28,8,178
North Dakota,Drake,429,40,90,91,25,17,263
North Dakota,Palermo,164,12,54,37,14,0,117
North Dakota,Dickey,38,2,10,6,3,0,21
North Dakota,Wyndmere,478,30,112,134,47,9,332
North Dakota,Crystal,109,12,36,26,6,1,81
North Dakota,St. Thomas,322,30,92,81,29,9,241
North Dakota,Walhalla,1035,104,250,205,116,20,695
North Dakota,Barton,0,0,0,0,0,0,0
North Dakota,Blanchard,6,0,3,0,0,3,6
North Dakota,Brooktree Park,106,0,0,17,45,0,62
North Dakota,Caledonia,33,0,5,28,0,0,33
North Dakota,Dahlen,46,0,4,13,16,0,33
North Dakota,De Lamere,27,0,6,6,4,0,16
North Dakota,Denhoff,25,0,4,11,4,0,19
North Dakota,Driscoll,78,6,21,19,4,0,50
North Dakota,East Fairview,52,14,4,14,1,1,34
North Dakota,Embden,27,0,10,6,6,0,22
North Dakota,Englevale,198,0,54,25,0,0,79
North Dakota,Foxholm,22,9,4,0,4,0,17
North Dakota,Green Acres,529,49,45,164,0,0,258
North Dakota,Harmon,257,31,9,86,55,0,181
North Dakota,Heil,16,2,2,3,3,6,16
North Dakota,Heimdal,7,0,0,7,0,0,7
North Dakota,Jessie,39,0,13,0,0,0,13
North Dakota,Ypsilanti,58,7,22,29,0,0,58
North Dakota,Sutton,6,0,3,3,0,0,6
North Dakota,Selz,25,0,0,12,0,0,12
North Dakota,Ruthville,147,13,42,30,9,5,99
North Dakota,Raleigh,12,2,1,7,2,0,12
North Dakota,Spiritwood,7,4,0,3,0,0,7
North Dakota,Auburn,19,0,10,6,0,0,16
North Dakota,Porcupine,263,5,36,28,27,0,96
North Dakota,Nash,47,14,33,0,0,0,47
North Dakota,Menoken,70,7,20,15,6,2,50
North Dakota,Manning,85,0,20,35,13,0,68
North Dakota,McLeod,5,0,0,5,0,0,5
North Dakota,Logan,239,6,52,33,38,10,139
North Dakota,Larson,12,8,0,4,0,0,12
North Dakota,Orrin,0,0,0,0,0,0,0
North Dakota,Glenburn,479,8,99,117,39,8,271
North Dakota,Gascoyne,12,0,1,7,3,0,11
North Dakota,Anamoose,257,26,85,71,14,5,201
North Dakota,Newburg,79,2,26,25,2,0,55
North Dakota,Sherwood,198,16,44,49,23,8,140
North Dakota,Wolford,36,4,15,6,1,0,26
North Dakota,Loma,11,0,3,6,2,0,11
North Dakota,Nekoma,29,0,9,8,9,0,26
North Dakota,Ambrose,11,0,2,6,3,0,11
North Dakota,Karlsruhe,65,16,22,14,1,1,54
North Dakota,Upham,158,12,39,58,15,0,124
North Dakota,Bucyrus,10,0,4,6,0,0,10
North Dakota,Parshall,1116,92,185,246,147,20,690
North Dakota,Crosby,1056,72,361,232,162,18,845
North Dakota,Almont,117,5,27,23,0,0,55
North Dakota,New Salem,962,72,317,191,143,62,785
North Dakota,Plaza,200,12,41,55,18,19,145
North Dakota,Bathgate,66,2,6,10,15,23,56
North Dakota,Langdon,1867,124,369,552,203,32,1280
North Dakota,Turtle Lake,550,25,156,124,74,23,402
North Dakota,Tappen,281,28,53,41,17,13,152
North Dakota,Bottineau,2199,124,459,476,265,112,1436
North Dakota,Stanley,2594,115,589,544,271,86,1605
North Dakota,Killdeer,894,81,213,161,131,35,621
North Dakota,Dunn Center,258,22,80,59,9,2,172
North Dakota,Buchanan,73,4,19,17,3,0,43
North Dakota,Voltaire,35,3,10,10,4,0,27
North Dakota,Great Bend,62,1,16,26,7,2,52
North Dakota,Hope,308,5,93,93,44,10,245
North Dakota,Shell Valley,1300,125,115,322,24,52,638
North Dakota,Rolette,876,50,104,199,81,33,467
North Dakota,Mapleton,992,24,134,310,135,18,621
North Dakota,Gladstone,373,17,112,43,12,1,185
North Dakota,Forbes,52,1,8,23,0,0,32
North Dakota,Cleveland,88,4,14,33,7,0,58
North Dakota,Pembina,504,8,169,146,53,9,385
North Dakota,Pillsbury,14,3,7,4,0,0,14
North Dakota,Halliday,379,27,67,71,32,10,207
North Dakota,Tolna,175,9,54,44,26,13,146
North Dakota,Grafton,4192,489,1079,936,287,99,2890
North Dakota,Esmond,83,17,14,30,4,2,67
North Dakota,Oberon,122,6,19,12,8,2,47
North Dakota,Oakes,2042,147,377,532,223,66,1345
North Dakota,Braddock,12,0,4,3,3,0,10
North Dakota,Columbus,127,3,15,38,14,6,76
North Dakota,Minnewaukan,228,7,30,46,62,20,165
North Dakota,Calvin,8,0,1,4,1,0,6
North Dakota,Forman,503,18,140,132,34,1,325
North Dakota,Alamo,44,1,7,17,4,0,29
North Dakota,Tioga,1121,100,308,297,76,35,816
North Dakota,Gwinner,1081,90,240,256,117,21,724
North Dakota,Wildrose,60,14,11,12,8,0,45
North Dakota,Aneta,278,18,71,47,17,1,154
North Dakota,Michigan City,190,13,43,76,29,4,165
North Dakota,Osnabrock,158,30,50,34,7,0,121
North Dakota,Maddock,401,20,108,94,45,16,283
North Dakota,Lakota,708,50,124,192,102,24,492
North Dakota,Amidon,20,5,1,4,6,4,20
North Dakota,Riverdale,221,4,54,91,34,14,197
North Dakota,Hampden,22,1,9,10,2,0,22
North Dakota,Sawyer,325,22,79,70,66,2,239
North Dakota,Cando,1110,85,233,353,113,47,831
North Dakota,Gardena,26,0,17,1,0,0,18
North Dakota,Landa,55,31,12,4,0,0,47
North Dakota,Willow City,184,4,64,50,13,2,133
North Dakota,Marmarth,124,18,24,13,21,2,78
North Dakota,Benedict,77,17,18,16,12,0,63
North Dakota,Hatton,736,34,165,221,84,31,535
North Dakota,Wing,128,7,27,32,25,3,94
North Dakota,Buxton,426,14,74,145,48,19,300
North Dakota,Grandin,211,8,62,57,17,3,147
North Dakota,Portland,637,39,104,135,112,27,417
North Dakota,Wahpeton,7792,561,1186,1851,710,278,4586
North Dakota,Walcott,253,19,58,52,43,3,175
North Dakota,Ruso,8,1,1,0,0,0,2
North Dakota,Casselton,2508,69,290,707,394,119,1579
North Dakota,Wilton,948,85,166,243,83,36,613
North Dakota,Richardton,766,49,210,162,77,17,515
North Dakota,Hunter,217,5,52,65,41,1,164
North Dakota,Kenmare,922,54,357,211,100,21,743
North Dakota,Sykeston,96,10,17,31,9,6,73
North Dakota,Surrey,1043,39,285,252,133,44,753
North Dakota,McHenry,76,3,7,27,5,1,43
North Dakota,Mott,763,62,203,203,71,30,569
North Dakota,Emerado,370,16,93,103,32,2,246
North Dakota,Erie,49,0,14,25,0,0,39
North Dakota,Munich,292,26,54,77,18,5,180
North Dakota,Max,355,22,84,79,36,4,225
North Dakota,Washburn,1509,63,328,419,243,56,1109
North Dakota,Fort Totten,1311,105,182,187,11,2,487
North Dakota,York,26,0,3,7,4,0,14
North Dakota,Ardoch,49,20,9,0,14,0,43
North Dakota,Minto,783,78,212,146,42,10,488
North Dakota,Strasburg,349,64,91,87,32,6,280
North Dakota,South Heart,304,37,92,48,43,9,229
North Dakota,Dickinson,22707,1148,4556,5468,2493,983,14648
North Dakota,Buffalo,226,6,41,80,28,5,160
North Dakota,Hazelton,267,13,73,51,21,6,164
North Dakota,Taylor,223,3,60,34,46,8,151
North Dakota,Ludden,36,2,15,8,2,0,27
North Dakota,Crary,78,17,10,20,6,5,58
North Dakota,Devils Lake,7317,512,1727,1576,907,273,4995
North Dakota,Lincoln,3594,102,521,829,449,184,2085
North Dakota,Mayville,1813,68,238,378,240,132,1056
North Dakota,Reynolds,306,11,60,103,32,8,214
North Dakota,Hannaford,102,8,43,35,9,3,98
North Dakota,Amenia,91,6,22,20,15,2,65
North Dakota,Fordville,220,12,36,57,28,8,141
North Dakota,Forest River,102,25,30,28,6,0,89
North Dakota,Lankin,93,14,15,29,10,2,70
North Dakota,Martin,66,3,20,23,3,2,51
North Dakota,Coleharbor,63,5,22,33,2,0,62
North Dakota,White Shield,243,24,46,50,11,12,143
North Dakota,Monango,47,0,2,23,1,0,26
North Dakota,Briarwood,47,0,6,15,6,4,31
North Dakota,Bowdon,168,22,52,36,17,4,131
North Dakota,Clifford,25,0,10,13,2,0,25
North Dakota,McVille,323,8,78,139,27,8,260
North Dakota,Hannah,14,0,4,2,0,0,6
North Dakota,Fingal,121,1,25,41,6,0,73
North Dakota,Leal,15,0,6,6,1,2,15
North Dakota,Rutland,140,10,39,41,15,1,106
North Dakota,Elgin,643,66,182,190,49,22,509
North Dakota,Carson,239,18,56,75,32,6,187
North Dakota,Barney,53,1,11,14,6,9,41
North Dakota,Rugby,2677,190,700,721,258,139,2008
North Dakota,Dwight,99,8,18,36,1,2,65
North Dakota,Belfield,975,167,201,216,46,12,642
North Dakota,Luverne,38,2,12,9,0,2,25
North Dakota,Butte,91,15,31,12,2,3,63
North Dakota,Garrison,1537,129,443,312,167,18,1069
North Dakota,Mercer,43,5,17,13,2,1,38
North Dakota,Underwood,803,47,261,194,67,8,577
North Dakota,Milton,71,5,36,21,1,0,63
North Dakota,Fredonia,34,2,14,8,2,0,26
North Dakota,Epping,72,5,23,20,9,0,57
North Dakota,Westhope,341,36,92,85,51,13,277
North Dakota,Neche,361,38,112,50,35,7,242
North Dakota,Grenora,208,10,35,47,11,5,108
North Dakota,Dawson,39,7,21,7,0,0,35
North Dakota,Pettibone,91,8,36,26,3,0,73
North Dakota,Tuttle,86,11,29,26,8,3,77
North Dakota,Deering,114,3,27,23,22,1,76
North Dakota,Towner,571,76,146,119,42,19,402
North Dakota,Rhame,265,24,73,72,9,5,183
North Dakota,Souris,63,6,25,19,3,0,53
North Dakota,Kathryn,59,12,16,17,6,1,52
North Dakota,Sibley,46,4,18,6,0,0,28
North Dakota,Colfax,180,4,10,55,42,9,120
North Dakota,Mooreton,199,11,42,58,15,5,131
North Dakota,Kensal,250,14,90,42,3,1,150
North Dakota,Berlin,42,2,11,11,2,0,26
North Dakota,Marion,122,4,27,37,21,0,89
North Dakota,Mandan,21943,1310,4155,5339,3233,1094,15131
North Dakota,Sanborn,169,9,79,30,9,1,128
North Dakota,Conway,17,3,9,2,0,0,14
North Dakota,Wales,41,2,5,12,1,0,20
North Dakota,Milnor,703,33,179,222,70,19,523
North Dakota,New Rockford,1436,132,329,293,134,99,987
North Dakota,Solen,89,3,35,18,5,3,64
North Dakota,Wimbledon,221,2,48,59,21,18,148
North Dakota,Fortuna,8,0,2,3,0,0,5
North Dakota,Bowman,1552,134,295,300,220,76,1025
North Dakota,Noonan,324,4,105,56,14,0,179
North Dakota,Cavalier,1191,103,327,263,178,37,908
North Dakota,Gackle,312,39,79,88,23,8,237
North Dakota,Mohall,729,40,185,208,108,11,552
North Dakota,Robinson,31,1,12,5,7,0,25
North Dakota,Hettinger,1152,44,320,282,141,63,850
North Dakota,New Town,2495,126,435,572,163,103,1399
North Dakota,Hoople,342,38,54,61,46,15,214
North Dakota,Prairie Rose,53,0,12,11,9,7,39
North Dakota,Sharon,55,3,10,18,19,0,50
North Dakota,Bismarck,71731,3286,11715,16821,12679,4684,49185
North Dakota,Oriska,130,15,17,46,6,2,86
North Dakota,Cogswell,71,18,28,14,4,1,65
North Dakota,Lansford,288,16,58,82,22,4,182
North Dakota,Jamestown,15368,944,3641,3372,1831,530,10318
North Dakota,Ray,479,26,142,115,48,16,347
North Dakota,Williston,26102,1250,4253,6721,3665,790,16679
North Dakota,Churchs Ferry,8,0,6,2,0,0,8
North Dakota,Edmore,204,27,36,59,36,10,168
North Dakota,Grano,3,0,1,0,0,2,3
North Dakota,Canton City,24,2,5,6,4,0,17
North Dakota,Hamilton,60,2,22,19,0,0,43
North Dakota,Dodge,145,30,33,19,6,0,88
North Dakota,Horace,2660,88,357,522,596,257,1820
North Dakota,Brocket,53,0,9,13,3,1,26
North Dakota,Edinburg,171,6,46,53,31,4,140
North Dakota,Davenport,291,18,72,84,27,4,205
North Dakota,Pekin,61,13,10,5,11,1,40
North Dakota,Beulah,3296,151,553,983,314,165,2166
North Dakota,Minot AFB,5384,31,176,880,475,208,1770
North Dakota,Fort Ransom,101,14,27,23,12,8,84
North Dakota,Springbrook,9,0,0,6,3,0,9
North Dakota,Hamberg,22,11,3,3,4,1,22
North Dakota,Kramer,56,5,10,24,2,0,41
North Dakota,Cooperstown,1104,86,216,295,147,29,773
North Dakota,Valley City,6487,446,1244,1516,856,465,4527
North Dakota,Leith,47,1,10,13,2,3,29
North Dakota,Abercrombie,216,4,61,88,13,1,167
North Dakota,Haynes,20,4,8,3,3,0,18
North Dakota,Glen Ullin,791,94,223,184,81,34,616
North Dakota,Reeder,130,10,33,48,12,0,103
North Dakota,Courtenay,58,4,16,9,6,0,35
North Dakota,Hankinson,971,56,237,232,88,33,646
North Dakota,Watford City,6197,247,1025,1408,677,281,3638
North Dakota,White Earth,140,0,19,24,18,0,61
North Dakota,Maxbass,106,8,19,14,3,4,48
North Dakota,Steele,764,55,197,174,85,35,546
North Dakota,Balfour,23,1,20,0,2,0,23
North Dakota,Napoleon,860,98,189,202,84,19,592
North Dakota,Bantry,8,3,0,2,1,0,6
North Dakota,Kief,20,0,12,5,0,0,17
North Dakota,Verona,58,19,23,6,0,2,50
North Dakota,Selfridge,271,24,77,39,17,12,169
North Dakota,Douglas,59,4,11,17,9,0,41
North Dakota,Hazen,2610,119,540,751,338,81,1829
North Dakota,Frontier,478,2,107,112,82,40,343
North Dakota,Harwood,728,18,110,180,184,20,512
North Dakota,Kindred,846,24,109,170,179,36,518
North Dakota,Reile's Acres,521,8,47,97,125,50,327
North Dakota,Wheatland,37,15,0,22,0,0,37
North Dakota,Carpio,139,1,48,39,11,0,99
North Dakota,Des Lacs,220,9,59,52,15,9,144
North Dakota,St. John,270,23,73,50,18,6,170
North Dakota,Pisek,116,13,28,19,2,2,64
North Dakota,Harvey,1758,227,371,408,202,57,1265
North Dakota,Bisbee,112,11,37,36,6,0,90
North Dakota,Sarles,14,0,1,2,6,0,9
North Dakota,Enderlin,910,57,279,261,91,20,708
North Dakota,Rocklake,104,9,19,23,22,6,79
North Dakota,Finley,452,24,119,125,60,11,339
North Dakota,Oxbow,301,0,13,44,108,36,201
North Dakota,Center,604,37,150,155,77,5,424
North Dakota,Fargo,120209,4487,14876,25460,20621,8663,74107
North Dakota,Bowbells,347,7,71,102,51,20,251
North Dakota,Alsen,52,0,3,4,23,0,30
North Dakota,Granville,255,16,72,59,28,3,178
North Dakota,Tolley,25,5,7,13,0,0,25
North Dakota,Lidgerwood,639,91,167,180,38,6,482
North Dakota,Ashley,604,121,123,188,76,39,547
North Dakota,Arnegard,55,0,19,27,1,0,47
North Dakota,Four Bears Village,426,5,95,77,19,12,208
North Dakota,Velva,1292,69,274,313,128,45,829
North Dakota,Bergen,11,0,10,0,0,0,10
North Dakota,Cannon Ball,945,64,172,138,56,20,450
North Dakota,Nome,52,0,12,21,2,1,36
North Dakota,Rogers,54,2,4,25,2,0,33
North Dakota,Christine,175,1,41,45,32,0,119
North Dakota,Fairmount,377,22,89,83,37,4,235
North Dakota,Mantador,52,2,6,19,0,0,27
North Dakota,Pingree,53,4,13,8,2,6,33
North Dakota,Spiritwood Lake,109,6,34,22,28,5,95
North Dakota,Litchville,205,17,41,56,6,9,129
North Dakota,Lignite,159,3,35,32,24,10,104
North Dakota,Mandaree,606,28,95,122,12,12,269
North Dakota,Wishek,965,193,176,207,84,47,707
North Dakota,Scranton,339,9,66,119,20,12,226
North Dakota,Fort Yates,211,17,47,41,19,1,125
North Dakota,Balta,128,2,66,6,3,0,77
North Dakota,Calio,3,0,3,0,0,0,3
North Dakota,Cayuga,56,2,20,15,0,0,37
North Dakota,Havana,57,6,15,11,9,3,44
North Dakota,Medina,271,32,82,42,18,11,185
North Dakota,Zeeland,89,6,18,22,8,0,54
North Dakota,Montpelier,93,4,18,24,17,0,63
North Dakota,Woodworth,50,7,15,11,3,2,38
North Dakota,Edgeley,516,65,111,150,63,22,411
North Dakota,Jud,75,10,20,15,6,0,51
North Dakota,Kulm,417,42,60,108,65,25,300
North Dakota,Fullerton,59,1,21,24,4,2,52
North Dakota,Sheyenne,197,14,38,78,16,6,152
North Dakota,Lehr,83,21,33,21,4,2,81
North Dakota,Streeter,116,21,20,31,16,3,91
North Dakota,Elliott,22,2,2,6,5,2,17
North Dakota,Drayton,702,39,169,201,97,22,528
North Dakota,Grand Forks AFB,2685,22,106,522,188,132,970
North Dakota,Carrington,2020,120,450,547,291,100,1508
North Dakota,Golva,64,2,19,23,10,1,55
North Dakota,Beach,1015,74,177,269,179,48,747
North Dakota,Starkweather,89,1,16,32,14,3,66
North Dakota,Goodrich,96,13,28,18,1,4,64
North Dakota,McClusky,411,74,128,82,18,10,312
North Dakota,Dunseith,678,80,146,108,60,16,410
North Dakota,New England,674,79,206,172,36,11,504
North Dakota,Gardner,90,2,37,14,11,0,64
North Dakota,Knox,25,2,14,6,0,0,22
North Dakota,Leeds,549,28,103,182,42,14,369
North Dakota,Adams,165,13,33,32,18,2,98
North Dakota,Grace City,94,2,30,20,4,0,56
North Dakota,Alice,29,2,11,4,2,0,19
North Dakota,Ayr,11,0,7,4,0,0,11
North Dakota,Thompson,1139,39,125,285,196,70,715
North Dakota,Park River,1489,173,336,378,149,55,1091
North Dakota,Inkster,32,2,14,4,7,0,27
North Dakota,Regent,180,9,34,41,16,7,107
North Dakota,Argusville,521,6,39,100,119,36,300
North Dakota,Northwood,790,45,154,198,141,44,582
North Dakota,Linton,1019,151,245,238,159,14,807
North Dakota,Hague,64,14,23,8,3,0,48
North Dakota,Ellendale,1201,104,223,195,200,52,774
North Dakota,Powers Lake,316,19,62,75,23,5,184
North Dakota,Flaxton,117,6,19,30,4,3,62
North Dakota,Loraine,13,0,0,12,0,0,12
North Dakota,Galesburg,173,19,32,50,12,6,119
North Dakota,Alexander,316,20,80,71,17,3,191
North Dakota,Overly,16,0,6,10,0,0,16
North Dakota,Perth,6,0,2,0,2,0,4
North Dakota,Portal,141,9,20,52,21,0,102
North Dakota,Hansboro,22,3,0,6,9,0,18
North Dakota,Binford,178,9,62,38,26,0,135
North Dakota,Antler,30,7,6,3,2,3,21
North Dakota,Mountain,66,17,18,9,10,8,62
North Dakota,Venturia,15,0,10,4,0,0,14
North Dakota,Manvel,367,8,66,102,33,12,221
North Dakota,Lawton,15,4,4,5,0,2,15
North Dakota,Egeland,36,2,11,17,1,0,31
North Dakota,Gilby,223,10,50,75,15,5,155
North Dakota,Grand Forks,56556,1677,7300,11792,7611,4092,32472
North Dakota,Larimore,1461,43,298,394,102,56,893
North Dakota,Lisbon,2052,98,595,459,229,69,1450
North Dakota,Niagara,44,3,16,12,6,0,37
North Dakota,Petersburg,168,8,31,43,24,7,113
North Dakota,Arthur,326,16,60,91,58,14,239
North Dakota,Burlington,1477,46,390,231,166,49,882
North Dakota,Leonard,263,7,48,83,26,16,180
North Dakota,Cathay,29,2,11,4,1,0,18
North Dakota,West Fargo,34419,740,4026,7982,6307,2879,21934
North Dakota,Mylo,11,0,6,0,5,0,11
North Dakota,Berthold,459,15,128,140,37,19,339
North Dakota,Makoti,106,2,26,38,4,4,74
North Dakota,Ryder,120,7,26,33,2,2,70
North Dakota,Regan,41,7,8,15,3,0,33
North Dakota,Sentinel Butte,134,0,27,23,13,3,66
North Dakota,Glenfield,124,8,6,42,6,5,67
North Dakota,Hillsboro,1610,141,312,449,174,70,1146
North Dakota,Hurdsfield,36,2,16,3,4,1,26
North Dakota,Zap,157,17,50,32,10,0,109
North Dakota,Rolla,1321,93,197,301,193,46,830
North Dakota,Sheldon,113,7,36,42,7,0,92
North Dakota,Brinsmade,30,0,11,6,4,0,21
North Dakota,East Dunseith,528,64,71,133,4,0,272
North Dakota,Minot,48304,2280,9586,10124,6696,2408,31094
North Dakota,Pick City,131,16,43,41,8,0,108
North Dakota,Stanton,337,33,85,125,12,3,258
North Dakota,Warwick,77,8,16,4,3,3,34
North Dakota,Fairdale,35,4,7,9,5,2,27
North Dakota,Tower City,280,4,68,74,34,11,191
North Dakota,Donnybrook,70,7,13,15,9,0,44
North Dakota,Page,269,3,47,71,23,0,144
North Dakota,Belcourt,2038,239,211,468,269,34,1221
North Dakota,North River,59,0,9,19,12,5,45
North Dakota,Fessenden,552,32,119,94,83,11,339
North Dakota,Golden Valley,237,20,66,83,15,3,187
Ohio,Addyston,1040,166,340,136,35,11,688
Ohio,Gratis,915,48,288,262,52,12,662
Ohio,Roswell,226,24,104,19,11,7,165
Ohio,Port Washington,447,44,213,51,16,10,334
Ohio,Bolivar,1193,66,307,327,119,40,859
Ohio,North Robinson,354,37,163,60,18,0,278
Ohio,West Millgrove,128,18,17,33,5,3,76
Ohio,Perrysburg,21430,379,2290,3972,4459,3386,14486
Ohio,Golf Manor,3549,336,723,810,450,193,2512
Ohio,Finneytown,12689,657,1874,2918,1735,1491,8675
Ohio,Mount Gilead,3428,185,1089,735,218,159,2386
Ohio,Harrisburg,498,34,176,110,35,7,362
Ohio,Clarksville,681,45,190,113,32,0,380
Ohio,Marengo,301,26,112,47,4,14,203
Ohio,Donnelsville,370,10,98,71,28,35,242
Ohio,South Bloomfield,2116,243,534,385,157,44,1363
Ohio,Rittman,6541,653,1885,1126,530,200,4394
Ohio,Mount Carmel,5372,385,1367,1011,417,197,3377
Ohio,Chilo,123,34,25,12,5,0,76
Ohio,Unionville Center,369,106,90,54,19,12,281
Ohio,Milford Center,920,20,320,151,63,6,560
Ohio,Akron,198314,17646,45701,42003,18514,9730,133594
Ohio,Glendale,2228,31,215,391,613,466,1716
Ohio,Beaver,471,56,160,73,19,15,323
Ohio,Sycamore,1031,56,257,210,95,30,648
Ohio,Cygnet,634,44,165,116,35,7,367
Ohio,Pemberville,1590,46,338,348,210,120,1062
Ohio,Luckey,949,54,259,208,102,45,668
Ohio,Hoytville,357,41,78,69,36,1,225
Ohio,Custar,200,15,78,34,2,0,129
Ohio,Bradner,1074,30,394,210,36,5,675
Ohio,Bowling Green,31541,776,3051,3518,2929,2846,13120
Ohio,Gibsonburg,2591,176,605,639,124,46,1590
Ohio,Clyde,6213,442,1899,1576,279,73,4269
Ohio,Sciotodale,1057,56,462,260,47,32,857
Ohio,Martinsville,492,42,159,85,9,4,299
Ohio,West Milton,4728,501,1328,1127,369,165,3490
Ohio,Ludlow Falls,260,19,97,52,8,12,188
Ohio,Franklin Furnace,1582,170,461,407,86,44,1168
Ohio,Fletcher,468,47,152,85,7,6,297
Ohio,Elida,2120,74,559,451,165,158,1407
Ohio,Albany,833,63,246,161,95,42,607
Ohio,Flushing,875,29,305,210,39,19,602
Ohio,McComb,1711,120,509,354,88,62,1133
Ohio,Fort Loramie,1521,35,401,270,145,113,964
Ohio,Fairfield Beach,1084,87,345,318,78,45,873
Ohio,Troy,25894,1920,5820,5391,2905,1487,17523
Ohio,Tipp City,9912,428,2093,2218,1353,979,7071
Ohio,Portsmouth,20366,2303,5276,3925,1131,780,13415
Ohio,Rarden,192,33,92,38,0,5,168
Ohio,Cheviot,8318,524,1983,1977,818,504,5806
Ohio,Blue Ash,12150,260,1163,2372,2433,2266,8494
Ohio,Reynoldsburg,37644,1525,6706,8444,4944,2797,24416
Ohio,Amanda,827,65,205,205,29,18,522
Ohio,Harrisville,190,14,94,27,13,4,152
Ohio,Cadiz,3196,297,912,739,175,121,2244
Ohio,Leavittsburg,1516,66,634,245,44,36,1025
Ohio,Wilkesville,178,16,59,30,14,2,121
Ohio,North Lewisburg,1607,114,522,289,84,16,1025
Ohio,Green Springs,1376,79,565,256,41,17,958
Ohio,Bloomville,1034,56,385,169,38,23,671
Ohio,Woodsfield,2371,254,733,514,128,100,1729
Ohio,Beallsville,384,25,151,69,7,4,256
Ohio,Timberlake,751,20,193,220,103,33,569
Ohio,Gnadenhutten,1484,76,406,232,130,71,915
Ohio,Caldwell,2172,137,789,425,115,123,1589
Ohio,Ottawa Hills,4436,68,233,351,1067,1221,2940
Ohio,Parral,207,12,98,48,7,4,169
Ohio,Centerburg,1673,110,530,337,135,38,1150
Ohio,Ballville,2737,102,689,750,314,245,2100
Ohio,Montezuma,142,0,51,53,6,1,111
Ohio,Deer Park,5688,372,1330,1361,932,375,4370
Ohio,Leesville,283,8,137,58,11,1,215
Ohio,Haskins,1126,40,162,278,153,72,705
Ohio,Evendale,2859,78,350,428,756,587,2199
Ohio,North Perry,701,21,181,157,88,55,502
Ohio,Ottoville,816,10,200,204,86,50,550
Ohio,Beechwood Trails,3297,77,719,640,504,315,2255
Ohio,Trenton,12755,648,3057,2768,936,333,7742
Ohio,Wright-Patterson AFB,2579,106,100,365,213,212,996
Ohio,Gilboa,163,8,46,34,8,2,98
Ohio,North Baltimore,3316,291,976,539,182,79,2067
Ohio,Nevada,841,75,271,185,34,10,575
Ohio,McGuffey,514,56,174,84,14,5,333
Ohio,Logan Elm Village,1022,58,384,198,67,7,714
Ohio,Walton Hills,2215,122,720,506,360,163,1871
Ohio,Wadsworth,23155,610,4464,5074,3920,1971,16039
Ohio,Tiltonsville,1385,106,460,315,92,60,1033
Ohio,Norwalk,16881,1510,5047,3070,1034,737,11398
Ohio,Quincy,605,84,161,124,22,10,401
Ohio,Republic,625,32,193,140,25,9,399
Ohio,Mount Healthy Heights,2796,147,599,744,209,7,1706
Ohio,Churchill,2328,190,758,445,143,87,1623
Ohio,Van Wert,11077,792,3453,2037,687,431,7400
Ohio,Columbus,867628,60198,145917,161429,132735,71527,571806
Ohio,Mount Blanchard,466,30,133,90,43,7,303
Ohio,Weston,1543,137,405,367,93,28,1030
Ohio,Lindsey,517,19,162,106,50,27,364
Ohio,Fort Recovery,1487,62,431,244,106,63,906
Ohio,North Fairfield,486,39,171,87,17,7,321
Ohio,Burton,1266,102,294,311,145,64,916
Ohio,Morrow,1660,94,375,347,179,68,1063
Ohio,Pandora,1048,44,285,249,96,79,753
Ohio,Belmore,106,18,31,24,1,1,75
Ohio,Avon Lake,23777,578,3051,4674,4922,3508,16733
Ohio,Lewisville,197,11,83,51,1,3,149
Ohio,Summerfield,224,25,83,59,1,8,176
Ohio,Berkey,286,4,75,74,27,23,203
Ohio,Benton Ridge,357,25,145,79,14,5,268
Ohio,Pickerington,20148,577,2672,3902,3592,1974,12717
Ohio,Amberley,3780,51,400,473,881,872,2677
Ohio,Richwood,2381,192,760,440,106,49,1547
Ohio,Magnolia,1006,30,312,175,79,59,655
Ohio,Montpelier,3960,515,1207,752,190,171,2835
Ohio,Chagrin Falls,4061,100,264,620,1172,777,2933
Ohio,Rome,67,23,25,3,1,0,52
Ohio,Junction City,893,110,251,118,35,0,514
Ohio,Marseilles,92,6,48,13,2,1,70
Ohio,Crooksville,2675,233,991,475,29,11,1739
Ohio,Wellsville,3393,493,966,575,101,9,2144
Ohio,Venedocia,142,11,47,25,2,3,88
Ohio,Ohio City,833,59,325,141,34,10,569
Ohio,Tuscarawas,1461,81,586,242,98,17,1024
Ohio,Champion Heights,6495,341,2054,1410,602,274,4681
Ohio,South Zanesville,2253,209,880,405,20,45,1559
Ohio,Avon,22786,521,2621,4329,4388,2944,14803
Ohio,East Sparta,922,65,284,220,52,15,636
Ohio,Kenwood,7244,134,719,1189,1746,1431,5219
Ohio,Chesterhill,491,31,130,95,9,17,282
Ohio,Smithfield,787,54,209,173,25,28,489
Ohio,Stockport,745,81,188,129,16,11,425
Ohio,Caledonia,774,34,238,192,29,26,519
Ohio,Norton,12047,703,2898,2719,1495,768,8583
Ohio,Limaville,235,2,77,44,3,21,147
Ohio,Bainbridge,2870,10,151,429,820,501,1911
Ohio,Bergholz,745,39,270,80,37,18,444
Ohio,Burgoon,186,9,47,54,10,0,120
Ohio,Ney,226,15,80,47,11,2,155
Ohio,Huntsville,484,25,189,90,29,2,335
Ohio,Bay View,712,56,234,155,49,17,511
Ohio,Burkettsville,270,9,107,34,27,4,181
Ohio,Mount Victory,590,30,213,136,22,8,409
Ohio,Fairport Harbor,3091,157,807,778,326,231,2299
Ohio,Mogadore,3645,222,1142,523,411,197,2495
Ohio,Congress,213,22,42,20,4,0,88
Ohio,Liberty Center,1234,36,441,236,87,27,827
Ohio,Enon,2479,150,405,641,298,324,1818
Ohio,Blakeslee,52,4,20,10,6,0,40
Ohio,Baltimore,2982,77,941,589,188,115,1910
Ohio,Alger,943,133,294,146,33,11,617
Ohio,Hills and Dales,300,4,23,33,80,84,224
Ohio,Midway,316,36,111,51,11,3,212
Ohio,London,10139,816,2921,2178,721,352,6988
Ohio,Wauseon,7531,443,2021,1318,794,170,4746
Ohio,Twinsburg,18915,495,3342,3219,3776,2355,13187
Ohio,Richfield,3647,128,614,837,639,384,2602
Ohio,Hudson,22287,331,1581,2592,6008,5007,15519
Ohio,South Charleston,1937,190,480,451,108,57,1286
Ohio,Woodlawn,3319,227,581,715,530,270,2323
Ohio,Turpin Hills,5351,107,309,732,1405,897,3450
Ohio,Lockland,3459,565,1257,434,74,32,2362
Ohio,Harrison,11521,649,3006,2429,1179,482,7745
Ohio,Groesbeck,6656,297,1620,1734,784,344,4779
Ohio,Fruit Hill,3931,34,479,952,696,294,2455
Ohio,Hamersville,808,93,234,154,54,11,546
Ohio,Solon,23038,505,2417,3195,4893,4789,15799
Ohio,Bedford Heights,10633,705,2795,3350,788,316,7954
Ohio,North Olmsted,31888,1768,6956,7430,4785,2324,23263
Ohio,Adamsville,159,20,47,27,4,4,102
Ohio,Obetz,4740,406,1470,893,342,73,3184
Ohio,Mantua,1204,50,448,240,113,41,892
Ohio,Kent,29824,863,3377,3921,2668,2996,13825
Ohio,Ashville,4143,203,911,697,278,207,2296
Ohio,Holiday Valley,1390,54,299,415,162,148,1078
Ohio,Middleport,2137,320,628,440,108,75,1571
Ohio,Whitehall,18874,1941,4610,3430,1160,474,11615
Ohio,Riverlea,541,3,24,43,179,135,384
Ohio,Brice,85,12,25,24,4,1,66
Ohio,Blacklick Estates,9596,681,2848,1628,677,74,5908
Ohio,New Washington,1120,37,324,239,82,35,717
Ohio,Bucyrus,11906,967,3947,2525,767,394,8600
Ohio,Beaverdam,414,44,101,92,27,0,264
Ohio,Nelsonville,4990,345,1082,1086,229,77,2819
Ohio,Adelphi,285,46,115,25,3,0,189
Ohio,Pomeroy,1786,261,464,379,84,29,1217
Ohio,Bellevue,7987,341,2288,1837,549,272,5287
Ohio,Beckett Ridge,9114,210,1087,1228,2264,1548,6337
Ohio,Linndale,132,35,18,28,2,1,84
Ohio,Manchester,1933,327,520,255,83,59,1244
Ohio,Martinsburg,277,18,95,47,7,0,167
Ohio,Chesterland,2277,102,417,484,429,127,1559
Ohio,Green,25758,715,5185,5357,4124,2076,17457
Ohio,Clinton,1246,73,363,331,69,53,889
Ohio,Fulton,241,25,67,51,13,4,160
Ohio,Edison,494,47,171,101,12,4,335
Ohio,Williamsport,955,108,297,164,22,19,610
Ohio,Darbyville,204,31,63,31,8,0,133
Ohio,Springfield,59305,6538,15011,11480,3539,2151,38719
Ohio,South Vienna,585,13,160,134,29,33,369
Ohio,Crystal Lakes,1467,226,418,299,62,6,1011
Ohio,Clifton,157,8,23,51,30,5,117
Ohio,Milford,6861,668,1392,1294,1142,546,5042
Ohio,Batavia,1762,301,271,459,74,102,1207
Ohio,Yankee Lake,87,4,28,21,4,12,69
Ohio,Defiance,17105,1109,4673,3453,1316,628,11179
Ohio,Seaman,1117,75,312,187,44,18,636
Ohio,Fredericktown,2494,122,604,628,199,155,1708
Ohio,Patterson,152,12,46,37,1,4,100
Ohio,Proctorville,574,72,210,97,32,7,418
Ohio,Ironton,10912,901,3299,2252,862,476,7790
Ohio,Marion,36268,4015,10837,7784,1528,1116,25280
Ohio,Clarksburg,478,62,127,79,27,0,295
Ohio,Centerville,64,2,21,13,5,2,43
Ohio,Summitville,98,7,50,11,0,2,70
Ohio,Cumberland,353,36,107,71,17,7,238
Ohio,Cambridge,10432,1022,2816,2013,668,353,6872
Ohio,Thurston,627,47,187,106,16,4,360
Ohio,Lisbon,2713,296,864,431,141,111,1843
Ohio,Brookfield Center,1541,90,417,297,97,158,1059
Ohio,Gratiot,274,14,87,57,9,4,171
Ohio,Potsdam,328,16,125,60,9,7,217
Ohio,Laura,480,27,157,98,16,4,302
Ohio,Danville,1061,57,326,196,122,16,717
Ohio,Gambier,2498,3,29,108,128,299,567
Ohio,Fairfield,42636,2747,9876,8584,5308,2567,29082
Ohio,Millville,677,55,214,161,33,28,491
Ohio,Oxford,22612,530,929,1138,1464,1892,5953
Ohio,Metamora,628,41,173,117,55,17,403
Ohio,Lyons,521,30,173,133,33,5,374
Ohio,Apple Creek,1000,69,256,275,77,18,695
Ohio,Withamsville,7788,449,1909,1818,847,325,5348
Ohio,Neville,76,12,16,12,16,0,56
Ohio,Day Heights,2910,67,608,706,278,160,1819
Ohio,South Canal,894,35,430,116,98,39,718
Ohio,Worthington,14705,167,1255,1880,3944,3165,10411
Ohio,Glenwillow,1034,74,196,127,134,177,708
Ohio,Cleveland,387398,52433,85032,77225,26815,15914,257419
Ohio,Broadview Heights,19242,449,3003,3585,3875,2511,13423
Ohio,Bratenahl,1334,5,115,272,346,434,1172
Ohio,Gates Mills,2198,24,216,218,482,738,1678
Ohio,Ada,5970,295,839,523,455,375,2487
Ohio,Put-in-Bay,68,0,9,20,30,7,66
Ohio,Middlefield,2707,236,761,551,306,133,1987
Ohio,Oak Harbor,2724,168,593,651,212,186,1810
Ohio,Mechanicsburg,1591,141,442,323,88,34,1028
Ohio,South Solon,309,30,105,67,15,1,218
Ohio,Granville South,1324,10,46,150,328,307,841
Ohio,Wellston,5540,727,1448,895,267,151,3488
Ohio,College Corner,306,43,86,59,12,6,206
Ohio,Aberdeen,1538,202,474,323,92,35,1126
Ohio,Dayton,140782,14618,25991,31865,9907,6075,88456
Ohio,Kirtland Hills,702,13,91,96,142,159,501
Ohio,Greenwich,1559,117,485,254,85,31,972
Ohio,Creston,2091,153,766,342,112,38,1411
Ohio,Lexington,5073,237,1055,1229,629,358,3508
Ohio,Mineral Ridge,3477,402,1185,571,452,181,2791
Ohio,Higginsport,253,47,84,44,12,3,190
Ohio,Pleasant Hill,1305,54,370,239,119,54,836
Ohio,Lewisburg,1806,118,494,427,120,17,1176
Ohio,St. Louisville,500,18,146,96,20,10,290
Ohio,Ravenna,11552,1007,3351,2266,920,476,8020
Ohio,Mount Sterling,1988,128,670,388,77,41,1304
Ohio,Wetherington,1283,25,103,176,481,221,1006
Ohio,Jacksonburg,50,4,21,7,2,0,34
Ohio,Mount Orab,3714,400,891,680,223,182,2376
Ohio,Sinking Spring,191,3,36,39,6,1,85
Ohio,Mowrystown,353,46,122,51,15,0,234
Ohio,Lakeview,1196,132,431,244,36,5,848
Ohio,Cincinnati,300357,24184,47978,52219,40716,29587,194684
Ohio,Cleves,3394,237,712,566,386,146,2047
Ohio,Jewett,750,34,256,137,22,3,452
Ohio,Hopedale,961,72,367,251,65,19,774
Ohio,Tiffin,17599,934,4473,3430,1151,776,10764
Ohio,Scio,952,94,288,149,58,12,601
Ohio,Willowick,14160,733,3621,3589,1440,745,10128
Ohio,Lower Salem,113,3,20,35,5,2,65
Ohio,Spencer,594,47,266,100,24,6,443
Ohio,Beach City,940,102,340,155,43,6,646
Ohio,Utica,1801,196,499,402,116,58,1271
Ohio,Alliance,21927,1781,6131,3130,1489,1002,13533
Ohio,South Salem,278,18,80,53,12,9,172
Ohio,Morral,433,33,128,106,17,8,292
Ohio,Waldo,327,25,125,78,34,4,266
Ohio,Kettlersville,164,2,60,33,7,4,106
Ohio,Waynesville,3038,177,705,437,367,306,1992
Ohio,Mason,32749,656,3925,4252,7617,5332,21782
Ohio,Corwin,502,40,91,120,59,45,355
Ohio,Green Meadows,2366,67,657,621,214,90,1649
Ohio,Westerville,39242,746,5728,6787,8589,5392,27242
Ohio,Ostrander,955,27,220,155,121,74,597
Ohio,Ashley,1682,186,602,233,123,15,1159
Ohio,Uniontown,3250,212,640,720,423,263,2258
Ohio,Lebanon,20584,845,4514,4161,2744,1175,13439
Ohio,Kalida,1355,54,297,286,171,141,949
Ohio,Murray City,401,39,169,99,1,2,310
Ohio,Sidney,20639,1713,5370,4161,1306,1044,13594
Ohio,Russia,724,16,193,144,60,32,445
Ohio,Vandalia,15080,813,3521,4025,1828,802,10989
Ohio,Oakwood,9030,113,455,1510,1964,2075,6117
Ohio,Moraine,6445,537,1659,1516,454,86,4252
Ohio,West Leipsic,223,18,60,53,8,5,144
Ohio,Gann,129,7,54,21,6,0,88
Ohio,Haydenville,302,10,93,64,0,0,167
Ohio,Garrettsville,2594,82,701,575,268,138,1764
Ohio,Taylor Creek,3336,112,756,788,521,242,2419
Ohio,Sulphur Springs,127,4,25,67,9,8,113
Ohio,Stony Ridge,432,5,193,55,27,17,297
Ohio,Stockdale,19,0,0,0,0,19,19
Ohio,Stewart,327,25,45,60,0,14,144
Ohio,Sterling,406,18,98,148,15,14,293
Ohio,Skyline Acres,2522,89,613,630,131,13,1476
Ohio,Sixteen Mile Stand,2804,18,200,267,886,638,2009
Ohio,Shawnee,598,38,263,105,49,47,502
Ohio,Sawyerwood,1331,142,467,185,88,52,934
Ohio,Sardis,659,62,276,54,64,52,508
Ohio,Miamitown,1560,54,290,214,108,11,677
Ohio,Miami Heights,4873,162,1051,912,867,430,3422
Ohio,Melmore,160,23,36,0,12,11,82
Ohio,Marne,692,0,121,144,119,66,450
Ohio,Tedrow,116,14,30,32,6,0,82
Ohio,McKinley Heights,512,33,185,111,89,42,460
Ohio,Tuppers Plains,372,0,69,169,9,0,247
Ohio,Tippecanoe,90,46,19,0,0,0,65
Ohio,Miamiville,229,0,67,36,17,8,128
Ohio,Wolfhurst,1232,231,436,164,101,10,942
Ohio,Winesburg,279,48,92,88,24,0,252
Ohio,Williston,407,104,130,99,32,0,365
Ohio,Williamsdale,1076,98,361,80,26,7,572
Ohio,Wightmans Grove,47,18,20,9,0,0,47
Ohio,Whites Landing,478,16,111,20,101,45,293
Ohio,West Carrollton,12954,788,3301,3481,1057,421,9048
Ohio,Waterford,651,8,235,38,91,11,383
Ohio,Walnut Creek,1271,323,271,144,88,33,859
Ohio,Vincent,242,7,87,24,12,0,130
Ohio,Vickery,47,0,11,8,20,8,47
Ohio,Vaughnsville,203,0,38,118,0,0,156
Ohio,Twinsburg Heights,735,19,79,157,78,16,349
Ohio,Trinway,216,36,100,16,40,14,206
Ohio,Thornport,964,33,256,255,95,162,801
Ohio,Millfield,294,39,171,44,0,0,254
Ohio,Mack,11422,293,2136,1951,2236,987,7603
Ohio,McCutchenville,281,11,71,45,12,0,139
Ohio,Kansas,15,0,10,5,0,0,15
Ohio,Kanauga,110,52,11,17,0,0,80
Ohio,Iberia,623,97,224,138,0,0,459
Ohio,Howard,86,0,37,34,0,0,71
Ohio,Hooven,400,95,140,49,7,11,302
Ohio,Homeworth,476,26,275,40,47,14,402
Ohio,Holiday Lakes,590,25,178,154,69,32,458
Ohio,Hockingport,150,73,33,36,0,0,142
Ohio,Highpoint,1338,263,209,215,166,45,898
Ohio,Highland Holiday,403,83,154,48,0,0,285
Ohio,Hide-A-Way Hills,557,0,61,216,155,11,443
Ohio,Hessville,201,62,21,34,11,0,128
Ohio,Orient,254,40,57,79,3,0,179
Ohio,Hannibal,403,7,203,33,22,28,293
Ohio,Good Hope,227,0,81,26,0,10,117
Ohio,Kidron,922,179,230,77,50,53,589
Ohio,McDermott,691,164,177,13,0,0,354
Ohio,Kilbourne,34,17,0,7,0,0,24
Ohio,Kings Mills,1564,105,310,305,213,131,1064
Ohio,Little Hocking,416,63,82,41,137,0,323
Ohio,Lewistown,254,30,131,0,0,0,161
Ohio,Lansing,627,10,241,174,8,66,499
Ohio,Lake Waynoka,993,0,323,231,174,46,774
Ohio,Lake Tomahawk,781,0,177,317,58,0,552
Ohio,Lakeside,674,12,119,172,205,149,657
Ohio,Lake Seneca,517,15,164,73,107,90,449
Ohio,Lake Mohawk,1771,0,285,545,263,110,1203
Ohio,Lake Lorelei,1137,45,386,306,54,49,840
Ohio,Lake Lakengren,3415,153,816,722,377,164,2232
Ohio,Lake Buckhorn,654,0,249,35,58,10,352
Ohio,Lafferty,151,0,71,64,0,0,135
Ohio,Lafayette,190,14,100,28,19,4,165
Ohio,Kunkle,308,51,100,24,0,0,175
Ohio,Kinsman Center,595,21,219,120,43,37,440
Ohio,Kimbolton,62,0,49,13,0,0,62
Ohio,Glencoe,150,0,99,24,12,0,135
Ohio,Minford,508,37,201,124,0,48,410
Ohio,Morgandale,753,81,424,75,23,13,616
Ohio,Groveport,5593,262,1507,1270,637,266,3942
Ohio,Greenfield,4597,563,1528,728,202,232,3253
Ohio,Germantown,5505,202,1194,1380,515,327,3618
Ohio,East Palestine,4535,352,1325,988,382,117,3164
Ohio,Canal Winchester,8328,267,1702,1717,1385,848,5919
Ohio,St. Johns,158,8,52,15,0,0,75
Ohio,Uniopolis,222,14,79,52,1,7,153
Ohio,Somerville,244,32,79,37,21,13,182
Ohio,Salesville,116,10,55,22,0,0,87
Ohio,Cherry Fork,290,16,32,24,98,4,174
Ohio,Atwater,1078,38,257,178,37,0,510
Ohio,Apple Valley,5408,193,1456,1501,688,349,4187
Ohio,Andersonville,853,43,172,170,92,79,556
Ohio,Sandyville,290,78,73,36,0,15,202
Ohio,Salem Heights,3277,70,581,587,993,222,2453
Ohio,New Albany,10896,81,624,900,2753,2170,6528
Ohio,Rudolph,579,47,176,99,15,7,344
Ohio,St. Bernard,4355,289,1157,923,394,244,3007
Ohio,Silverton,4767,427,837,1410,628,174,3476
Ohio,New Richmond,2666,284,727,468,257,81,1817
Ohio,Westminster,544,0,171,168,9,8,356
Ohio,Valley City,552,18,107,197,117,29,468
Ohio,Rose Farm,247,0,94,53,15,0,162
Ohio,Parkman,123,36,0,76,11,0,123
Ohio,Nettle Lake,254,18,54,75,15,8,170
Ohio,Mitiwanga,275,8,70,55,40,48,221
Ohio,Marlboro,358,15,94,125,8,0,242
Ohio,Lake Milton,582,22,305,61,65,34,487
Ohio,Goshen,463,47,209,32,59,27,374
Ohio,East Springfield,511,12,100,122,31,0,265
Ohio,Connorville,218,9,61,58,18,5,151
Ohio,Fort Shawnee,5960,206,1505,1580,641,443,4375
Ohio,Waverly,4294,442,1183,994,296,253,3168
Ohio,Waterville,5484,141,851,1057,1147,591,3787
Ohio,St. Martin,265,8,128,31,26,30,223
Ohio,Monfort Heights,13064,451,2629,2772,1991,1200,9043
Ohio,Alvordton,176,7,82,24,0,0,113
Ohio,Rosewood,192,26,94,17,0,0,137
Ohio,Oceola,96,0,29,22,0,0,51
Ohio,Northridge,7343,311,1900,2053,912,387,5563
Ohio,North Lawrence,221,9,131,30,0,0,170
Ohio,Newport CDP (Washington County),867,0,377,170,94,0,641
Ohio,Newport CDP (Shelby County),152,8,46,56,9,0,119
Ohio,New Pittsburg,411,64,88,44,58,5,259
Ohio,New Marshfield,369,12,189,34,59,0,294
Ohio,New Haven CDP (Huron County),270,28,105,47,9,0,189
Ohio,New Haven CDP (Hamilton County),507,16,136,93,32,7,284
Ohio,New Hampshire,250,21,78,43,0,0,142
Ohio,New California,1738,11,187,234,466,131,1029
Ohio,New Burlington,4819,367,1031,1235,516,279,3428
Ohio,New Baltimore,920,72,187,213,88,57,617
Ohio,Negley,165,15,91,36,0,0,142
Ohio,Neapolis,287,15,84,85,0,16,200
Ohio,Old Fort,189,27,46,3,0,35,111
Ohio,Rossmoyne,1744,177,495,397,234,139,1442
Ohio,Pancoastburg,144,28,98,8,0,0,134
Ohio,Pheasant Run,1337,16,312,390,83,22,823
Ohio,Rocky Fork Point,681,165,211,137,27,0,540
Ohio,Rockbridge,27,8,19,0,0,0,27
Ohio,Robertsville,241,0,118,21,7,6,152
Ohio,Ridgeville Corners,525,17,145,117,41,8,328
Ohio,Richville,3298,245,1140,753,225,84,2447
Ohio,Richmond Dale,367,27,178,16,0,0,221
Ohio,Reno,1138,93,387,293,80,0,853
Ohio,Remington,273,19,0,49,105,22,195
Ohio,Raymond,156,0,16,9,34,23,82
Ohio,Radnor,159,0,99,34,26,0,159
Ohio,Pulaski,104,6,43,29,13,0,91
Ohio,Pottery Addition,201,8,92,44,0,0,144
Ohio,Plumwood,365,63,128,64,0,13,268
Ohio,Pleasant Hills,779,27,223,143,163,59,615
Ohio,Plainville,182,0,67,87,14,14,182
Ohio,Pettisville,455,19,79,119,50,25,292
Ohio,South Webster,680,44,246,106,40,58,494
Ohio,Fresno,282,79,57,57,0,0,193
Ohio,Fort Seneca,222,26,98,53,13,0,190
Ohio,Berea,18859,932,3197,3915,2422,1669,12135
Ohio,Polk,347,39,110,68,12,11,240
Ohio,Jeromesville,659,29,166,126,40,20,381
Ohio,Parma,79559,4985,21172,19468,8619,3730,57974
Ohio,Newburgh Heights,1778,227,538,431,118,34,1348
Ohio,Lyndhurst,13630,399,2127,2988,3004,2180,10698
Ohio,Lakewood,50553,2260,7490,10322,10308,6481,36861
Ohio,Tarlton,259,18,97,29,26,10,180
Ohio,New Holland,848,96,316,152,40,16,620
Ohio,Commercial Point,1758,73,400,329,176,104,1082
Ohio,Park Layne,4082,409,956,975,202,15,2557
Ohio,New Carlisle,5622,592,1175,1101,458,151,3477
Ohio,Wilmot,329,34,126,62,11,2,235
Ohio,Tremont City,319,14,99,76,19,5,213
Ohio,Johnstown,5111,250,1351,936,483,208,3228
Ohio,Brook Park,18721,1493,5957,4083,1266,542,13341
Ohio,Heath,10646,694,3000,2315,985,442,7436
Ohio,Fairview Park,16400,574,2662,3571,3201,1740,11748
Ohio,Pepper Pike,6242,61,284,562,1535,1848,4290
Ohio,Hanover,1106,40,257,232,102,35,666
Ohio,Barberton,26189,3032,8261,4447,2077,770,18587
Ohio,Chesterville,182,17,57,32,15,12,133
Ohio,Newtonsville,374,65,107,65,17,0,254
Ohio,Moscow,88,13,43,22,3,1,82
Ohio,Bethel,2770,299,994,411,133,42,1879
Ohio,New Concord,2627,56,259,227,199,173,914
Ohio,Frazeysburg,1700,122,496,309,50,11,988
Ohio,Sheffield Lake,9011,540,2144,2643,893,289,6509
Ohio,Continental,1091,72,391,210,67,13,753
Ohio,Sunbury,5280,160,1085,964,882,383,3474
Ohio,Dalton,1557,112,433,270,183,86,1084
Ohio,Hanging Rock,206,27,84,49,7,2,169
Ohio,Chesapeake,830,86,164,215,66,30,561
Ohio,Shaker Heights,27620,661,1988,3805,4792,7699,18945
Ohio,Garfield Heights,28001,2400,7580,6613,1820,959,19372
Ohio,Malta,718,67,223,127,57,11,485
Ohio,Harbor Hills,1485,54,443,273,275,129,1174
Ohio,Clay Center,270,12,83,56,14,7,172
Ohio,Sherrodsville,292,34,122,50,8,1,215
Ohio,Carrollton,3064,222,912,672,187,232,2225
Ohio,Reminderville,4113,101,623,809,805,514,2852
Ohio,Wilmington,12403,1139,2964,2125,980,583,7791
Ohio,Wooster,26778,1395,6320,4724,2815,2236,17490
Ohio,Stratton,363,45,137,66,6,0,254
Ohio,Richmond,390,18,141,109,34,14,316
Ohio,Rayland,422,37,125,105,21,6,294
Ohio,Mount Pleasant,420,16,162,83,19,24,304
Ohio,Bloomingdale,223,30,38,61,13,7,149
Ohio,Fairborn,33433,2199,5534,7938,3656,2869,22196
Ohio,Beavercreek,46600,892,6107,9472,8422,8631,33524
Ohio,Florida,241,8,90,47,22,9,176
Ohio,Navarre,1797,112,649,371,119,54,1305
Ohio,Windham,1988,206,619,315,70,26,1236
Ohio,Orangeville,173,7,40,44,14,5,110
Ohio,Port Clinton,5939,453,1500,1441,495,266,4155
Ohio,Orrville,8239,431,2501,1409,963,564,5868
Ohio,Hebron,2183,233,687,347,155,63,1485
Ohio,Sharonville,13942,851,2828,2461,2520,1671,10331
Ohio,Ripley,1786,187,557,323,121,35,1223
Ohio,Genoa,2221,160,593,570,189,46,1558
Ohio,Hamler,661,30,206,85,50,31,402
Ohio,Perry Heights,8581,696,2599,2011,561,258,6125
Ohio,Greentown,3240,0,672,665,565,257,2159
Ohio,East Canton,1379,88,503,274,77,46,988
Ohio,Canton,71313,6540,17819,15815,3976,2294,46444
Ohio,Pataskala,15465,848,3469,3289,1798,830,10234
Ohio,Newark,49070,3623,12171,9962,4677,2293,32726
Ohio,Alexandria,697,18,160,156,66,56,456
Ohio,Octa,41,17,19,3,1,0,40
Ohio,Milledgeville,102,17,34,12,3,2,68
Ohio,Olde West Chester,357,54,37,24,43,21,179
Ohio,Sabina,2454,290,780,543,112,23,1748
Ohio,Urbana,11434,895,3881,1852,673,330,7631
Ohio,Four Bridges,3387,73,245,581,889,557,2345
Ohio,Louisville,9317,427,2456,2201,948,450,6482
Ohio,Seville,2598,122,759,497,305,98,1781
Ohio,Curtice,1428,10,369,321,136,124,960
Ohio,Crystal Rock,83,12,42,0,0,0,54
Ohio,Concorde Hills,704,2,28,52,293,168,543
Ohio,Collins,531,34,181,126,34,13,388
Ohio,Coldstream,1224,14,36,140,373,290,853
Ohio,Clarktown,407,37,173,132,11,24,377
Ohio,Cinnamon Lake,1092,27,374,259,16,58,734
Ohio,Chippewa Park,720,134,258,166,52,31,641
Ohio,Celeryville,89,0,6,36,8,0,50
Ohio,Carbon Hill,289,6,69,100,0,8,183
Ohio,Candlewood Lake,526,44,103,116,44,22,329
Ohio,Canal Lewisville,349,15,138,94,37,9,293
Ohio,Camp Dennison,320,15,72,64,56,45,252
Ohio,Buford,133,10,49,31,0,0,90
Ohio,Buffalo,306,29,130,64,10,0,233
Ohio,Cynthiana,0,0,0,0,0,0,0
Ohio,Brownsville,81,55,0,0,0,0,55
Ohio,Damascus,402,0,184,48,33,0,265
Ohio,Darrtown,504,35,123,146,46,11,361
Ohio,Friendship,181,10,47,79,8,0,144
Ohio,Flat Rock,141,17,31,17,27,0,92
Ohio,Etna,948,40,111,247,68,47,513
Ohio,Elizabethtown,309,30,83,78,6,0,197
Ohio,East Rochester,213,0,62,55,19,0,136
Ohio,East Liberty,280,16,140,15,17,0,188
Ohio,East Fultonham,314,35,106,56,24,6,227
Ohio,Dunlap,1498,43,303,319,382,187,1234
Ohio,Dundee,273,43,109,44,0,0,196
Ohio,Duncan Falls,1052,48,371,307,12,0,738
Ohio,Dry Ridge,2630,62,565,598,491,338,2054
Ohio,Dola,155,15,40,47,14,0,116
Ohio,Derby,431,94,148,81,21,0,344
Ohio,Delshire,3277,210,785,703,308,152,2158
Ohio,Delhi Hills,5308,230,1401,1233,450,354,3668
Ohio,Darbydale,904,132,379,66,47,0,624
Ohio,Waynesburg,822,33,308,152,51,24,568
Ohio,Gahanna,35061,905,5285,6755,7505,4190,24640
Ohio,Crown City,379,25,106,76,16,8,231
Ohio,Edgerton,2132,158,559,449,202,77,1445
Ohio,New Straitsville,650,67,172,140,14,10,403
Ohio,Kingston,961,68,376,215,64,35,758
Ohio,Frankfort,1308,113,372,198,54,69,806
Ohio,Syracuse,787,76,200,204,63,28,571
Ohio,Rutland,453,58,130,82,32,11,313
Ohio,Valleyview,526,54,174,117,45,8,398
Ohio,Lockbourne,167,29,42,30,9,0,110
Ohio,Lake Darby,4577,101,732,1021,700,215,2769
Ohio,Kettering,55405,2012,9252,14185,8099,6029,39577
Ohio,Minerva Park,1352,64,155,254,352,168,993
Ohio,Brookside,707,6,188,222,61,31,508
Ohio,Bridgeport,1651,111,555,443,50,36,1195
Ohio,Butler,755,64,232,162,42,7,507
Ohio,Bellville,2278,69,587,493,337,114,1600
Ohio,Stryker,1170,41,368,257,55,12,733
Ohio,Vinton,279,31,104,47,16,7,205
Ohio,Corning,417,36,122,71,4,8,241
Ohio,West Union,3231,408,956,533,225,94,2216
Ohio,Cheshire,176,9,70,28,3,0,110
Ohio,Galion,10089,664,2885,2295,599,309,6752
Ohio,Chatfield,247,17,78,53,11,3,162
Ohio,Sarahsville,133,9,62,21,7,0,99
Ohio,Belle Valley,249,12,127,56,2,3,200
Ohio,Rawson,504,33,125,108,28,3,297
Ohio,Spencerville,2367,162,613,472,70,75,1392
Ohio,Chauncey,1019,156,302,228,44,20,750
Ohio,Sandusky,25012,2017,6591,5494,1681,843,16626
Ohio,Huron,6958,347,1510,1664,1032,644,5197
Ohio,Barnesville,3716,177,1144,688,372,137,2518
Ohio,Harrod,373,26,114,87,13,7,247
Ohio,Bluffton,4216,167,755,775,580,556,2833
Ohio,Jerry City,578,48,152,101,23,13,337
Ohio,Mifflin,123,15,43,30,5,3,96
Ohio,Shawnee,449,36,134,68,18,6,262
Ohio,Glenmoor,1918,270,546,364,11,14,1205
Ohio,Delta,3210,170,843,708,268,136,2125
Ohio,Willshire,399,60,162,45,3,1,271
Ohio,Zanesfield,303,6,49,96,17,9,177
Ohio,Grover Hill,368,33,107,53,10,4,207
Ohio,Paulding,3465,412,1175,552,253,71,2463
Ohio,Bellbrook,7174,108,875,1507,1509,1151,5150
Ohio,Amsterdam,480,53,123,99,28,3,306
Ohio,Dillonvale,668,44,302,175,22,3,546
Ohio,New Alexandria,286,63,75,62,15,2,217
Ohio,Hamden,797,164,219,97,20,5,505
Ohio,Coshocton,11067,1043,3556,2011,921,378,7909
Ohio,Warsaw,605,45,188,138,12,13,396
Ohio,West Lafayette,2445,223,917,364,111,52,1667
Ohio,Melrose,209,25,72,22,8,5,132
Ohio,Oakwood village (Paulding County),644,48,226,128,9,12,423
Ohio,Maple Ridge,853,33,313,115,19,0,480
Ohio,Beloit,992,76,320,217,35,48,696
Ohio,West Liberty,1696,99,492,394,161,72,1218
Ohio,Boardman,34557,1251,8152,7812,5151,2741,25107
Ohio,De Graff,1366,78,452,238,73,25,866
Ohio,Norwood,19796,1849,3819,3369,2735,1297,13069
Ohio,La Croft,1226,19,480,255,66,40,860
Ohio,Rogers,263,56,88,37,4,0,185
Ohio,Marble Cliff,541,12,40,79,181,145,457
Ohio,Lucasville,1484,210,248,306,161,118,1043
Ohio,Rosemount,1993,177,558,540,65,58,1398
Ohio,Carey,3516,276,1070,673,185,81,2285
Ohio,Springboro,18042,476,2142,2617,3535,2584,11354
Ohio,Middletown,48449,5193,12733,9045,3749,1550,32270
Ohio,Seven Mile,828,32,339,84,49,42,546
Ohio,Jackson,6274,435,1780,1444,539,299,4497
Ohio,Oak Hill,1691,192,543,349,43,60,1187
Ohio,Newtown,2658,91,438,473,606,272,1880
Ohio,Portage Lakes,7139,376,1757,1548,1186,492,5359
Ohio,Dellroy,430,30,153,78,9,5,275
Ohio,North Bend,843,54,188,170,172,127,711
Ohio,Piketon,2137,231,444,356,88,67,1186
Ohio,Calcutta,3538,218,1296,918,200,184,2816
Ohio,Mentor-on-the-Lake,7410,376,1978,1887,850,270,5361
Ohio,Mutual,141,16,26,35,14,3,94
Ohio,Hilliard,35665,1007,4399,5554,7651,4997,23608
Ohio,Roaming Shores,1494,64,354,267,228,103,1016
Ohio,Hollansburg,225,25,74,41,20,2,162
Ohio,North Star,259,19,69,37,29,10,164
Ohio,Palestine,242,17,63,55,2,6,143
Ohio,Wayne Lakes,641,29,227,159,60,19,494
Ohio,Celina,10288,574,3266,1969,601,449,6859
Ohio,Rockford,941,81,318,173,90,46,708
Ohio,Bloomdale,619,44,201,114,52,13,424
Ohio,Fostoria,13249,1057,4535,2323,480,284,8679
Ohio,Millbury,1517,111,411,339,91,35,987
Ohio,Milton Center,140,18,51,20,17,1,107
Ohio,Dunkirk,756,46,275,131,29,22,503
Ohio,Mount Vernon,16669,1191,4347,2779,1591,944,10852
Ohio,Otway,57,0,25,10,1,0,36
Ohio,Grove City,40171,1432,8849,8195,5898,3025,27399
Ohio,Antioch,105,12,24,35,8,1,80
Ohio,Salineville,1223,141,406,150,22,15,734
Ohio,New Paris,1692,125,433,369,93,16,1036
Ohio,Zaleski,285,35,114,37,5,2,193
Ohio,Xenia,26364,2377,6722,5633,2066,1245,18043
Ohio,West Jefferson,4343,424,1512,878,247,89,3150
Ohio,Napoleon,8676,500,2536,1913,601,373,5923
Ohio,Cedarville,4082,23,246,310,260,185,1024
Ohio,Mingo Junction,3358,100,972,954,402,178,2606
Ohio,Fredericksburg,306,39,95,43,29,8,214
Ohio,Shreve,1627,93,525,306,55,37,1016
Ohio,Midland,278,30,93,34,0,0,157
Ohio,Macedonia,11808,377,2103,2065,2584,1477,8606
Ohio,Mansfield,46638,5439,12523,9815,3393,1453,32623
Ohio,Shelby,8809,830,2597,1780,629,385,6221
Ohio,Devola,2599,55,551,715,400,256,1977
Ohio,Eastlake,18229,1402,5392,4373,1290,767,13224
Ohio,East Liverpool,10762,1221,3067,1997,504,193,6982
Ohio,West Manchester,436,46,102,84,16,9,257
Ohio,Wheelersburg,5996,445,1781,1135,388,544,4293
Ohio,New Philadelphia,17432,1725,5167,2972,1193,701,11758
Ohio,Dennison,2745,199,853,600,81,38,1771
Ohio,Bolindale,2246,228,887,329,136,34,1614
Ohio,Warren,39668,3897,11944,6952,2705,909,26407
Ohio,New Lebanon,4243,343,1231,826,138,40,2578
Ohio,Forestville,10866,253,1545,1908,2216,1750,7672
Ohio,Lincoln Heights,3337,269,974,575,176,31,2025
Ohio,Mariemont,3429,11,196,402,1047,742,2398
Ohio,Phillipsburg,445,33,141,85,26,14,299
Ohio,Riverside,25087,2134,5135,5916,2014,1438,16637
Ohio,Trotwood,24361,2128,5942,5925,1639,1163,16797
Ohio,Logan,6846,393,1852,1546,464,234,4489
Ohio,Glenmont,257,38,91,41,11,4,185
Ohio,Portage,492,11,129,98,84,32,354
Ohio,Rossford,6507,185,1176,1724,697,412,4194
Ohio,Tontogany,520,18,168,112,31,20,349
Ohio,Arlington,1453,50,330,321,193,76,970
Ohio,Norwich,117,9,41,17,6,16,89
Ohio,Toledo,278193,25609,59529,63525,21916,12203,182782
Ohio,Grafton,6094,1005,1657,2014,350,84,5110
Ohio,St. Marys,8145,560,2437,1527,518,258,5300
Ohio,Upper Sandusky,6757,422,2091,1254,560,226,4553
Ohio,Cleveland Heights,44865,1814,4721,7599,7413,8575,30122
Ohio,Cuyahoga Heights,630,27,192,105,64,25,413
Ohio,Euclid,47456,3669,10824,11952,4565,2257,33267
Ohio,Independence,7156,280,1397,1123,1504,800,5104
Ohio,Mayfield,3397,98,551,706,689,532,2576
Ohio,Middleburg Heights,15670,816,3252,3599,2643,1722,12032
Ohio,North Randall,1023,77,347,341,63,42,870
Ohio,North Royalton,30322,1430,5517,6769,5502,3179,22397
Ohio,Strongsville,44752,1077,7543,8691,9334,5866,32511
Ohio,Elgin,112,29,23,24,0,0,76
Ohio,West Alexandria,1603,125,354,323,114,141,1057
Ohio,Hanoverton,362,28,128,65,22,17,260
Ohio,New Waterford,1190,123,365,262,71,27,848
Ohio,Roseville,2262,187,670,354,55,52,1318
Ohio,Northbrook,10832,647,2761,2414,994,345,7161
Ohio,Mineral City,737,55,257,142,60,6,520
Ohio,Clarington,380,34,136,61,22,0,253
Ohio,Streetsboro,16395,916,3555,3518,2088,1293,11370
Ohio,Williamsburg,2535,246,735,540,121,69,1711
Ohio,Burbank,243,25,98,52,9,0,184
Ohio,Blanchester,4086,432,1160,805,193,64,2654
Ohio,Deshler,1536,105,496,278,78,27,984
Ohio,McClure,644,75,195,143,32,4,449
Ohio,New Bavaria,112,13,21,16,16,6,72
Ohio,Findlay,41276,2553,9385,8258,4869,2686,27751
Ohio,Jenera,195,11,48,52,17,2,130
Ohio,Mount Cory,184,27,47,37,5,1,117
Ohio,Vanlue,283,13,85,51,25,15,189
Ohio,Harbor View,61,15,12,18,1,0,46
Ohio,Oregon,20012,1368,5136,5070,1745,1010,14329
Ohio,Midvale,817,59,291,109,44,12,515
Ohio,Swanton,3637,111,912,928,332,192,2475
Ohio,Sylvania,18928,626,2812,3935,3734,2299,13406
Ohio,Summerside,4692,365,1263,957,445,215,3245
Ohio,Hiram,1272,0,60,55,94,152,361
Ohio,Mount Repose,4446,152,1050,780,511,377,2870
Ohio,Amelia,5074,454,1082,1272,398,163,3369
Ohio,Grand River,442,56,118,96,40,9,319
Ohio,Attica,925,47,357,180,42,37,663
Ohio,Bettsville,694,21,211,166,43,13,454
Ohio,New Riegel,266,6,101,54,22,9,192
Ohio,Christiansburg,478,36,155,90,21,5,307
Ohio,Hunter,2210,119,727,558,101,70,1575
Ohio,Eaton Estates,1244,76,478,186,108,5,853
Ohio,Kipton,224,10,75,84,10,2,181
Ohio,Sheffield,4126,212,787,1151,504,411,3065
Ohio,South Amherst,1807,173,575,511,137,16,1412
Ohio,Seven Hills,11690,486,2746,2697,2192,1142,9263
Ohio,Prospect,975,31,270,177,122,49,649
Ohio,Athalia,285,21,85,56,19,8,189
Ohio,Clayton,13172,531,2175,3227,2084,1214,9231
Ohio,Owensville,946,159,385,114,71,14,743
Ohio,Felicity,669,105,234,69,12,13,433
Ohio,Wharton,346,17,147,59,18,1,242
Ohio,Pitsburg,371,19,106,95,15,1,236
Ohio,Rossburg,201,13,89,42,3,1,148
Ohio,Silver Lake,2511,39,341,405,648,394,1827
Ohio,Stow,34796,956,5405,6530,7615,4170,24676
Ohio,Aquilla,325,33,76,77,26,24,236
Ohio,Plymouth,1600,147,478,292,69,32,1018
Ohio,Macksburg,202,40,95,16,3,0,154
Ohio,Marietta,13718,906,3189,2675,1435,997,9202
Ohio,Kirtland,6818,247,1149,1428,1140,977,4941
Ohio,Arcanum,2110,86,488,539,168,62,1343
Ohio,Orwell,1583,179,528,241,55,33,1036
Ohio,Jefferson,3327,206,838,984,173,140,2341
Ohio,Conneaut,12659,1197,4177,2777,726,405,9282
Ohio,Baltic,802,111,269,85,36,21,522
Ohio,West Mansfield,688,48,231,103,26,17,425
Ohio,Russells Point,1158,100,432,245,40,27,844
Ohio,Stoutsville,655,27,173,155,28,26,409
Ohio,Wren,110,1,49,44,6,0,100
Ohio,Lancaster,39942,3224,11222,8734,3048,1573,27801
Ohio,Pigeon Creek,721,9,103,179,173,82,546
Ohio,Fairlawn,7522,144,1222,1599,1746,958,5669
Ohio,Lakemore,3085,377,1150,634,170,162,2493
Ohio,Peninsula,632,4,64,115,168,112,463
Ohio,Brady Lake,525,22,178,84,62,31,377
Ohio,McArthur,1522,133,403,248,85,87,956
Ohio,Aurora,15941,484,2117,2570,3699,2101,10971
Ohio,Magnetic Springs,277,39,117,39,14,0,209
Ohio,Niles,18606,1364,5897,3480,1510,630,12881
Ohio,Monroe,14013,453,2740,3030,2012,915,9150
Ohio,Vienna Center,623,30,167,203,28,31,459
Ohio,Georgetown,4637,352,1305,799,303,278,3037
Ohio,Elmore,1401,47,354,314,156,96,967
Ohio,Montrose-Ghent,4928,146,503,774,1137,814,3374
Ohio,Arlington Heights,903,82,240,170,56,9,557
Ohio,Old Washington,506,10,132,143,18,9,312
Ohio,Boston Heights,1122,25,183,150,246,207,811
Ohio,Munroe Falls,5065,170,1350,841,988,494,3843
Ohio,Plainfield,132,3,58,27,14,2,104
Ohio,Bremen,1725,111,405,423,101,46,1086
Ohio,Andover,1021,81,346,236,68,11,742
Ohio,Hamilton,62259,5784,16999,11678,4455,2068,40984
Ohio,Russellville,827,59,254,119,42,12,486
Ohio,Fayetteville,353,27,116,62,16,13,234
Ohio,Union,6555,296,1479,1622,608,399,4404
Ohio,Lockington,161,19,76,17,4,0,116
Ohio,Drexel,1991,352,495,295,32,65,1239
Ohio,New Knoxville,965,27,217,197,116,52,609
Ohio,New Bremen,3318,51,709,652,484,309,2205
Ohio,Minster,2727,59,713,466,431,239,1908
Ohio,Westlake,32378,841,4183,6285,7546,5106,23961
Ohio,Warrensville Heights,13258,770,2713,3595,972,474,8524
Ohio,Valley View,2013,50,467,425,325,163,1430
Ohio,Cridersville,1778,95,623,365,117,56,1256
Ohio,Pleasant Grove,1682,74,432,466,101,109,1182
Ohio,Philo,1148,95,322,162,56,3,638
Ohio,Hemlock,115,15,21,26,4,6,72
Ohio,North Kingsville,2816,247,653,667,250,162,1979
Ohio,Savannah,367,31,104,67,24,12,238
Ohio,Bentleyville,976,7,30,67,220,298,622
Ohio,Amesville,144,2,32,46,13,19,112
Ohio,Ithaca,59,4,22,7,5,0,38
Ohio,Yellow Springs,3858,135,255,683,791,1026,2890
Ohio,Hayesville,470,19,169,78,44,31,341
Ohio,Winchester,1065,87,327,169,31,45,659
Ohio,Peebles,1851,275,521,276,49,40,1161
Ohio,Galena,589,17,102,124,108,49,400
Ohio,Delaware,39219,1471,7261,7326,5682,3098,24838
Ohio,Wapakoneta,9732,569,2918,2129,538,301,6455
Ohio,La Rue,660,66,261,109,28,15,479
Ohio,West Unity,1749,110,476,377,99,36,1098
Ohio,Maple Heights,22539,1828,5778,5602,1479,693,15380
Ohio,Highland Hills,922,112,184,276,54,45,671
Ohio,Highland Heights,8396,212,1207,1182,1648,1752,6001
Ohio,Brooklyn Heights,1686,75,410,349,231,112,1177
Ohio,Beachwood,11704,428,1558,1503,2104,3213,8806
Ohio,Shiloh,663,74,219,97,18,7,415
Ohio,Kelleys Island,202,3,41,66,53,25,188
Ohio,Castalia,907,41,271,160,78,34,584
Ohio,Burlington,2643,182,891,645,95,62,1875
Ohio,Centerville,23821,698,2779,4670,5453,4001,17601
Ohio,Cherry Grove,4521,118,598,856,999,376,2947
Ohio,Covedale,6209,205,1227,1072,1227,602,4333
Ohio,Lore City,282,39,92,49,9,8,197
Ohio,Pleasant City,430,32,110,63,12,15,232
Ohio,Elmwood Place,1907,290,565,378,61,4,1298
Ohio,Belpre,6422,476,2010,1515,472,245,4718
Ohio,Beverly,1420,93,327,341,114,34,909
Ohio,Matamoras,699,106,207,159,41,17,530
Ohio,Lakeline,243,2,69,74,34,15,194
Ohio,Mentor,47062,2416,10398,10917,7217,4056,35004
Ohio,Waite Hill,399,5,50,68,103,89,315
Ohio,Wickliffe,12733,821,3200,3104,1651,788,9564
Ohio,Willoughby Hills,9526,482,1821,1612,1867,1376,7158
Ohio,Richmond Heights,10449,590,2108,2541,1516,1010,7765
Ohio,Graysville,68,8,12,31,2,3,56
Ohio,Buckeye Lake,2792,293,923,631,182,64,2093
Ohio,Westfield Center,1191,30,231,233,258,139,891
Ohio,Chickasaw,375,11,127,45,30,18,231
Ohio,Edgewood,4251,236,1208,791,305,71,2611
Ohio,New Madison,906,53,301,155,48,27,584
Ohio,Osgood,239,15,62,41,15,21,154
Ohio,Yorkshire,83,10,29,1,1,0,41
Ohio,Belmont,418,28,92,99,28,11,258
Ohio,Yorkville,1049,84,338,255,67,19,763
Ohio,Vermilion,10226,826,2757,2163,1327,831,7904
Ohio,Glouster,1709,288,402,337,30,38,1095
Ohio,Payne,1197,111,485,223,72,12,903
Ohio,Somerset,1673,79,508,410,79,64,1140
Ohio,Port Jefferson,492,51,197,65,17,0,330
Ohio,Brunswick,34733,1611,8155,7832,4361,1895,23854
Ohio,Choctaw Lake,1547,13,278,399,297,103,1090
Ohio,Medina,26220,678,5039,5280,4537,1982,17516
Ohio,Lucas,617,35,182,150,25,6,398
Ohio,Miltonsburg,84,9,28,6,0,0,43
Ohio,Miller City,133,8,69,28,6,3,114
Ohio,Ottawa,4377,395,1088,760,405,330,2978
Ohio,Fayette,1441,87,349,329,77,42,884
Ohio,Adena,679,27,265,167,23,10,492
Ohio,Monroeville,1206,79,436,247,44,23,829
Ohio,Willard,6060,584,2012,838,451,130,4015
Ohio,Granville,5766,27,139,518,800,976,2460
Ohio,Hartford,340,20,115,59,32,5,231
Ohio,Ashtabula,18243,2125,5588,3243,804,435,12195
Ohio,Jacksonville,426,64,181,85,13,1,344
Ohio,The Plains,3001,378,794,511,286,258,2227
Ohio,Sherwood,854,69,229,186,55,27,566
Ohio,Fairview,72,14,11,16,7,0,48
Ohio,Holloway,289,39,108,57,0,0,204
Ohio,Martins Ferry,6703,593,2198,1522,505,234,5052
Ohio,Shadyside,3623,121,1196,881,363,167,2728
Ohio,Berlin Heights,646,38,168,147,71,34,458
Ohio,Archbold,4409,322,1014,1028,351,197,2912
Ohio,Woodstock,301,27,69,61,10,3,170
Ohio,St. Paris,2059,164,538,371,113,75,1261
Ohio,Youngstown,64734,7112,17797,12954,4180,1710,43753
Ohio,Franklin,11734,1415,3286,2007,643,393,7744
Ohio,Harveysburg,664,16,156,136,73,37,418
Ohio,Loveland Park,1888,50,520,246,282,116,1214
Ohio,Maineville,1047,54,235,260,108,73,730
Ohio,South Lebanon,4622,328,892,504,1336,356,3416
Ohio,Fultonham,123,6,59,7,7,0,79
Ohio,Sardinia,1360,141,313,289,51,24,818
Ohio,Perry,1646,86,459,361,139,98,1143
Ohio,North Zanesville,2390,101,525,653,339,259,1877
Ohio,Cortland,6889,245,2033,1275,1108,629,5290
Ohio,Hilltop,924,109,247,197,28,23,604
Ohio,Hubbard,7564,271,2323,1655,804,479,5532
Ohio,Girard,9465,944,3026,1584,944,437,6935
Ohio,Howland Center,6400,268,1695,1349,748,506,4566
Ohio,West Farmington,434,77,85,51,18,4,235
Ohio,West Hill,2045,168,961,252,115,9,1505
Ohio,Zanesville,25376,2799,6766,4990,1531,796,16882
Ohio,Gettysburg,564,43,209,80,21,6,359
Ohio,Madison,3164,149,724,783,294,223,2173
Ohio,South Point,3609,231,1067,858,303,164,2623
Ohio,Bethesda,1259,65,422,236,65,49,837
Ohio,Milan,1316,56,361,325,123,86,951
Ohio,Eldorado,510,25,174,97,33,18,347
Ohio,Hicksville,3253,176,1034,651,197,69,2127
Ohio,Campbell,7964,815,2317,1630,356,154,5272
Ohio,Poland,2582,59,508,536,478,370,1951
Ohio,West Elkton,185,15,65,30,0,0,110
Ohio,Grandview Heights,7681,89,350,1032,2376,1966,5813
Ohio,Huber Ridge,4511,102,1030,995,673,188,2988
Ohio,Lincoln Village,10071,1306,2936,2015,579,131,6967
Ohio,North Canton,17362,621,3409,3593,2719,1685,12027
Ohio,Kirkersville,405,28,151,105,26,12,322
Ohio,Lowell,638,31,219,115,46,17,428
Ohio,Painesville,19828,2359,4103,3604,1376,578,12020
Ohio,Willoughby,22770,1122,4754,5932,3665,1623,17096
Ohio,Greenville,12824,915,4663,2353,914,426,9271
Ohio,Jerusalem,136,15,57,29,2,4,107
Ohio,Rock Creek,403,54,158,75,16,1,304
Ohio,Walbridge,3110,172,1025,730,206,114,2247
Ohio,New Weston,98,34,30,11,0,1,76
Ohio,Morristown,261,15,98,47,18,6,184
Ohio,St. Clairsville,5071,140,1279,1277,826,482,4004
Ohio,Wilson,136,9,44,36,4,2,95
Ohio,Athens,24771,261,913,1312,1602,3207,7295
Ohio,Buchtel,566,52,203,117,40,23,435
Ohio,Van Buren,448,5,107,120,24,11,267
Ohio,Holland,1613,176,347,386,259,70,1238
Ohio,Maumee,13857,349,2658,3432,2064,1505,10008
Ohio,Batesville,89,10,37,15,5,0,67
Ohio,Dover,12811,1141,3469,2347,1117,877,8951
Ohio,Newcomerstown,3883,368,1568,474,193,65,2668
Ohio,Stone Creek,187,10,58,39,10,0,117
Ohio,Zoar,169,0,53,41,30,13,137
Ohio,Gordon,183,2,74,46,13,4,139
Ohio,Wayne,1047,65,358,227,34,10,694
Ohio,Castine,225,8,43,48,1,0,100
Ohio,Stafford,112,7,32,27,6,0,72
Ohio,Whitehouse,4713,58,832,1055,792,383,3120
Ohio,Cecil,123,27,57,10,1,0,95
Ohio,Latty,154,3,63,39,9,1,115
Ohio,New London,2458,236,684,429,86,45,1480
Ohio,Terrace Park,2350,38,48,163,664,568,1481
Ohio,Wyoming,8535,44,654,980,1784,2297,5759
Ohio,Upper Arlington,35223,261,1857,3519,10121,8838,24596
Ohio,Chillicothe,21717,1874,5896,4475,1813,1398,15456
Ohio,Coolville,563,79,249,91,10,14,443
Ohio,Trimble,532,77,146,103,24,13,363
Ohio,Delphos,7044,428,2270,1327,462,287,4774
Ohio,Lima,37335,3798,9325,7549,1768,933,23373
Ohio,Tiro,193,16,59,33,4,2,114
Ohio,Dexter City,72,8,34,4,2,0,48
Ohio,Glenford,193,10,52,39,9,4,114
Ohio,Rendville,27,4,1,5,6,1,17
Ohio,Valley Hi,175,13,57,32,7,0,109
Ohio,Cairo,492,42,129,99,27,9,306
Ohio,Belle Center,734,33,293,142,32,18,518
Ohio,Spring Valley,535,40,160,159,48,20,427
Ohio,Barnhill,307,66,127,32,6,0,231
Ohio,Strasburg,2814,182,1000,533,219,133,2067
Ohio,Lafayette,430,23,135,101,11,10,280
Ohio,Sugarcreek,2220,325,609,378,169,86,1567
Ohio,Uhrichsville,5370,697,1757,849,188,157,3648
Ohio,Rio Grande,842,30,84,90,16,5,225
Ohio,Bexley,13764,136,617,996,2979,3122,7850
Ohio,Urbancrest,1085,155,198,199,52,4,608
Ohio,Racine,704,61,188,188,34,23,494
Ohio,Doylestown,3097,186,719,580,458,290,2233
Ohio,Marshallville,829,63,318,121,37,9,548
Ohio,Mount Eaton,179,30,57,15,14,0,116
Ohio,Smithville,1346,65,385,241,133,82,906
Ohio,Broughton,113,15,47,12,1,1,76
Ohio,Ridgeway,334,18,140,49,13,5,225
Ohio,Steubenville,18095,1369,4480,3509,1337,1130,11825
Ohio,Piqua,20941,1616,6155,4654,1327,620,14372
Ohio,Geneva,5989,625,2015,1199,487,155,4481
Ohio,Rushville,397,27,80,75,42,5,229
Ohio,Coalton,436,69,150,81,34,0,334
Ohio,Marblehead,775,37,242,154,114,97,644
Ohio,Jeffersonville,1279,122,371,212,50,17,772
Ohio,Bloomingburg,917,93,357,94,56,4,604
Ohio,Waynesfield,722,46,263,134,32,14,489
Ohio,Hartville,3016,229,782,569,497,196,2273
Ohio,Botkins,1171,54,355,252,97,62,820
Ohio,Huber Heights,39219,1979,7683,10344,3894,2466,26366
Ohio,Bentonville,180,17,80,29,0,9,135
Ohio,Coal Grove,1811,220,637,326,88,62,1333
Ohio,Woodmere,786,10,152,158,122,123,565
Ohio,University Heights,13138,361,934,1996,2091,2219,7601
Ohio,South Euclid,21688,847,3561,4449,3209,2491,14557
Ohio,Rocky River,20310,394,2303,3543,4655,4136,15031
Ohio,Orange,3285,33,188,512,773,766,2272
Ohio,Nashville,167,14,60,28,7,1,110
Ohio,Moreland Hills,3316,21,157,417,997,1003,2595
Ohio,Cloverdale,145,19,59,19,4,2,103
Ohio,Landen,7214,66,771,1188,1545,1056,4626
Ohio,Wakeman,1218,113,281,282,102,49,827
Ohio,Nellie,101,11,32,21,6,2,72
Ohio,Conesville,427,17,176,82,11,2,288
Ohio,Rushsylvania,582,29,235,94,18,1,377
Ohio,Bellefontaine,13531,688,4269,2105,1008,443,8513
Ohio,Wintersville,4482,174,1453,1052,160,259,3098
Ohio,Toronto,5298,373,1754,1150,291,142,3710
Ohio,Empire,242,30,95,48,4,0,177
Ohio,Wilberforce,2291,42,111,171,33,73,430
Ohio,Shawnee Hills,2254,111,687,465,159,200,1622
Ohio,Bowersville,322,30,83,88,12,3,216
Ohio,Lodi,2849,276,1057,519,138,86,2076
Ohio,Five Points,1723,0,201,223,534,282,1240
Ohio,Leipsic,2402,295,678,353,95,38,1459
Ohio,Dupont,257,23,115,37,8,4,187
Ohio,Columbus Grove,2272,86,554,502,150,104,1396
Ohio,Versailles,2676,123,829,476,204,113,1745
Ohio,Brooklyn,10862,964,3027,2571,928,443,7933
Ohio,Bailey Lakes,397,28,117,105,29,17,296
Ohio,New Vienna,1214,39,386,263,31,23,742
Ohio,Malvern,1343,93,426,202,131,68,920
Ohio,Holgate,1103,106,299,270,56,31,762
Ohio,Malinta,277,12,101,57,9,5,184
Ohio,Jamestown,2082,207,546,466,145,97,1461
Ohio,Mount Healthy,6076,400,1742,1446,395,235,4218
Ohio,North College Hill,9307,737,2259,1859,1035,372,6262
Ohio,Northgate,7099,518,2227,1346,623,272,4986
Ohio,Northfield,3677,84,1303,791,377,100,2655
Ohio,Cardington,1911,138,605,301,74,29,1147
Ohio,Cuyahoga Falls,49317,1816,10696,11478,7696,3671,35357
Ohio,Tallmadge,17581,707,3623,3981,2720,1336,12367
Ohio,Pioneer,1650,116,398,284,111,52,961
Ohio,Convoy,1125,52,325,223,45,28,673
Ohio,Lithopolis,1655,28,320,498,145,116,1107
Ohio,Beulah Beach,13,0,13,0,0,0,13
Ohio,Loudonville,2654,281,870,583,160,59,1953
Ohio,Bladensburg,166,9,66,6,28,0,109
Ohio,Bourneville,279,0,197,0,0,0,197
Ohio,Mulberry,3772,211,728,809,658,542,2948
Ohio,Loveland,13082,341,2261,2355,2373,1577,8907
Ohio,Plain City,4421,199,1020,869,745,322,3155
Ohio,Washingtonville,983,112,318,139,70,20,659
Ohio,Salem,11870,1032,3410,2420,830,468,8160
Ohio,Minerva,3482,204,1196,652,196,138,2386
Ohio,Verona,446,32,153,102,12,4,303
Ohio,Eaton,8195,700,2704,1605,621,299,5929
Ohio,Camden,1942,238,734,326,46,30,1374
Ohio,Sebring,4263,451,1419,710,290,156,3026
Ohio,New Middletown,1490,54,520,327,117,58,1076
Ohio,Lowellville,1142,105,313,262,82,32,794
Ohio,Canfield,7295,147,1213,1485,1628,1018,5491
Ohio,Bridgetown,13824,548,3594,2789,1751,845,9527
Ohio,Brecon,518,105,88,16,119,0,328
Ohio,Blue Jay,1111,74,228,286,205,37,830
Ohio,Port William,226,28,65,43,13,1,150
Ohio,West Portsmouth,2795,262,937,609,152,36,1996
Ohio,Geneva-on-the-Lake,1320,103,489,277,66,59,994
Ohio,North Madison,8573,447,2211,2282,406,265,5611
Ohio,New Athens,304,24,124,53,12,7,220
Ohio,Madeira,9091,173,835,987,2276,1987,6258
Ohio,Greenhills,3596,115,498,1038,584,263,2498
Ohio,Masury,1893,105,738,303,186,80,1412
Ohio,Laurelville,584,59,238,81,31,9,418
Ohio,McDonald,3116,146,953,691,313,139,2242
Ohio,New Miami,2416,438,919,223,44,0,1624
Ohio,West Salem,1562,113,492,287,52,7,951
Ohio,Bainbridge,777,131,227,147,31,9,545
Ohio,Sugar Bush Knolls,196,2,31,31,32,63,159
Ohio,Bellaire,4139,524,1260,880,88,78,2830
Ohio,Brookville,5813,316,1528,1704,536,342,4426
Ohio,Canal Fulton,5464,222,1233,1483,719,321,3978
Ohio,Carlisle,5337,382,1523,1112,469,127,3613
Ohio,Quaker City,376,13,172,72,5,10,272
Ohio,Chardon,5171,220,1014,1475,697,348,3754
Ohio,Ross,3526,209,762,644,477,184,2276
Ohio,Irondale,351,42,124,37,13,0,216
Ohio,Edon,672,31,211,137,53,21,453
Ohio,Holiday City,31,0,7,5,7,1,20
Ohio,Coldwater,4385,223,1267,722,408,171,2791
Ohio,St. Henry,2503,101,583,410,258,121,1473
Ohio,Bradford,1962,222,673,289,54,23,1261
Ohio,Kenton,8296,608,2680,1314,423,156,5181
Ohio,Englewood,13485,626,2787,3524,1721,1018,9676
Ohio,Rocky Ridge,521,26,170,89,25,8,318
Ohio,South Russell,3801,20,211,561,1262,716,2770
Ohio,Meyers Lake,605,31,128,139,142,88,528
Ohio,Millersport,1163,51,280,211,142,30,714
Ohio,Haviland,216,45,57,21,13,5,141
Ohio,Lordstown,3300,216,1114,648,299,106,2383
Ohio,West Rushville,251,26,54,50,19,0,149
Ohio,Dry Run,7754,120,354,855,2057,1533,4919
Ohio,North Hampton,439,21,127,106,21,11,286
Ohio,Bryan,8285,315,2476,2125,561,348,5825
Ohio,Columbiana,6293,258,1842,1198,1053,465,4816
Ohio,Gallipolis,3589,403,845,831,209,249,2537
Ohio,Hillsboro,6520,721,1883,980,416,365,4365
Ohio,Leesburg,1442,125,491,302,66,18,1002
Ohio,Senecaville,336,26,134,66,8,8,242
Ohio,Fairfax,1707,90,344,369,269,113,1185
Ohio,Montgomery,10663,168,849,1281,2803,2503,7604
Ohio,Pleasant Run Farm,4653,168,892,1070,596,310,3036
Ohio,Reading,10286,803,2742,2173,1135,464,7317
Ohio,Amherst,12097,651,2612,3364,1590,712,8929
Ohio,Elyria,53910,4675,12222,13717,3782,1809,36205
Ohio,Wellington,5249,373,1529,1133,369,203,3607
Ohio,Helena,309,25,93,77,22,7,224
Ohio,Bairdstown,136,16,44,25,4,2,91
Ohio,Dent,11378,273,1754,2659,2230,1144,8060
Ohio,Dillonvale,3441,163,796,719,577,206,2461
Ohio,Craig Beach,1318,114,456,279,89,33,971
Ohio,Sugar Grove,381,7,142,56,23,12,240
Ohio,Crestline,4478,419,1298,761,243,82,2803
Ohio,Byesville,2360,189,756,437,79,28,1489
Ohio,Carroll,415,34,163,86,38,8,329
Ohio,LaGrange,2375,113,583,638,165,85,1584
Ohio,Newton Falls,4564,320,1890,811,165,138,3324
Ohio,Ontario,6100,401,1551,1470,626,530,4578
Ohio,Powell,12909,63,507,1305,3531,2572,7978
Ohio,Washington Court House,14135,1317,4629,2017,1156,481,9600
Ohio,Chippewa Lake,672,58,195,155,60,56,524
Ohio,New Lexington,5189,548,1480,1079,164,168,3439
Ohio,Sherwood,3448,17,298,628,951,520,2414
Ohio,Brilliant,1596,71,525,386,61,0,1043
Ohio,New Franklin,14178,746,4061,3370,1621,789,10587
Ohio,Austinburg,595,86,155,93,43,45,422
Ohio,Bannock,176,0,117,30,0,13,160
Ohio,Bascom,371,21,77,100,65,14,277
Ohio,Massillon,32366,2126,9273,6783,2389,1271,21842
Ohio,Farmersville,1105,49,292,295,92,47,775
Ohio,Gloria Glens Park,472,39,129,99,45,14,326
Ohio,Kirby,119,0,52,13,4,3,72
Ohio,Struthers,10325,580,3298,2109,930,156,7073
Ohio,Highland,398,35,105,72,8,4,224
Ohio,Forest Park,18703,1322,3728,3622,2208,998,11878
Ohio,Grandview,1149,110,314,259,201,42,926
Ohio,Pleasant Run,4460,252,1233,954,505,108,3052
Ohio,Springdale,11228,808,2409,2084,1592,785,7678
Ohio,White Oak,19900,1604,4416,4149,2481,1054,13704
Ohio,Perrysville,758,46,274,117,34,2,473
Ohio,New Bloomington,473,121,115,45,6,4,291
Ohio,Ashland,20396,1469,4881,2839,2410,1347,12946
Ohio,Bedford,12705,558,3236,3163,1043,838,8838
Ohio,Berlin,863,206,286,32,79,37,640
Ohio,Brecksville,13538,191,1704,2433,3347,2277,9952
Ohio,East Cleveland,17321,2103,4355,4078,1013,536,12085
Ohio,Mayfield Heights,18766,702,3911,3600,3438,2182,13833
Ohio,Olmsted Falls,8912,178,1610,2274,1571,825,6458
Ohio,Parma Heights,20162,1137,4647,5135,2550,1232,14701
Ohio,Union City,1755,203,520,246,22,12,1003
Ohio,Buckland,265,8,87,68,4,5,172
Ohio,Brewster,2159,240,852,350,107,15,1564
Ohio,Antwerp,1412,88,472,280,91,46,977
Ohio,Bay Village,15391,311,1248,2077,4136,2955,10727
Ohio,Hunting Valley,740,9,31,70,190,229,529
Ohio,Arcadia,548,16,163,128,33,21,361
Ohio,Oakwood village (Cuyahoga County),3692,246,822,939,298,428,2733
Ohio,Leetonia,2118,130,718,391,106,65,1410
Ohio,Shawnee Hills,785,2,61,137,196,118,514
Ohio,Powhatan Point,1524,101,592,324,89,54,1160
Ohio,Sparta,161,10,42,31,4,0,87
Ohio,Grand Rapids,959,39,244,158,143,61,645
Ohio,Neffs,623,45,266,133,32,60,536
Ohio,Brimfield,3526,109,969,745,290,90,2203
Ohio,Scott,286,20,89,70,6,5,190
Ohio,McConnelsville,1910,186,583,420,87,87,1363
Ohio,Green Camp,355,11,161,71,12,9,264
Ohio,Holmesville,301,11,118,46,19,3,197
Ohio,The Village of Indian Hill,5876,63,65,358,1717,1919,4122
Ohio,Lynchburg,1331,83,391,292,35,33,834
Ohio,Dublin,45559,555,2199,4687,12936,9568,29945
Ohio,Thornville,1083,34,304,217,81,30,666
Ohio,Stony Prairie,1307,193,446,262,65,8,974
Ohio,Woodville,2118,115,562,466,238,88,1469
Ohio,Northwood,5383,306,1445,1481,396,264,3892
Ohio,Butlerville,172,15,62,34,2,0,113
Ohio,Risingsun,635,30,223,122,34,9,418
Ohio,Catawba,260,13,100,36,9,1,159
Ohio,Circleville,13853,1342,4000,2535,1188,471,9536
Ohio,Killbuck,946,108,354,141,20,6,629
Ohio,Millersburg,3165,275,1197,530,223,84,2309
Ohio,Fort Jennings,444,14,120,98,49,22,303
Ohio,Glandorf,998,21,244,223,132,49,669
Ohio,Pleasant Plain,156,19,66,13,7,3,108
Ohio,Miamisburg,19974,1191,4286,5004,2201,1231,13913
Ohio,Anna,1487,37,353,313,117,85,905
Ohio,Jackson Center,1604,84,506,310,111,58,1069
Ohio,Fremont,16171,1369,4658,3205,815,482,10529
Ohio,Middle Point,525,24,190,131,14,8,367
Ohio,Mendon,671,31,255,105,20,9,420
Ohio,New Boston,2375,361,812,384,147,61,1765
Ohio,Austintown,28386,1491,8135,6344,3044,1295,20309
Ohio,Rochester,168,12,57,21,8,14,112
Ohio,Lorain,63773,7475,14729,14104,3506,1722,41536
Ohio,North Ridgeville,32954,1418,6835,7602,4668,2459,22982
Ohio,Oberlin,8299,298,666,1139,783,1154,4040
Ohio,Dresden,1685,98,551,306,72,74,1101
Ohio,Maplewood Park,292,50,69,73,19,0,211
Ohio,Bowerston,437,29,190,52,14,9,294
Ohio,Deersville,41,2,20,7,5,0,34
Ohio,Freeport,374,67,129,62,14,6,278
Ohio,Pleasantville,1065,96,333,230,32,5,696
Ohio,Covington,2653,291,777,474,137,44,1723
Ohio,Ansonia,1344,138,491,165,43,23,860
Ohio,Forest,1652,62,528,280,55,55,980
Ohio,Casstown,218,9,65,47,20,1,142
Ohio,Harpster,186,5,82,49,10,6,152
Ohio,Marysville,23509,1449,5375,4204,3240,1456,15724
Oklahoma,Felt,149,10,31,17,34,0,92
Oklahoma,Weleetka,875,144,227,166,38,11,586
Oklahoma,Grandview,277,0,39,58,36,15,148
Oklahoma,Grant,335,51,86,70,6,5,218
Oklahoma,Indianola,29,14,0,15,0,0,29
Oklahoma,Isabella,241,44,16,29,42,0,131
Oklahoma,Lebanon,224,24,100,47,0,0,171
Oklahoma,Kenton,36,0,36,0,0,0,36
Oklahoma,Kenwood,1095,150,344,210,31,24,759
Oklahoma,Lane,268,24,60,61,8,17,170
Oklahoma,Lucien,146,5,50,16,16,2,89
Oklahoma,Mulberry,115,5,48,14,7,3,77
Oklahoma,Nardin,30,0,0,10,20,0,30
Oklahoma,Nescatunga,80,0,62,3,6,0,71
Oklahoma,Gideon,8,2,0,3,3,0,8
Oklahoma,Nicut,262,55,94,56,3,0,208
Oklahoma,Peggs,933,72,255,174,65,35,601
Oklahoma,Piney,33,26,7,0,0,0,33
Oklahoma,Proctor,235,0,55,86,18,16,175
Oklahoma,Rose,263,45,143,16,0,8,212
Oklahoma,Steely Hollow,169,5,34,63,0,0,102
Oklahoma,Swink,66,12,18,10,6,1,47
Oklahoma,Sycamore,165,58,34,0,0,0,92
Oklahoma,Teresita,144,17,35,39,20,5,116
Oklahoma,Titanic,350,22,89,77,21,8,217
Oklahoma,Turpin,388,28,115,110,7,2,262
Oklahoma,Tuskahoma,107,2,28,29,3,8,70
Oklahoma,Wauhillau,479,75,87,98,3,11,274
Oklahoma,Old Green,587,42,206,43,62,0,353
Oklahoma,Okarche,1445,41,381,294,235,40,991
Oklahoma,Pawnee,2141,155,641,415,134,68,1413
Oklahoma,Idabel,6925,681,1885,1226,462,168,4422
Oklahoma,Ardmore,24892,2305,5379,5241,2035,1602,16562
Oklahoma,Camargo,130,3,23,24,29,3,82
Oklahoma,Grainola,50,2,17,6,5,2,32
Oklahoma,Okemah,3191,514,672,620,197,103,2106
Oklahoma,Scraper,250,16,82,57,0,57,212
Oklahoma,Kemp,126,16,55,24,4,0,99
Oklahoma,Mutual,101,7,38,18,2,5,70
Oklahoma,Bennington,296,34,100,25,28,6,193
Oklahoma,Justice,1407,18,368,334,232,53,1005
Oklahoma,Antlers,2594,377,549,431,158,84,1599
Oklahoma,Sperry,1201,136,361,240,70,24,831
Oklahoma,Mill Creek,334,46,71,41,27,2,187
Oklahoma,Mooreland,1537,34,308,344,207,66,959
Oklahoma,Amber,423,34,131,78,22,4,269
Oklahoma,Holdenville,5611,1007,1543,999,191,121,3861
Oklahoma,Brush Creek,18,18,0,0,0,0,18
Oklahoma,Bull Hollow,64,9,20,11,0,0,40
Oklahoma,Leach,294,9,55,62,46,17,189
Oklahoma,Cleveland,3166,254,904,648,260,88,2154
Oklahoma,Collinsville,6720,267,1223,1495,815,406,4206
Oklahoma,Briggs,355,48,59,46,27,15,195
Oklahoma,Dry Creek,180,29,55,51,5,12,152
Oklahoma,Hulbert,605,89,181,89,36,22,417
Oklahoma,Welling,638,39,198,116,70,11,434
Oklahoma,Stigler,2725,409,641,470,194,60,1774
Oklahoma,Broken Bow,4102,575,970,540,214,42,2341
Oklahoma,Haworth,311,67,91,36,14,1,209
Oklahoma,White Oak,269,15,88,60,33,0,196
Oklahoma,Fletcher,965,55,280,180,98,29,642
Oklahoma,Whitesboro,203,14,62,36,10,3,125
Oklahoma,Burneyville,627,24,157,127,69,72,449
Oklahoma,Chelsea,1990,164,551,407,97,48,1267
Oklahoma,Sweetwater,60,3,16,23,7,5,54
Oklahoma,Foster,145,8,69,16,14,2,109
Oklahoma,Katie,514,28,149,84,15,9,285
Oklahoma,Oologah,1241,74,333,240,90,21,758
Oklahoma,Verdigris,4372,200,755,1119,506,157,2737
Oklahoma,Beaver,1469,213,384,217,80,28,922
Oklahoma,New Woodville,199,20,38,20,7,0,85
Oklahoma,Ringwood,594,105,139,64,30,16,354
Oklahoma,Tiawah,213,0,28,59,42,0,129
Oklahoma,Albany,113,4,14,51,28,10,107
Oklahoma,Arpelar,321,4,120,91,8,16,239
Oklahoma,Stoney Point,243,35,66,45,10,9,165
Oklahoma,Badger Lee,50,15,14,0,0,0,29
Oklahoma,Bison,32,5,10,5,0,12,32
Oklahoma,Blackgum,85,8,7,18,0,0,33
Oklahoma,Blue,272,27,78,52,15,0,172
Oklahoma,Box,187,50,28,90,7,0,175
Oklahoma,Butler,146,0,39,36,10,11,96
Oklahoma,Cartwright,577,165,160,95,48,15,483
Oklahoma,Chester,150,15,34,12,36,0,97
Oklahoma,Dale,222,0,30,39,22,14,105
Oklahoma,Deer Lick,0,0,0,0,0,0,0
Oklahoma,Drowning Creek,213,59,51,41,10,0,161
Oklahoma,Eagletown,597,52,205,118,18,3,396
Oklahoma,Elm Grove,265,22,86,20,7,0,135
Oklahoma,Bee,151,37,62,15,5,0,119
Oklahoma,Sand Hill,341,25,133,54,24,10,246
Oklahoma,Pinhook Corner,158,0,54,29,30,0,113
Oklahoma,Perkins,2866,188,567,593,358,69,1775
Oklahoma,Clarita,110,10,43,11,0,4,68
Oklahoma,Coleman,256,22,106,63,14,5,210
Oklahoma,Connerville,152,33,81,0,0,0,114
Oklahoma,Gowen,366,30,39,33,55,16,173
Oklahoma,Latta,1227,18,226,297,136,81,758
Oklahoma,Lequire,184,38,39,25,19,6,127
Oklahoma,Monroe,208,18,56,40,3,0,117
Oklahoma,Panola,25,0,7,8,0,0,15
Oklahoma,Platter,198,22,74,48,0,0,144
Oklahoma,Wardville,30,5,13,6,0,6,30
Oklahoma,Skiatook,8047,552,2008,1612,693,173,5038
Oklahoma,Liberty,329,27,62,101,23,2,215
Oklahoma,McLoud,4649,420,1313,1199,244,87,3263
Oklahoma,Carlton Landing,13,0,2,0,7,0,9
Oklahoma,Blanco,91,12,18,24,6,0,60
Oklahoma,Mazie,130,29,44,37,11,0,121
Oklahoma,Wickliffe,7,0,0,7,0,0,7
Oklahoma,Earlsboro,549,64,173,109,30,16,392
Oklahoma,Johnson,222,20,52,42,30,11,155
Oklahoma,St. Louis,100,12,53,15,1,4,85
Oklahoma,Shawnee,31141,2711,6883,6490,2500,1529,20113
Oklahoma,Calumet,611,15,173,132,55,14,389
Oklahoma,Bridge Creek,342,13,99,69,29,8,218
Oklahoma,Carlisle,580,133,158,68,29,30,418
Oklahoma,Friendship,43,17,7,9,0,5,38
Oklahoma,IXL,55,10,10,11,3,2,36
Oklahoma,Marietta,166,8,48,10,11,0,77
Oklahoma,White Water,65,0,9,21,0,0,30
Oklahoma,Talihina,1010,85,256,235,43,34,653
Oklahoma,Pond Creek,1039,99,216,158,112,62,647
Oklahoma,Dill City,503,41,182,76,15,11,325
Oklahoma,Warwick,202,32,71,67,4,2,176
Oklahoma,Lehigh,282,41,99,34,15,6,195
Oklahoma,Coyle,289,30,91,35,23,10,189
Oklahoma,Marshall,224,17,49,63,22,1,152
Oklahoma,Wellston,851,52,273,168,56,24,573
Oklahoma,Arcadia,252,14,84,77,17,5,197
Oklahoma,Del City,21874,1980,5192,5406,1343,566,14487
Oklahoma,Luther,1309,122,277,227,140,46,812
Oklahoma,Loco,106,25,46,10,10,3,94
Oklahoma,Meridian,33,0,5,14,1,4,24
Oklahoma,Optima,432,59,120,63,7,9,258
Oklahoma,Alderson,205,22,70,50,3,0,145
Oklahoma,Watts,337,53,109,25,4,0,191
Oklahoma,Meno,175,29,45,21,17,4,116
Oklahoma,Longtown,2731,279,866,833,216,83,2277
Oklahoma,Lenapah,257,13,85,50,10,3,161
Oklahoma,Deer Creek,177,18,30,32,6,3,89
Oklahoma,Lamont,342,23,68,54,55,1,201
Oklahoma,Medford,1179,99,278,237,107,43,764
Oklahoma,Bethany,19472,1359,3553,4261,2177,1078,12428
Oklahoma,Choctaw,12367,590,2789,2849,1608,825,8661
Oklahoma,Edmond,91053,1934,8596,16130,18343,12964,57967
Oklahoma,Warr Acres,10360,1004,2249,1734,907,359,6253
Oklahoma,Peoria,123,26,42,23,1,0,92
Oklahoma,Dibble,990,78,213,157,130,25,603
Oklahoma,Afton,1189,131,294,222,39,6,692
Oklahoma,Crowder,407,49,103,78,23,23,276
Oklahoma,Winchester,570,48,123,150,20,28,369
Oklahoma,Henryetta,5671,662,1517,1162,309,189,3839
Oklahoma,Cedar Valley,482,25,66,133,74,81,379
Oklahoma,Depew,427,60,112,69,21,12,274
Oklahoma,Cherry Tree,1052,223,248,153,34,15,673
Oklahoma,Forgan,522,61,130,84,31,33,339
Oklahoma,Lawrence Creek,134,10,46,27,8,1,92
Oklahoma,Mounds,1061,63,320,229,59,29,700
Oklahoma,Burns Flat,2196,132,566,367,138,15,1218
Oklahoma,Cleo Springs,384,10,116,68,23,16,233
Oklahoma,East Duke,373,14,80,70,44,24,232
Oklahoma,Elmer,95,15,37,21,1,4,78
Oklahoma,Ames,264,33,79,37,8,4,161
Oklahoma,Canadian,162,16,44,32,9,2,103
Oklahoma,Cimarron City,167,5,42,24,17,10,98
Oklahoma,Beggs,1453,172,389,325,67,33,986
Oklahoma,Grayson,135,14,35,41,5,3,98
Oklahoma,Okmulgee,12024,1138,2622,2952,617,329,7658
Oklahoma,Schulter,392,52,106,98,20,4,280
Oklahoma,Hooker,1740,217,263,309,202,15,1006
Oklahoma,Tyrone,716,93,128,114,75,21,431
Oklahoma,Wakita,295,33,95,72,19,14,233
Oklahoma,Fallis,47,0,44,3,0,0,47
Oklahoma,Spencer,4012,316,1163,976,194,200,2849
Oklahoma,Prague,2042,221,558,451,122,79,1431
Oklahoma,Sparks,152,13,55,30,1,0,99
Oklahoma,Forest Park,1145,67,199,305,154,135,860
Oklahoma,Bray,1112,80,386,185,88,30,769
Oklahoma,Marlow,4512,480,1414,833,215,139,3081
Oklahoma,Meridian,1631,152,619,350,107,0,1228
Oklahoma,North Miami,351,60,100,60,17,2,239
Oklahoma,Elmore City,872,77,311,153,33,9,583
Oklahoma,Kremlin,265,9,63,66,26,6,170
Oklahoma,Claremore,18780,1066,4359,4408,1599,777,12209
Oklahoma,Blanchard,8573,344,1959,1927,1111,535,5876
Oklahoma,Morrison,774,81,161,129,76,33,480
Oklahoma,Hardesty,334,62,52,53,8,8,183
Oklahoma,Christie,116,0,42,29,16,0,87
Oklahoma,Lyons Switch,335,53,81,44,24,13,215
Oklahoma,Knowles,14,1,0,13,0,0,14
Oklahoma,Sapulpa,20659,1871,5267,4174,1705,580,13597
Oklahoma,Shamrock,14,2,7,2,0,0,11
Oklahoma,Martha,133,13,42,18,5,0,78
Oklahoma,Corn,663,73,156,111,103,49,492
Oklahoma,Manchester,52,1,23,7,3,0,34
Oklahoma,Carney,646,63,157,181,32,10,443
Oklahoma,Buffalo,1175,136,275,204,115,59,789
Oklahoma,Stroud,2714,224,729,607,184,66,1810
Oklahoma,Nichols Hills,3891,31,154,312,1319,1022,2838
Oklahoma,Velma,650,56,179,122,25,20,402
Oklahoma,Coalgate,1987,238,583,322,124,48,1315
Oklahoma,Tupelo,315,49,73,46,10,10,188
Oklahoma,Texhoma,782,82,208,65,80,5,440
Oklahoma,Fairfield,516,72,198,49,37,28,384
Oklahoma,Salem,54,29,25,0,0,0,54
Oklahoma,Gate,99,12,16,22,16,4,70
Oklahoma,Oilton,888,82,297,150,20,23,572
Oklahoma,Blair,801,88,143,191,46,22,490
Oklahoma,Eldorado,429,57,101,88,16,6,268
Oklahoma,Krebs,2049,147,524,476,153,46,1346
Oklahoma,Lake Aluma,77,0,2,8,10,39,59
Oklahoma,Norman,121090,4843,14557,22237,16691,13202,71530
Oklahoma,Moore,60807,3171,11727,14534,7315,2804,39551
Oklahoma,Greenfield,132,14,40,14,5,3,76
Oklahoma,Foyil,311,31,102,50,7,2,192
Oklahoma,Remy,607,88,144,142,83,13,470
Oklahoma,Gould,131,20,17,37,18,5,97
Oklahoma,Marietta,2713,365,726,362,69,59,1581
Oklahoma,Foraker,12,0,10,0,2,0,12
Oklahoma,Brent,863,90,248,166,74,24,602
Oklahoma,Redbird Smith,447,103,137,73,15,23,351
Oklahoma,Manitou,156,16,50,22,0,1,89
Oklahoma,Porter,692,88,167,140,53,5,453
Oklahoma,Amorita,34,0,5,6,3,0,14
Oklahoma,Kaw City,329,26,104,95,12,2,239
Oklahoma,Leedey,531,20,117,73,39,19,268
Oklahoma,Oakwood,30,3,12,8,5,2,30
Oklahoma,Westville,1717,224,445,254,59,11,993
Oklahoma,Ashland,35,2,12,8,0,6,28
Oklahoma,Kellyville,1233,149,312,216,40,17,734
Oklahoma,Clinton,9297,1153,1894,1779,685,313,5824
Oklahoma,Cromwell,242,39,65,38,1,3,146
Oklahoma,Sentinel,847,81,219,170,47,52,569
Oklahoma,Erin Springs,137,14,59,15,6,0,94
Oklahoma,Wilburton,2663,346,526,581,114,101,1668
Oklahoma,Waukomis,1462,74,502,239,103,32,950
Oklahoma,Vinita,5478,557,1527,1179,346,177,3786
Oklahoma,Stidham,18,1,7,0,2,0,10
Oklahoma,Ochelata,433,20,151,85,33,6,295
Oklahoma,Stonewall,404,52,124,91,24,9,300
Oklahoma,Canton,480,36,170,77,40,36,359
Oklahoma,Cooperton,7,0,7,0,0,0,7
Oklahoma,Meeker,1236,156,281,295,118,37,887
Oklahoma,Rock Island,772,118,249,128,24,25,544
Oklahoma,Wynona,364,34,118,76,9,4,241
Oklahoma,Colony,136,12,30,35,8,4,89
Oklahoma,Dustin,457,54,161,78,17,0,310
Oklahoma,Shady Grove CDP (McIntosh County),235,49,27,75,0,20,171
Oklahoma,Bowlegs,378,42,103,87,7,13,252
Oklahoma,Pryor Creek,9402,731,2453,1874,529,363,5950
Oklahoma,Caney,207,19,56,38,15,3,131
Oklahoma,Ralston,300,43,83,47,13,4,190
Oklahoma,Burlington,151,6,26,18,24,13,87
Oklahoma,Ninnekah,1166,72,337,193,125,23,750
Oklahoma,Seiling,893,82,169,133,107,23,514
Oklahoma,Tonkawa,3090,266,561,708,258,133,1926
Oklahoma,Dacoma,89,9,30,26,9,1,75
Oklahoma,Soper,234,34,71,42,7,6,160
Oklahoma,Terral,422,81,121,82,8,7,299
Oklahoma,Bokoshe,448,74,152,57,20,4,307
Oklahoma,Union City,1532,83,477,396,155,70,1181
Oklahoma,Hinton,3232,673,766,471,254,86,2250
Oklahoma,Jenks,21793,795,2296,4261,4096,2058,13506
Oklahoma,Owasso,35646,1298,5961,7450,5528,2148,22385
Oklahoma,Fort Towson,532,68,170,103,36,17,394
Oklahoma,Cayuga,146,5,45,38,19,10,117
Oklahoma,Cloud Creek,91,16,24,19,0,9,68
Oklahoma,Jay,2499,390,597,401,117,65,1570
Oklahoma,New Eucha,470,75,160,98,33,13,379
Oklahoma,Oaks,266,28,67,41,10,5,151
Oklahoma,West Siloam Springs,818,143,262,124,58,18,605
Oklahoma,Milburn,333,39,79,103,9,5,235
Oklahoma,Ada,17276,1372,3126,2862,2009,1256,10625
Oklahoma,Disney,204,23,74,58,15,3,173
Oklahoma,Boynton,196,21,34,58,7,0,120
Oklahoma,Olustee,678,56,168,135,11,2,372
Oklahoma,Sawyer,321,31,92,84,22,8,237
Oklahoma,Cornish,152,21,48,21,11,1,102
Oklahoma,Grandfield,864,146,192,151,73,25,587
Oklahoma,Webb City,47,11,8,19,0,0,38
Oklahoma,Hugo,5184,705,1326,980,204,106,3321
Oklahoma,Fairfax,1384,170,422,268,92,24,976
Oklahoma,Osage,135,19,68,17,5,0,109
Oklahoma,Salina,1210,119,360,272,66,9,826
Oklahoma,Arnett,585,38,183,101,72,23,417
Oklahoma,Braggs,271,13,60,66,8,7,154
Oklahoma,Hennessey,2584,357,720,358,144,84,1663
Oklahoma,Loyal,111,2,17,47,16,0,82
Oklahoma,Tatums,126,7,60,21,4,0,92
Oklahoma,Wilson,1434,142,423,262,91,46,964
Oklahoma,Iron Post,178,8,57,43,0,0,108
Oklahoma,Texola,62,4,43,10,5,0,62
Oklahoma,Big Cabin,213,24,64,48,5,6,147
Oklahoma,Breckenridge,209,17,51,29,44,6,147
Oklahoma,Strong City,40,1,20,7,2,0,30
Oklahoma,Kiefer,2462,106,610,507,205,69,1497
Oklahoma,Dewey,3462,333,1052,712,199,126,2422
Oklahoma,Okeene,1152,199,205,231,94,36,765
Oklahoma,Laverne,1836,270,344,361,166,35,1176
Oklahoma,Vera,185,16,74,32,9,2,133
Oklahoma,Maysville,1196,138,365,174,44,11,732
Oklahoma,Hillsdale,95,10,32,18,10,4,74
Oklahoma,Fairmont,228,16,92,31,18,7,164
Oklahoma,Pink,2155,221,463,434,185,98,1401
Oklahoma,Muskogee,37900,3788,8383,7079,3528,1621,24399
Oklahoma,Locust Grove,1541,201,353,293,45,24,916
Oklahoma,Piedmont,7424,129,809,1629,1400,617,4584
Oklahoma,Dodge,96,12,20,17,20,0,69
Oklahoma,Grove,6862,531,1497,1922,962,509,5421
Oklahoma,Ravia,528,100,138,100,18,0,356
Oklahoma,Ballou,295,23,96,20,35,15,189
Oklahoma,Panama,1244,189,373,179,38,35,814
Oklahoma,Warner,1493,163,261,282,79,42,827
Oklahoma,Eakly,383,74,72,43,12,3,204
Oklahoma,Alex,546,57,169,120,23,16,385
Oklahoma,Chickasha,16297,1453,4312,2906,1446,630,10747
Oklahoma,Howe,941,154,269,184,41,5,653
Oklahoma,Brushy,1156,222,310,131,72,24,759
Oklahoma,Flute Springs,96,17,36,15,4,0,72
Oklahoma,Long,290,23,58,58,38,29,206
Oklahoma,Vian,1275,167,366,211,57,23,824
Oklahoma,Cleora,1473,101,353,409,223,88,1174
Oklahoma,Colcord,991,154,269,171,45,11,650
Oklahoma,Dennis,165,0,17,36,34,19,106
Oklahoma,Tagg Flats,49,0,11,22,0,0,33
Oklahoma,Hollister,57,22,25,6,0,0,53
Oklahoma,Loveland,2,0,0,2,0,0,2
Oklahoma,Carmen,452,31,127,87,50,20,315
Oklahoma,Cherokee,1598,127,378,343,142,81,1071
Oklahoma,Freedom,331,18,58,88,31,4,199
Oklahoma,Tishomingo,3063,374,551,729,172,140,1966
Oklahoma,Old Eucha,25,9,5,8,0,0,22
Oklahoma,Rocky Ford,35,3,8,8,0,6,25
Oklahoma,Mannsville,955,105,254,195,49,7,610
Oklahoma,Mead,106,12,17,34,9,5,77
Oklahoma,Bokchito,691,86,207,130,27,11,461
Oklahoma,Achille,359,53,99,74,18,10,254
Oklahoma,Stringtown,406,35,153,61,17,8,274
Oklahoma,Fort Gibson,4063,226,1003,633,562,204,2628
Oklahoma,Oktaha,380,47,119,67,14,4,251
Oklahoma,River Bottom,260,29,97,63,14,0,203
Oklahoma,Sour John,88,10,36,14,2,0,62
Oklahoma,Devol,148,3,51,22,12,6,94
Oklahoma,Walters,2686,235,721,598,166,64,1784
Oklahoma,Jennings,307,28,112,45,9,2,196
Oklahoma,Oak Grove,9,0,4,5,0,0,9
Oklahoma,Skedee,18,1,7,3,1,0,12
Oklahoma,Fair Oaks,95,7,25,32,9,0,73
Oklahoma,Okay,493,48,146,107,27,5,333
Oklahoma,Caddo,1221,99,316,243,152,61,871
Oklahoma,Silo,426,38,104,84,33,22,281
Oklahoma,Colbert,1331,161,427,261,95,47,991
Oklahoma,Allen,870,109,280,154,46,35,624
Oklahoma,Ryan,770,133,173,143,41,10,500
Oklahoma,Oakland,973,161,219,132,67,20,599
Oklahoma,El Reno,18714,1782,4970,4111,1269,444,12576
Oklahoma,Cement,429,66,151,63,1,0,281
Oklahoma,Fort Coffee,435,50,109,82,19,9,269
Oklahoma,Poteau,8793,1095,1862,1781,609,388,5735
Oklahoma,Shady Point,1033,126,266,208,23,22,645
Oklahoma,Castle,123,18,35,21,0,2,76
Oklahoma,Gore,956,116,221,207,94,53,691
Oklahoma,Short,334,91,118,44,2,0,255
Oklahoma,Kingfisher,4861,426,987,839,462,287,3001
Oklahoma,Ratliff City,116,4,59,12,0,0,75
Oklahoma,Rattan,309,28,82,63,25,14,212
Oklahoma,Carnegie,1875,195,512,356,95,41,1199
Oklahoma,Hoot Owl,0,0,0,0,0,0,0
Oklahoma,Armstrong,107,11,42,25,11,1,90
Oklahoma,Hammon,527,52,186,121,15,5,379
Oklahoma,Council Hill,124,14,56,16,2,0,88
Oklahoma,Porum,699,115,157,107,24,4,407
Oklahoma,Summit,113,30,32,14,2,2,80
Oklahoma,Cheyenne,835,58,178,172,45,21,474
Oklahoma,Lone Grove,5052,369,1047,1062,450,256,3184
Oklahoma,Newkirk,2232,234,527,536,111,40,1448
Oklahoma,Tushka,289,29,67,54,18,14,182
Oklahoma,Thackerville,375,43,121,83,7,3,257
Oklahoma,Hartshorne,2087,180,553,508,166,33,1440
Oklahoma,Kiowa,657,67,209,112,33,10,431
Oklahoma,Bessie,159,11,58,25,21,2,117
Oklahoma,New Cordell,2851,183,807,469,241,178,1878
Oklahoma,Douglas,20,3,4,5,0,0,12
Oklahoma,Renfrow,8,2,4,2,0,0,8
Oklahoma,Cashion,716,40,139,189,88,27,483
Oklahoma,McAlester,18095,1818,4432,4191,1316,714,12471
Oklahoma,Quinton,938,142,222,202,16,0,582
Oklahoma,Nicoma Park,2543,210,692,623,186,43,1754
Oklahoma,Comanche,1565,125,532,338,83,8,1086
Oklahoma,Empire City,992,51,245,257,79,21,653
Oklahoma,Granite,1910,293,613,406,123,40,1475
Oklahoma,Seminole,7328,708,1548,1613,436,210,4515
Oklahoma,Canute,456,19,162,83,35,8,307
Oklahoma,Wann,110,2,40,22,12,2,78
Oklahoma,Maud,1143,87,248,255,46,45,681
Oklahoma,Wewoka,3367,465,628,868,152,79,2192
Oklahoma,Erick,962,117,223,202,85,12,639
Oklahoma,Copeland,1852,152,517,476,88,90,1323
Oklahoma,Horntown,124,6,34,23,2,9,74
Oklahoma,Wyandotte,370,45,77,78,14,5,219
Oklahoma,Inola,1894,94,500,392,133,45,1164
Oklahoma,Dotyville,134,0,16,37,13,33,99
Oklahoma,Stratford,1362,114,367,214,77,24,796
Oklahoma,Hunter,219,13,87,30,14,3,147
Oklahoma,Cowlington,99,6,25,23,5,0,59
Oklahoma,Redbird,94,2,38,18,4,0,62
Oklahoma,Tipton,824,130,201,135,79,13,558
Oklahoma,Madill,3900,779,860,523,207,141,2510
Oklahoma,Paden,481,48,149,94,32,10,333
Oklahoma,Taft,136,9,59,28,7,5,108
Oklahoma,Calera,2596,220,544,600,224,49,1637
Oklahoma,Harrah,6083,432,1534,1420,572,304,4262
Oklahoma,Adair,873,52,169,205,57,16,499
Oklahoma,Foss,151,17,59,34,12,10,132
Oklahoma,Kendrick,100,11,27,19,4,1,62
Oklahoma,Peavine,431,34,150,72,34,4,294
Oklahoma,Chandler,3103,274,763,639,176,108,1960
Oklahoma,Mangum,2837,272,596,723,237,53,1881
Oklahoma,Stilwell,4012,584,939,504,227,70,2324
Oklahoma,Haileyville,682,66,177,182,26,8,459
Oklahoma,Davenport,786,90,236,116,34,19,495
Oklahoma,Phillips,143,22,24,23,1,2,72
Oklahoma,Gene Autry,138,21,38,28,4,0,91
Oklahoma,Carrier,36,3,10,4,5,8,30
Oklahoma,Fargo,370,40,92,63,29,17,241
Oklahoma,Watonga,2900,717,881,695,108,112,2513
Oklahoma,Rosedale,52,11,24,3,1,0,39
Oklahoma,Perry,4994,329,1362,852,577,151,3271
Oklahoma,Goldsby,2199,157,387,437,362,150,1493
Oklahoma,Lamar,172,19,67,25,12,4,127
Oklahoma,Hitchita,81,17,29,13,1,0,60
Oklahoma,Rentiesville,131,10,53,32,15,4,114
Oklahoma,Heavener,3334,672,694,508,111,27,2012
Oklahoma,Temple,983,117,400,141,10,14,682
Oklahoma,Hobart,3562,518,852,730,314,40,2454
Oklahoma,Eldon,121,21,39,23,5,6,94
Oklahoma,Keys,442,0,106,149,20,70,345
Oklahoma,Zeb,583,71,99,138,70,24,402
Oklahoma,Coweta,9637,577,1981,2154,869,370,5951
Oklahoma,Durant,17517,1723,3117,3320,1651,1119,10930
Oklahoma,Francis,285,45,70,54,13,3,185
Oklahoma,Agra,294,29,123,38,7,8,205
Oklahoma,Midwest City,57292,3765,12101,14192,5445,2659,38162
Oklahoma,Central High,1106,73,252,220,186,69,800
Oklahoma,The Village,9385,531,1435,2122,2334,863,7285
Oklahoma,Duncan,22823,1964,5962,4629,2049,809,15413
Oklahoma,Willow,126,14,28,42,11,3,98
Oklahoma,Mulhall,237,20,76,43,19,5,163
Oklahoma,Orlando,112,12,44,11,4,2,73
Oklahoma,Le Flore,155,18,49,18,5,5,95
Oklahoma,Dwight Mission,53,9,8,0,18,0,35
Oklahoma,Wapanucka,407,52,100,65,14,8,239
Oklahoma,Oklahoma City,637284,56994,104685,126402,81715,43662,413458
Oklahoma,Fort Supply,427,30,122,79,37,8,276
Oklahoma,Wanette,281,34,86,49,14,6,189
Oklahoma,Ponca City,24424,2214,5033,5355,2391,877,15870
Oklahoma,Chattanooga,419,25,137,68,50,12,292
Oklahoma,Davidson,319,43,83,37,9,3,175
Oklahoma,Sharon,107,7,32,10,18,2,69
Oklahoma,Cameron,278,43,99,30,9,4,185
Oklahoma,Hydro,1041,81,251,196,133,45,706
Oklahoma,Bridgeport,83,19,30,13,4,1,67
Oklahoma,Binger,677,61,240,117,39,16,473
Oklahoma,Texanna,2400,274,767,584,146,59,1830
Oklahoma,Drumright,2854,352,842,476,126,68,1864
Oklahoma,Longdale,389,30,132,37,10,0,209
Oklahoma,Paoli,664,37,241,87,44,14,423
Oklahoma,Sasakwa,107,13,26,17,4,0,60
Oklahoma,Geary,1245,114,237,293,82,24,750
Oklahoma,Norge,149,29,48,28,5,0,110
Oklahoma,Yukon,26317,1115,5245,6924,3409,1348,18041
Oklahoma,Cyril,954,73,206,213,89,14,595
Oklahoma,Gracemont,258,48,76,54,7,7,192
Oklahoma,Wister,1031,122,365,201,38,14,740
Oklahoma,Belfonte,318,105,49,33,0,6,193
Oklahoma,Marble City,231,45,58,35,12,8,158
Oklahoma,Taloga,353,13,110,56,46,39,264
Oklahoma,Moffett,128,31,44,16,2,0,93
Oklahoma,Blackwell,6786,591,1691,1761,356,256,4655
Oklahoma,Davis,2808,372,653,549,191,61,1826
Oklahoma,Dougherty,223,16,83,38,12,6,155
Oklahoma,Kansas,932,156,302,107,43,7,615
Oklahoma,Twin Oaks,244,43,63,53,30,0,189
Oklahoma,Bromide,109,32,25,19,11,5,92
Oklahoma,Chouteau,2124,125,516,490,217,54,1402
Oklahoma,Murphy,134,0,86,16,32,0,134
Oklahoma,Snake Creek,254,29,36,72,20,0,157
Oklahoma,Spavinaw,389,44,130,96,12,4,286
Oklahoma,Strang,85,10,21,25,2,0,58
Oklahoma,Asher,368,53,104,69,14,7,247
Oklahoma,Macomb,28,15,6,3,0,0,24
Oklahoma,Vici,710,40,306,131,72,17,566
Oklahoma,Langley,652,71,151,190,34,14,460
Oklahoma,Fitzhugh,263,10,46,84,17,21,178
Oklahoma,Bethel Acres,3136,147,787,748,334,111,2127
Oklahoma,Dripping Springs,55,0,31,3,0,0,34
Oklahoma,Flint Creek,836,42,295,109,109,17,572
Oklahoma,Zena,130,0,50,34,0,10,94
Oklahoma,Cedar Crest,225,63,75,34,0,0,172
Oklahoma,Grand Lake Towne,81,2,21,24,8,14,69
Oklahoma,Wynnewood,2026,190,627,402,125,66,1410
Oklahoma,Red Oak,581,74,175,109,36,19,413
Oklahoma,Ketchum,426,37,110,98,31,7,283
Oklahoma,Welch,664,50,163,140,52,10,415
Oklahoma,Snyder,1467,193,374,240,115,45,967
Oklahoma,Drummond,395,39,106,60,44,7,256
Oklahoma,North Enid,1059,51,256,250,96,45,698
Oklahoma,Gotebo,195,20,81,41,9,1,152
Oklahoma,Billings,598,51,211,125,11,4,402
Oklahoma,Calvin,316,34,50,53,16,17,170
Oklahoma,Gerty,59,12,21,8,1,1,43
Oklahoma,Wetumka,1325,171,340,220,87,34,852
Oklahoma,Checotah,3188,382,912,544,167,128,2133
Oklahoma,Valley Park,71,0,10,10,6,9,35
Oklahoma,Marland,316,53,47,52,2,1,155
Oklahoma,Sequoyah,893,35,256,155,103,8,557
Oklahoma,Eufaula,2886,353,977,604,214,93,2241
Oklahoma,Cushing,7788,887,2370,1459,393,149,5258
Oklahoma,Glencoe,521,22,181,129,41,13,386
Oklahoma,Stillwater,49527,1265,4257,6250,5580,5142,22494
Oklahoma,Lindsay,2820,336,1065,429,172,95,2097
Oklahoma,Pauls Valley,6143,893,1552,1001,355,295,4096
Oklahoma,Quapaw,747,106,209,164,8,10,497
Oklahoma,New Alluwe,59,5,21,15,5,0,46
Oklahoma,Commerce,2293,378,628,362,103,31,1502
Oklahoma,Hitchcock,57,7,23,4,2,2,38
Oklahoma,Putnam,54,2,17,16,13,0,48
Oklahoma,Sulphur,5024,580,1134,907,404,222,3247
Oklahoma,Addington,141,8,44,30,15,1,98
Oklahoma,Ringling,965,109,245,203,40,9,606
Oklahoma,Mustang,20735,964,4042,5224,2561,817,13608
Oklahoma,Arkoma,1872,311,544,276,91,41,1263
Oklahoma,Cache,2886,152,749,711,233,131,1976
Oklahoma,Webbers Falls,544,60,125,108,27,14,334
Oklahoma,Ramona,556,47,185,128,21,7,388
Oklahoma,Slaughterville,4294,291,1349,834,260,72,2806
Oklahoma,Elgin,3037,153,469,764,291,104,1781
Oklahoma,Sterling,617,90,192,138,27,11,458
Oklahoma,May,58,5,13,16,4,3,41
Oklahoma,Newcastle,9657,424,1787,2419,1230,693,6553
Oklahoma,Wayne,605,64,168,94,30,11,367
Oklahoma,Narcissa,126,0,55,29,19,0,103
Oklahoma,Lotsee,5,0,0,0,4,0,4
Oklahoma,Mannford,3184,153,730,593,324,125,1925
Oklahoma,Haskell,2052,168,501,401,143,45,1258
Oklahoma,Reydon,140,4,32,30,17,0,83
Oklahoma,Healdton,2740,306,899,451,167,28,1851
Oklahoma,Springer,622,49,179,116,58,9,411
Oklahoma,Braman,182,18,55,43,10,3,129
Oklahoma,Kildare,93,8,34,19,6,2,69
Oklahoma,Bartlesville,36448,2140,7474,7004,5459,2615,24692
Oklahoma,Duchess Landing,65,0,42,23,0,0,65
Oklahoma,Yale,1176,131,341,205,72,13,762
Oklahoma,Lawton,94697,6526,18431,20456,7589,5027,58029
Oklahoma,South Coffeyville,781,61,195,189,50,13,508
Oklahoma,Konawa,1173,118,243,278,50,40,729
Oklahoma,Lima,67,16,13,12,2,6,49
Oklahoma,Carter,232,33,68,67,6,3,177
Oklahoma,Hickory,116,8,29,16,10,1,64
Oklahoma,Albion,93,6,32,24,3,1,66
Oklahoma,Clayton,676,98,154,161,28,12,453
Oklahoma,Woodward,12601,1011,3178,2109,1140,558,7996
Oklahoma,Fairland,1139,95,298,236,46,20,695
Oklahoma,Tulsa,402223,34215,66525,81857,53653,27468,263718
Oklahoma,Guymon,11679,2224,1735,1621,968,466,7014
Oklahoma,Atoka,3059,350,757,587,185,85,1964
Oklahoma,Hendrix,70,9,28,13,0,2,52
Oklahoma,Leon,109,16,41,11,6,2,76
Oklahoma,Avant,269,36,104,46,7,0,193
Oklahoma,Frederick,3685,603,782,648,183,163,2379
Oklahoma,Catoosa,7640,718,1834,1711,554,219,5036
Oklahoma,Keyes,248,18,81,38,21,9,167
Oklahoma,Alva,5154,365,816,924,724,389,3218
Oklahoma,Fort Cobb,627,57,203,100,29,40,429
Oklahoma,Lookeba,162,35,43,21,2,1,102
Oklahoma,Boley,1207,345,463,194,38,15,1055
Oklahoma,Rush Springs,1264,109,455,150,102,29,845
Oklahoma,Verden,669,83,183,122,49,7,444
Oklahoma,Pocola,4066,332,1258,816,238,71,2715
Oklahoma,Anadarko,6664,506,1455,1334,516,120,3931
Oklahoma,Bradley,121,14,47,20,3,0,84
Oklahoma,Sportsmen Acres,351,35,83,53,13,9,193
Oklahoma,Hominy,3457,443,1175,702,167,91,2578
Oklahoma,Prue,410,43,151,52,18,8,272
Oklahoma,Limestone,879,67,153,180,92,73,565
Oklahoma,Gregory,169,6,37,32,30,7,112
Oklahoma,Talala,363,27,73,62,13,34,209
Oklahoma,Custer City,448,51,102,87,30,1,271
Oklahoma,Elk City,12046,891,3196,2339,963,496,7885
Oklahoma,Spaulding,134,17,33,32,8,1,91
Oklahoma,Yeager,72,7,18,15,5,1,46
Oklahoma,Hanna,100,20,28,6,1,0,55
Oklahoma,Ripley,288,16,91,53,11,2,173
Oklahoma,Copan,804,50,271,170,50,8,549
Oklahoma,Etowah,137,25,36,33,7,4,105
Oklahoma,Lexington,2413,337,699,358,158,37,1589
Oklahoma,Noble,6718,395,1421,1506,781,222,4325
Oklahoma,Faxon,72,0,30,17,3,1,51
Oklahoma,Geronimo,1006,54,287,250,60,47,698
Oklahoma,Medicine Park,291,10,64,88,61,24,247
Oklahoma,Rosston,55,5,12,5,17,0,39
Oklahoma,Dickson,1333,90,307,233,115,75,820
Oklahoma,Byars,171,24,59,26,10,1,120
Oklahoma,Minco,1603,138,486,260,157,30,1071
Oklahoma,Tuttle,6982,303,1545,1437,970,308,4563
Oklahoma,Bearden,138,11,27,27,8,11,84
Oklahoma,Clearview,27,4,9,8,1,2,24
Oklahoma,Akins,558,64,191,71,12,11,349
Oklahoma,Evening Shade,305,23,105,77,37,37,279
Oklahoma,Notchietown,184,39,66,10,19,0,134
Oklahoma,Kinta,290,38,57,51,16,5,167
Oklahoma,Woodall,835,84,218,231,43,9,585
Oklahoma,Butler,242,21,87,44,17,5,174
Oklahoma,Pin Oak Acres,484,49,167,84,39,0,339
Oklahoma,Sams Corner,160,9,41,62,11,0,123
Oklahoma,Brooksville,50,6,23,7,2,0,38
Oklahoma,Purcell,6380,789,1395,1247,553,141,4125
Oklahoma,Wainwright,142,17,37,19,13,0,86
Oklahoma,Roff,678,59,225,86,20,23,413
Oklahoma,Gage,533,50,182,87,24,8,351
Oklahoma,Burbank,84,19,27,8,11,1,66
Oklahoma,Pawhuska,3516,415,840,915,190,97,2457
Oklahoma,Shattuck,1291,144,270,252,122,31,819
Oklahoma,Dover,324,33,77,57,25,10,202
Oklahoma,Cole,761,48,149,144,113,12,466
Oklahoma,Miami,13335,1196,2934,2918,799,423,8270
Oklahoma,Headrick,96,9,22,24,6,4,65
Oklahoma,Fairview,2620,150,737,623,206,95,1811
Oklahoma,Pocasset,164,28,45,29,9,1,112
Oklahoma,Boise City,1076,138,289,182,131,17,757
Oklahoma,Byron,39,1,15,4,10,2,32
Oklahoma,Lambert,5,0,1,2,2,0,5
Oklahoma,Fanshawe,402,55,116,48,23,22,264
Oklahoma,Spiro,2604,362,722,376,116,70,1646
Oklahoma,Roland,3646,454,929,695,146,75,2299
Oklahoma,Goltry,233,18,61,42,23,18,162
Oklahoma,Muldrow,3276,363,782,754,162,26,2087
Oklahoma,Paradise Hill,79,8,13,11,13,6,51
Oklahoma,Park Hill,3969,393,833,749,364,100,2439
Oklahoma,Wright City,730,88,207,87,43,22,447
Oklahoma,Pettit,829,42,101,155,114,133,545
Oklahoma,Shady Grove CDP (Cherokee County),467,56,134,75,35,19,319
Oklahoma,Whitefield,457,49,125,74,18,13,279
Oklahoma,Blackburn,83,10,29,8,8,0,55
Oklahoma,Hallett,117,13,46,23,1,1,84
Oklahoma,Terlton,93,18,34,15,0,0,67
Oklahoma,Wagoner,8808,927,2152,1752,711,299,5841
Oklahoma,Byng,1269,47,311,256,175,85,874
Oklahoma,Helena,1508,301,552,390,68,19,1330
Oklahoma,Broken Arrow,107500,4199,16322,26084,17070,6758,70433
Oklahoma,Valliant,790,134,252,123,35,15,559
Oklahoma,Simms,244,43,76,58,8,8,193
Oklahoma,Weatherford,11973,619,1321,1873,1304,589,5706
Oklahoma,Waurika,2148,232,614,384,140,63,1433
Oklahoma,Kingston,1714,182,525,353,88,22,1170
Oklahoma,Apache,1415,85,365,380,149,26,1005
Oklahoma,Sayre,4598,585,1256,891,400,155,3287
Oklahoma,Bluejacket,300,67,72,64,6,3,212
Oklahoma,Atwood,58,2,24,11,2,0,39
Oklahoma,Stuart,181,15,43,40,3,1,102
Oklahoma,Pensacola,109,11,22,21,5,3,62
Oklahoma,Pump Back,178,23,49,57,0,10,139
Oklahoma,Tecumseh,6625,542,1604,1526,411,159,4242
Oklahoma,Lost City,894,38,324,169,62,20,613
Oklahoma,Keota,534,85,116,66,21,5,293
Oklahoma,Tamaha,114,36,34,19,16,3,108
Oklahoma,Garvin,286,21,65,42,25,11,164
Oklahoma,Bixby,25818,850,3344,5332,4964,2179,16669
Oklahoma,Tullahassee,157,10,40,30,22,4,106
Oklahoma,Liberty,195,9,48,28,33,16,134
Oklahoma,Oakhurst,2364,333,804,470,75,44,1726
Oklahoma,Sand Springs,19864,1364,4331,4933,1929,752,13309
Oklahoma,Boswell,636,86,173,123,20,9,411
Oklahoma,Sugden,36,8,12,9,0,0,29
Oklahoma,Tahlequah,16592,1396,2134,2707,1782,1128,9147
Oklahoma,Tenkiller,673,83,157,97,46,31,414
Oklahoma,Randlett,376,27,142,70,18,5,262
Oklahoma,McCurtain,449,62,116,72,19,1,270
Oklahoma,Maramec,120,17,29,28,0,4,78
Oklahoma,Jet,242,9,64,52,22,12,159
Oklahoma,Tribbey,335,41,118,74,11,5,249
Oklahoma,Waynoka,1093,125,284,140,101,26,676
Oklahoma,Dewar,852,62,263,178,35,7,545
Oklahoma,Morris,1413,81,268,372,93,37,851
Oklahoma,Goodwell,1353,48,100,198,147,64,557
Oklahoma,Indiahoma,355,22,82,90,26,6,226
Oklahoma,Washington,735,46,109,154,67,46,422
Oklahoma,Glenpool,13313,629,2255,3218,1637,380,8119
Oklahoma,Indianola,137,19,34,23,8,3,87
Oklahoma,Pittsburg,208,27,66,32,12,2,139
Oklahoma,Savanna,686,48,176,154,40,27,445
Oklahoma,Rocky,181,4,91,40,10,0,145
Oklahoma,Delaware,438,51,167,69,9,2,298
Oklahoma,Nowata,3674,372,1176,820,94,45,2507
Oklahoma,Enid,50612,4166,11870,9479,4380,2646,32541
Oklahoma,Garber,848,51,246,153,46,30,526
Oklahoma,Turley,2615,481,784,485,91,27,1868
Oklahoma,Lone Wolf,409,32,67,118,31,19,267
Oklahoma,Mountain View,674,67,190,139,73,6,475
Oklahoma,Mountain Park,500,41,144,70,31,8,294
Oklahoma,Covington,512,33,144,109,18,19,323
Oklahoma,Lahoma,518,24,156,115,61,4,360
Oklahoma,Roosevelt,331,25,93,50,27,0,195
Oklahoma,Red Rock,380,37,97,99,18,3,254
Oklahoma,Bushyhead,1169,168,353,239,47,43,850
Oklahoma,Arapaho,897,67,295,145,56,2,565
Oklahoma,Thomas,1280,128,324,231,160,54,897
Oklahoma,Hastings,73,9,18,37,0,3,67
Oklahoma,Capron,0,0,0,0,0,0,0
Oklahoma,Guthrie,11165,770,2623,2299,1000,478,7170
Oklahoma,Centrahoma,68,12,26,4,0,0,42
Oklahoma,Bernice,513,66,154,159,34,7,420
Oklahoma,Valley Brook,936,168,260,120,33,0,581
Oklahoma,Gans,267,28,81,44,12,5,170
Oklahoma,Sallisaw,8547,1188,2091,1655,527,178,5639
Oklahoma,Millerton,295,37,97,39,15,8,196
Oklahoma,Smithville,85,2,8,17,20,0,47
Oklahoma,Westport,484,38,130,116,41,41,366
Oklahoma,Kenefic,169,14,45,25,3,8,95
Oklahoma,Hollis,1921,355,346,443,193,28,1365
Oklahoma,Barnsdall,1140,94,344,210,88,12,748
Oklahoma,Woodlawn Park,171,5,25,48,39,29,146
Oklahoma,Shidler,328,47,100,50,26,7,230
Oklahoma,Aline,149,28,60,13,9,0,110
Oklahoma,Greasy,267,66,93,39,3,8,209
Oklahoma,Crescent,1325,94,459,287,96,33,969
Oklahoma,Langston,1238,20,42,69,98,29,258
Oklahoma,McCord,1570,133,532,334,106,14,1119
Oklahoma,Bell,424,76,128,63,6,0,273
Oklahoma,Hoffman,106,16,41,16,4,2,79
Oklahoma,Jones,3024,291,665,661,182,142,1941
Oklahoma,Tryon,540,65,132,108,28,8,341
Oklahoma,Nash,221,2,68,56,36,14,176
Oklahoma,Jefferson,8,0,3,3,0,0,6
Oklahoma,Altus,19034,2291,3260,3959,1657,1000,12167
Oklahoma,Smith Village,79,10,18,36,6,0,70
Oklahoma,Bristow,4194,392,1127,769,242,57,2587
Oklahoma,Zion,24,0,7,4,2,0,13
Oklahoma,West Peavine,399,43,158,57,8,3,269
Oklahoma,Rocky Mountain,447,63,132,72,46,2,315
Oklahoma,Chewey,66,10,31,13,2,0,56
Oklahoma,Slick,163,16,71,25,0,0,112
Oregon,Gresham,110770,10128,20079,27428,10533,5006,73174
Oregon,Wilsonville,23418,607,2903,5379,4609,2616,16114
Oregon,Sherwood,19337,361,1597,3990,3786,2031,11765
Oregon,Hillsboro,104730,7170,12937,21343,16673,11826,69949
Oregon,Gaston,546,59,151,165,19,5,399
Oregon,Mehama,192,0,101,19,0,0,120
Oregon,Sublimity,2899,173,650,779,430,149,2181
Oregon,Donald,1287,123,316,319,103,53,914
Oregon,Deschutes River Woods,5775,302,1313,1764,435,258,4072
Oregon,Sandy,10834,620,1921,3083,817,359,6800
Oregon,Woodburn,25417,4467,4495,4303,1513,622,15400
Oregon,Dallas,15805,793,3448,4215,1684,819,10959
Oregon,Scio,766,42,191,211,75,16,535
Oregon,Wood Village,4036,609,827,646,181,62,2325
Oregon,Haines,357,27,142,96,18,15,298
Oregon,Eagle Point,9015,697,1837,2630,765,344,6273
Oregon,Nyssa,3175,456,471,574,67,56,1624
Oregon,Mount Vernon,472,69,166,97,22,6,360
Oregon,North Powder,490,78,84,120,32,0,314
Oregon,Winston,5406,309,1328,1571,212,153,3573
Oregon,Clatskanie,1668,160,384,432,80,55,1111
Oregon,Depoe Bay,1772,42,382,648,294,162,1528
Oregon,Barview,2066,209,699,549,104,109,1670
Oregon,Coos Bay,16176,1466,3279,4540,1196,923,11404
Oregon,Harrisburg,3741,308,961,621,206,133,2229
Oregon,Monmouth,10131,579,709,1652,1085,597,4622
Oregon,Eola,0,0,0,0,0,0,0
Oregon,Raleigh Hills,5892,107,484,1422,1770,969,4752
Oregon,Sisters,2555,159,331,704,375,182,1751
Oregon,Sweet Home,9435,900,2499,2493,300,107,6299
Oregon,Amity,1782,96,527,407,120,31,1181
Oregon,Klamath Falls,21138,1794,3962,5326,1841,1248,14171
Oregon,Port Orford,950,69,179,325,187,91,851
Oregon,Huntington,361,83,70,113,14,7,287
Oregon,Jacksonville,2873,34,581,578,588,636,2417
Oregon,Shady Cove,3041,320,935,677,300,88,2320
Oregon,White City,8953,1206,1935,2140,273,162,5716
Oregon,Astoria,9747,563,1511,2758,1425,1042,7299
Oregon,Cannon Beach,1489,58,277,448,165,165,1113
Oregon,Fairview,9303,934,1712,2721,1013,447,6827
Oregon,Maywood Park,998,64,97,250,198,110,719
Oregon,Rufus,193,25,78,53,4,0,160
Oregon,Grants Pass,37201,2543,7687,10647,2361,1671,24909
Oregon,Portland,639387,36928,72838,130715,138564,92821,471866
Oregon,Terrebonne,1626,286,301,283,148,130,1148
Oregon,Four Corners,16045,1834,3569,3880,764,277,10324
Oregon,Hubbard,3399,494,593,672,208,99,2066
Oregon,Jefferson,3270,246,608,752,318,90,2014
Oregon,Mill City,1691,202,469,432,77,38,1218
Oregon,Butte Falls,412,30,105,112,32,8,287
Oregon,Arlington,508,46,121,149,62,5,383
Oregon,Rockcreek,9898,327,1134,2254,2053,1236,7004
Oregon,West Haven-Sylvan,8434,99,438,1564,2280,2051,6432
Oregon,Idanha,161,23,73,28,0,0,124
Oregon,Halfway,319,23,115,89,23,19,269
Oregon,Lonerock,10,2,8,0,0,0,10
Oregon,Keizer,38479,2634,6572,9359,4435,2114,25114
Oregon,Tygh Valley,201,0,98,73,9,0,180
Oregon,Gardiner,382,57,42,121,6,0,226
Oregon,Warrenton,5453,326,865,1725,514,268,3698
Oregon,Idaville,356,30,124,104,41,9,308
Oregon,Juntura,35,5,10,14,1,0,30
Oregon,Kerby,1075,59,410,138,94,0,701
Oregon,Kings Valley,161,49,0,41,25,0,115
Oregon,Lacomb,820,83,123,191,49,5,451
Oregon,Langlois,89,0,0,50,39,0,89
Oregon,Lookingglass,910,18,138,476,51,15,698
Oregon,Melrose,679,0,198,238,64,34,534
Oregon,Merlin,1856,121,453,782,93,118,1567
Oregon,Mount Hood,409,25,84,27,0,8,144
Oregon,Mulino,2413,116,475,596,270,103,1560
Oregon,Nesika Beach,352,0,120,168,52,12,352
Oregon,New Hope,1317,99,410,491,110,44,1154
Oregon,New Pine Creek,67,35,18,14,0,0,67
Oregon,O'Brien,406,0,134,138,73,0,345
Oregon,Peoria,184,20,0,62,32,15,129
Oregon,Pistol River,115,0,82,33,0,0,115
Oregon,Plush,66,5,18,25,8,2,58
Oregon,Pronghorn,50,0,0,3,18,29,50
Oregon,Prospect,409,15,134,188,33,13,383
Oregon,Ruch,721,36,70,186,214,72,578
Oregon,Selma,658,107,51,382,24,0,564
Oregon,Seventh Mountain,348,0,17,60,144,109,330
Oregon,Shedd,563,188,36,39,9,25,297
Oregon,Silver Lake,83,8,16,40,6,0,70
Oregon,Stafford,1807,74,201,280,609,240,1404
Oregon,Imbler,361,11,61,119,53,3,247
Oregon,Holley,333,61,95,48,10,16,230
Oregon,Gold Beach,2208,283,322,815,192,209,1821
Oregon,Harper,118,9,17,29,18,2,75
Oregon,Glasgow,809,48,203,279,52,37,619
Oregon,Troutdale,16559,967,2817,4728,1991,572,11075
Oregon,Umatilla,7114,1088,1807,1566,274,134,4869
Oregon,Redmond,29234,2707,5920,8205,2477,963,20272
Oregon,Three Rivers,3593,113,814,1115,400,261,2703
Oregon,Gates,542,35,154,201,40,13,443
Oregon,Labish Village,466,120,68,51,15,0,254
Oregon,Scotts Mills,462,59,76,119,31,8,293
Oregon,King City,3807,91,505,1115,777,516,3004
Oregon,Grand Ronde,1745,191,556,364,156,51,1318
Oregon,Metzger,3477,149,674,788,490,361,2462
Oregon,West Slope,7498,161,929,1297,1630,1348,5365
Oregon,Falls City,1162,127,291,292,80,27,817
Oregon,Central Point,18130,1260,3776,4778,1576,727,12117
Oregon,Cascade Locks,1109,101,198,310,80,33,722
Oregon,Milwaukie,20955,864,3323,6095,3565,1918,15765
Oregon,Biggs Junction,26,0,12,0,14,0,26
Oregon,Moro,324,19,65,84,46,11,225
Oregon,La Pine,2188,171,595,596,142,75,1579
Oregon,The Dalles,15320,1488,2818,3975,1405,782,10468
Oregon,Crawfordsville,431,45,118,158,43,0,364
Oregon,Days Creek,296,67,71,51,13,39,241
Oregon,Deer Island,196,98,30,36,6,0,170
Oregon,Dillard,371,32,228,33,0,14,307
Oregon,Fort Hill,81,0,48,33,0,0,81
Oregon,Eagle Crest,2191,93,236,746,687,303,2065
Oregon,Fair Oaks,254,29,30,128,0,16,203
Oregon,Foots Creek,610,10,144,197,47,25,423
Oregon,Government Camp,166,0,26,36,25,60,147
Oregon,Medford,80051,6479,14914,19713,8909,4370,54385
Oregon,Warm Springs,3311,359,564,736,116,64,1839
Oregon,Hayesville,22272,3335,3714,4312,1464,618,13443
Oregon,Philomath,4702,291,640,1050,756,428,3165
Oregon,Canyon City,848,58,201,185,78,61,583
Oregon,Lakeview,2765,253,575,653,244,126,1851
Oregon,Paisley,338,16,106,70,27,20,239
Oregon,La Grande,13103,551,2593,2786,1403,725,8058
Oregon,Granite,12,0,0,2,10,0,12
Oregon,Monument,90,18,17,28,4,3,70
Oregon,Rainier,2109,139,521,579,172,83,1494
Oregon,Rose Lodge,1359,170,406,456,98,58,1188
Oregon,Bunker Hill,1986,171,379,539,107,0,1196
Oregon,Powers,1048,106,218,394,38,8,764
Oregon,Lowell,1173,67,190,382,112,57,808
Oregon,Chenoweth,2053,157,543,432,110,86,1328
Oregon,Springfield,61525,4947,12737,16426,5076,1909,41095
Oregon,Waterloo,265,19,62,92,7,5,185
Oregon,Wallowa,853,42,202,290,73,19,626
Oregon,Mosier,431,5,83,147,36,46,317
Oregon,Wamic,62,5,35,22,0,0,62
Oregon,Lafayette,4105,525,787,967,306,63,2648
Oregon,Yamhill,1353,75,232,408,107,45,867
Oregon,Adair Village,1189,14,60,298,203,106,681
Oregon,Corvallis,57213,1264,3558,7750,9466,9003,31041
Oregon,Glide,1235,89,341,306,110,103,949
Oregon,Elkton,226,19,68,93,6,0,186
Oregon,Willamina,2412,186,547,737,96,39,1605
Oregon,Gladstone,12045,601,2214,3318,1637,455,8225
Oregon,Sodaville,481,16,86,131,60,20,313
Oregon,Joseph,1005,46,208,368,118,93,833
Oregon,Lebanon,16599,1167,3832,4617,1470,606,11692
Oregon,Pine Grove,102,11,37,35,12,0,95
Oregon,Enterprise,1990,136,556,459,195,124,1470
Oregon,Maupin,535,33,133,192,35,29,422
Oregon,Dundee,3219,155,484,838,433,179,2089
Oregon,Island City,1028,74,269,218,130,44,735
Oregon,Union,2066,133,439,610,209,101,1492
Oregon,Oakland,829,73,188,252,53,31,597
Oregon,Riddle,1331,165,325,287,19,27,823
Oregon,Summit,128,28,10,14,38,0,90
Oregon,Milton-Freewater,7035,951,1150,1370,328,178,3977
Oregon,Pilot Rock,1445,95,347,374,107,4,927
Oregon,Weston,748,75,190,140,24,11,440
Oregon,Johnson City,500,43,146,174,52,9,424
Oregon,Toledo,3540,273,871,948,259,137,2488
Oregon,Waldport,2043,101,427,777,153,121,1579
Oregon,Yachats,669,68,87,194,119,106,574
Oregon,Bandon,3072,154,605,1016,210,279,2264
Oregon,Oakridge,3261,593,857,706,208,103,2467
Oregon,Dufur,576,4,130,193,47,22,396
Oregon,Newberg,23167,2010,2905,5012,3096,1402,14425
Oregon,Chiloquin,980,96,187,209,84,4,580
Oregon,Elgin,1382,89,566,296,45,24,1020
Oregon,Seneca,233,43,57,69,5,2,176
Oregon,Canby,17527,1356,2721,4501,2064,938,11580
Oregon,Prineville,9748,1089,2253,2481,684,230,6737
Oregon,Irrigon,2095,299,423,445,85,15,1267
Oregon,Cape Meares,88,0,0,38,0,41,79
Oregon,Netarts,792,22,130,193,174,84,603
Oregon,Canyonville,1787,184,476,461,72,39,1232
Oregon,Parkdale,407,109,83,74,7,0,273
Oregon,Hebo,159,8,41,90,0,7,146
Oregon,Stanfield,2751,424,506,563,166,57,1716
Oregon,Shaniko,14,4,4,1,0,0,9
Oregon,Rowena,301,38,88,28,26,0,180
Oregon,Yoncalla,1121,77,358,284,58,6,783
Oregon,Altamont,18987,1640,4037,5022,1344,724,12767
Oregon,Summerville,173,3,40,50,19,5,117
Oregon,Ione,332,32,79,97,15,9,232
Oregon,Scappoose,7125,271,1297,1921,791,349,4629
Oregon,Millersburg,1646,76,297,548,166,61,1148
Oregon,Dayville,127,14,49,22,21,9,115
Oregon,Boardman,3340,698,540,441,83,63,1825
Oregon,Condon,655,35,184,217,67,32,535
Oregon,Salem,166756,14232,27381,37804,18511,11382,109310
Oregon,Antelope,74,15,28,15,4,0,62
Oregon,Mount Angel,3502,482,756,864,299,101,2502
Oregon,Independence,9556,918,1180,2138,819,289,5344
Oregon,Gearhart,1531,67,228,495,278,130,1198
Oregon,Prairie City,636,31,137,182,91,39,480
Oregon,McMinnville,33662,3049,5475,7619,3309,2088,21540
Oregon,Madras,6674,843,1167,1479,397,234,4120
Oregon,Coburg,1144,50,217,337,117,76,797
Oregon,Brownsville,1867,108,448,540,141,85,1322
Oregon,Stayton,8025,681,1688,2060,360,174,4963
Oregon,Aurora,1254,46,131,287,198,146,808
Oregon,Wasco,371,32,118,109,31,18,308
Oregon,Tangent,1137,77,220,334,109,50,790
Oregon,Forest Grove,23923,2168,3927,4757,2517,1216,14585
Oregon,Rivergrove,509,9,54,83,139,81,366
Oregon,Columbia City,2065,178,552,593,133,124,1580
Oregon,Metolius,1038,140,218,159,24,19,560
Oregon,Lyons,1141,99,288,280,103,23,793
Oregon,Sheridan,6106,515,1899,1809,298,152,4673
Oregon,Cove,728,61,145,206,69,22,503
Oregon,Monroe,715,63,177,186,34,14,474
Oregon,Culver,1838,205,320,332,76,48,981
Oregon,Greenhorn,8,0,0,4,0,4,8
Oregon,John Day,2251,171,490,465,236,158,1520
Oregon,Long Creek,166,20,49,28,8,11,116
Oregon,Cottage Grove,10083,862,2000,2794,890,379,6925
Oregon,Creswell,5291,268,860,1872,512,89,3601
Oregon,Junction City,5946,337,1190,1572,429,281,3809
Oregon,Westfir,252,39,56,114,8,8,225
Oregon,Halsey,919,52,247,227,34,43,603
Oregon,Aumsville,4058,279,753,980,133,44,2189
Oregon,Brooks,570,65,111,57,64,16,313
Oregon,Detroit,79,0,33,12,20,7,72
Oregon,Marion,485,74,61,174,17,18,344
Oregon,Richland,228,10,30,89,21,16,166
Oregon,Unity,67,6,39,11,4,1,61
Oregon,Gold Hill,1343,107,300,374,168,25,974
Oregon,Oatfield,13531,641,2575,3654,2185,1238,10293
Oregon,Silverton,10028,408,1839,2355,1074,802,6478
Oregon,Oak Hills,11962,378,918,2177,2656,1578,7707
Oregon,Tigard,52368,2726,6109,11658,10745,5609,36847
Oregon,Tualatin,27338,1013,2732,6161,5725,3064,18695
Oregon,Phoenix,4536,359,942,1474,465,242,3482
Oregon,Rogue River,2563,146,600,733,126,180,1785
Oregon,Seaside,6643,517,1161,2086,452,452,4668
Oregon,Adams,429,12,86,129,30,18,275
Oregon,Sunriver,1302,13,206,320,356,108,1003
Oregon,Tri-City,4090,524,1062,1129,117,118,2950
Oregon,Tetherow,534,0,0,93,91,155,339
Oregon,Glendale,826,78,164,248,33,17,540
Oregon,Roseburg North,5207,287,1208,1723,318,170,3706
Oregon,North Plains,2427,140,398,567,407,167,1679
Oregon,Cornelius,12575,2143,2080,2451,831,315,7820
Oregon,Cedar Mill,17897,382,1048,2818,4085,3436,11769
Oregon,Aloha,55492,4263,8398,12787,8123,2688,36259
Oregon,Fossil,503,38,132,164,21,2,357
Oregon,Ukiah,255,19,65,64,7,9,164
Oregon,Tutuilla,447,45,101,128,27,31,332
Oregon,Riverside,202,21,24,55,8,16,124
Oregon,Pendleton,16713,1233,3273,4984,1036,718,11244
Oregon,Kirkpatrick,159,12,36,46,9,0,103
Oregon,Cave Junction,2323,200,476,754,100,142,1672
Oregon,Garden Home-Whitford,6666,82,462,1317,1952,1265,5078
Oregon,Myrtle Creek,3435,243,1053,977,150,53,2476
Oregon,Cedar Hills,8480,556,900,1899,1693,1028,6076
Oregon,Turner,2284,141,423,705,222,77,1568
Oregon,Gervais,2666,446,616,345,39,24,1470
Oregon,Butteville,241,16,17,68,59,18,178
Oregon,West Linn,26511,470,1918,4726,6683,4168,17965
Oregon,St. Paul,449,18,89,82,58,33,280
Oregon,Oak Grove,17183,1226,2907,4640,2603,1558,12934
Oregon,Molalla,9082,723,1634,2535,543,179,5614
Oregon,Mitchell,75,13,31,22,0,0,66
Oregon,Mission,924,54,176,229,61,17,537
Oregon,Neskowin,187,0,10,63,0,114,187
Oregon,Beaver,110,0,28,8,7,67,110
Oregon,Roseburg,22988,1595,4510,6239,2542,1793,16679
Oregon,Reedsport,4072,459,999,1222,211,133,3024
Oregon,Green,7695,875,1761,2273,435,178,5522
Oregon,Banks,1811,55,267,528,202,54,1106
Oregon,Lexington,195,7,50,68,2,3,130
Oregon,Sutherlin,7941,554,1993,2186,694,238,5665
Oregon,Heppner,1093,79,258,331,157,10,835
Oregon,Takilma,367,13,25,196,15,32,281
Oregon,Siletz,1497,163,335,436,66,33,1033
Oregon,Prescott,82,9,20,21,22,3,75
Oregon,Ontario,10997,1342,1912,2277,585,381,6497
Oregon,Florence,8815,743,2069,2874,1091,556,7333
Oregon,Malin,970,316,176,92,22,4,610
Oregon,Bay City,1514,74,347,520,166,43,1150
Oregon,Jennings Lodge,8138,433,1443,2454,973,450,5753
Oregon,Happy Valley,19471,383,1900,3489,4082,2863,12717
Oregon,Cloverdale,396,11,137,110,17,34,309
Oregon,Albany,52736,2826,8455,14282,6418,3266,35247
Oregon,Eugene,165997,7251,17772,36658,24474,18979,105134
Oregon,North Bend,9615,553,1575,2997,914,580,6619
Oregon,Lakeside,1766,151,432,781,144,30,1538
Oregon,Winchester Bay,378,26,39,204,27,10,306
Oregon,Coquille,3856,218,1091,1293,141,180,2923
Oregon,Vernonia,1851,182,538,478,133,88,1419
Oregon,St. Helens,13446,1119,3090,3576,909,338,9032
Oregon,Cayuse,71,3,15,17,2,6,43
Oregon,Lincoln City,8684,780,1757,2349,789,757,6432
Oregon,Lostine,326,19,79,120,13,10,241
Oregon,Vale,2016,220,365,457,140,41,1223
Oregon,Jordan Valley,155,11,27,60,23,1,122
Oregon,Dayton,2643,330,496,519,221,67,1633
Oregon,Echo,693,64,213,141,44,14,476
Oregon,Tillamook,5176,489,1426,1333,327,133,3708
Oregon,Rockaway Beach,1213,88,230,379,161,82,940
Oregon,Pacific City,1037,124,185,271,39,64,683
Oregon,Manzanita,333,0,46,88,96,94,324
Oregon,Garibaldi,864,64,255,255,55,28,657
Oregon,Bonanza,439,79,57,113,33,17,299
Oregon,Carlton,2032,122,350,662,134,39,1307
Oregon,Myrtle Point,2506,295,788,596,121,94,1894
Oregon,Merrill,745,161,166,150,43,15,535
Oregon,Talent,6424,552,848,1501,986,490,4377
Oregon,Beatty,0,0,0,0,0,0,0
Oregon,Neahkahnie,85,11,0,0,39,35,85
Oregon,Jeffers Gardens,305,14,48,93,32,32,219
Oregon,Wimer,369,0,120,172,30,24,346
Oregon,Williams,1126,41,225,433,183,12,894
Oregon,Westport,200,34,69,60,24,13,200
Oregon,Warren,2053,83,572,599,285,47,1586
Oregon,Wallowa Lake,15,0,4,11,0,0,15
Oregon,West Scio,175,0,0,35,25,0,60
Oregon,Umapine,313,34,63,113,23,14,247
Oregon,Tumalo,615,0,39,47,139,226,451
Oregon,Damascus,12024,361,2497,3173,1774,863,8668
Oregon,Crooked River Ranch,4051,254,898,1675,407,148,3382
Oregon,Barlow,119,5,36,18,15,8,82
Oregon,Crane,99,7,5,18,7,14,51
Oregon,Cascadia,192,17,45,63,0,0,125
Oregon,Camp Sherman,228,0,16,69,58,55,198
Oregon,Bull Mountain,9591,226,732,1842,2297,1210,6307
Oregon,Brogan,137,17,23,37,8,0,85
Oregon,Blodgett,60,17,43,0,0,0,60
Oregon,Black Butte Ranch,217,0,0,89,53,68,210
Oregon,Bellfountain,8,0,8,0,0,0,8
Oregon,Beavercreek,4322,217,593,1281,794,298,3183
Oregon,Bayside Gardens,785,10,192,272,140,0,614
Oregon,Annex,288,36,70,56,6,9,177
Oregon,Alsea,256,20,42,60,3,0,125
Oregon,Alpine,180,20,18,43,46,0,127
Oregon,Trail,594,64,96,228,134,0,522
Oregon,Pine Hollow,509,39,130,239,35,9,452
Oregon,Crabtree,778,17,157,156,48,18,396
Oregon,Estacada,3270,291,734,810,212,104,2151
Oregon,Bethany,24396,578,1076,3020,5161,6046,15881
Oregon,Oregon City,36040,2135,6640,9838,4670,1700,24983
Oregon,Adrian,218,39,27,59,15,0,140
Oregon,Mount Hood Village,4587,221,836,1554,579,368,3558
Oregon,Harbor,2044,363,585,603,155,198,1904
Oregon,Brookings,6413,296,1320,2089,700,593,4998
Oregon,South Lebanon,777,17,152,260,116,17,562
Oregon,Veneta,4891,580,672,1526,385,105,3268
Oregon,Newport,10381,637,1887,2927,1270,873,7594
Oregon,Lincoln Beach,1810,182,273,576,301,279,1611
Oregon,Bend,90500,2928,10892,22548,17701,10027,64096
Oregon,Lake Oswego,38705,369,2200,5953,11586,8410,28518
Oregon,Durham,1724,59,155,379,377,200,1170
Oregon,Odell,2194,659,287,122,93,7,1168
Oregon,Hood River,7688,593,1097,1343,1270,1180,5483
Oregon,Burns,2756,315,574,792,203,65,1949
Oregon,Hermiston,17346,2774,2406,3260,1064,710,10214
Oregon,Dunes City,1178,80,170,434,149,151,984
Oregon,Gopher Flats,400,54,95,123,38,11,321
Oregon,Helix,129,0,22,40,11,3,76
Oregon,Baker City,9738,709,2369,2329,1066,470,6943
Oregon,Sumpter,187,22,75,63,12,13,185
Oregon,Redwood,2707,203,602,980,214,119,2118
Oregon,Rickreall,70,0,0,0,0,0,0
Oregon,Ashland,20912,397,1540,4100,4598,4302,14937
Oregon,Oceanside,352,0,67,120,83,67,337
Oregon,Drain,945,48,342,265,13,2,670
Oregon,Grass Valley,199,15,45,36,16,6,118
Oregon,Spray,204,13,72,62,6,1,154
Oregon,Hines,1451,36,350,476,105,90,1057
Oregon,Beaverton,97012,6033,10548,19483,21306,11258,68628
Oregon,Nehalem,481,45,89,92,16,14,256
Oregon,Wheeler,327,14,51,150,36,36,287
Oregon,Athena,1323,65,248,365,125,64,867
Pennsylvania,Evansburg,2272,28,282,563,376,353,1602
Pennsylvania,Halfway House,2810,105,602,510,402,262,1881
Pennsylvania,Plymouth Meeting,6557,262,845,971,1452,1271,4801
Pennsylvania,Rockledge borough,2537,70,639,500,434,160,1803
Pennsylvania,Doylestown borough,8307,267,1380,1528,1720,1495,6390
Pennsylvania,New Hope borough,2513,30,229,463,805,434,1961
Pennsylvania,Perkasie borough,8502,198,1942,1574,1357,735,5806
Pennsylvania,Langhorne borough,1553,85,379,305,256,176,1201
Pennsylvania,Newtown borough,1953,21,179,353,491,478,1522
Pennsylvania,Churchville,4011,76,594,600,883,518,2671
Pennsylvania,Vanderbilt borough,331,27,120,86,13,5,251
Pennsylvania,McAdoo borough,2380,156,822,452,64,55,1549
Pennsylvania,Republic,1230,107,470,170,105,37,889
Pennsylvania,Leith-Hatfield,2472,140,801,459,417,239,2056
Pennsylvania,Marlin,438,39,184,52,57,13,345
Pennsylvania,Mahanoy City borough,4018,453,1268,559,131,38,2449
Pennsylvania,Donaldson,245,10,135,40,3,0,188
Pennsylvania,Mill Village borough,363,29,124,54,38,18,263
Pennsylvania,Sand Hill,2253,183,735,472,212,68,1670
Pennsylvania,Fredericksburg CDP (Lebanon County),1644,210,421,253,81,15,980
Pennsylvania,Silverdale borough,751,21,217,123,95,64,520
Pennsylvania,Weissport borough,448,72,134,70,8,3,287
Pennsylvania,East Side borough,297,20,138,60,13,9,240
Pennsylvania,Smithfield borough,795,31,339,101,53,8,532
Pennsylvania,Burnham borough,1997,148,713,367,130,14,1372
Pennsylvania,Meadville,12949,786,3653,1801,1190,984,8414
Pennsylvania,Monument,197,45,70,16,5,0,136
Pennsylvania,Portersville borough,277,10,68,72,31,42,223
Pennsylvania,Mercersburg borough,1695,183,556,284,102,128,1253
Pennsylvania,Sugar Grove borough,641,19,200,133,57,20,429
Pennsylvania,Bear Lake borough,192,45,52,36,4,2,139
Pennsylvania,Woodland Heights,1239,35,475,280,58,59,907
Pennsylvania,Pleasantville borough (Venango County),833,41,283,184,67,36,611
Pennsylvania,Clintonville borough,438,53,166,44,30,14,307
Pennsylvania,Barkeyville borough,352,12,161,26,16,3,218
Pennsylvania,Montrose borough,1710,94,415,464,135,129,1237
Pennsylvania,Titusville,5337,380,1587,915,360,276,3518
Pennsylvania,Spartansburg borough,283,12,106,57,17,11,203
Pennsylvania,Milesburg borough,964,57,273,210,129,27,696
Pennsylvania,Fredericksburg CDP (Crawford County),1038,56,265,105,170,85,681
Pennsylvania,Blooming Valley borough,269,19,99,56,27,11,212
Pennsylvania,Harmony borough,995,27,268,182,156,51,684
Pennsylvania,Lower Allen,6937,145,1551,1546,1617,487,5346
Pennsylvania,Wheatland borough,664,76,290,102,50,4,522
Pennsylvania,New Lebanon borough,216,14,57,44,18,3,136
Pennsylvania,Mercer borough,1698,113,427,390,186,128,1244
Pennsylvania,Goldsboro borough,1205,82,293,199,80,29,683
Pennsylvania,East York,8459,530,2168,1603,1236,700,6237
Pennsylvania,Deemston borough,812,51,275,127,89,67,609
Pennsylvania,Montgomery borough,1564,125,442,332,90,34,1023
Pennsylvania,Pine Glen,177,14,64,33,8,1,120
Pennsylvania,Conneaut Lakeshore,2457,130,548,642,301,320,1941
Pennsylvania,Colwyn borough,2554,187,590,541,217,49,1584
Pennsylvania,Union City borough,3213,222,1048,586,311,112,2279
Pennsylvania,Franklin borough,225,22,103,37,25,4,191
Pennsylvania,Girard borough,3003,168,823,475,407,174,2047
Pennsylvania,Valley Green,4220,59,1103,888,601,117,2768
Pennsylvania,Stewartstown borough,1994,139,501,404,286,144,1474
Pennsylvania,Red Lion borough,6320,445,2175,1022,331,150,4123
Pennsylvania,Hanover borough,15563,1579,4474,2881,1281,855,11070
Pennsylvania,Roseville borough,114,13,38,34,11,1,97
Pennsylvania,Elkland borough,1903,146,826,225,112,54,1363
Pennsylvania,Newmanstown,2443,357,602,328,185,84,1556
Pennsylvania,Jonestown borough,1935,85,515,333,189,63,1185
Pennsylvania,Fort Indiantown Gap,87,0,19,22,14,0,55
Pennsylvania,Avon,1488,109,550,255,108,26,1048
Pennsylvania,Annville,4903,229,970,626,369,271,2465
Pennsylvania,Tresckow,1017,40,408,219,38,11,716
Pennsylvania,Pottstown borough,22694,1957,5668,4533,2023,1032,15213
Pennsylvania,Pottsgrove,3268,141,824,524,657,317,2463
Pennsylvania,Narberth borough,4350,50,336,356,957,1372,3071
Pennsylvania,East Greenville borough,2958,146,878,397,334,123,1878
Pennsylvania,Tremont borough,1801,242,750,186,51,18,1247
Pennsylvania,Rouseville borough,487,39,165,94,7,9,314
Pennsylvania,Village Shires,3796,67,605,631,844,753,2900
Pennsylvania,Penndel borough,3013,124,563,466,354,285,1792
Pennsylvania,Loretto borough,1195,15,29,24,44,75,187
Pennsylvania,Slippery Rock borough,3567,136,264,413,224,219,1256
Pennsylvania,Lawrence Park,3839,149,1108,585,539,193,2574
Pennsylvania,Wesleyville borough,3204,176,1029,695,323,92,2315
Pennsylvania,Mechanicsville borough,462,29,177,65,34,13,318
Pennsylvania,Mount Carbon borough,67,2,28,22,1,1,54
Pennsylvania,Clarion borough,5436,116,874,557,529,751,2827
Pennsylvania,Leetsdale borough,1237,103,231,243,195,110,882
Pennsylvania,Everett borough,1872,151,752,271,23,38,1235
Pennsylvania,Tarentum borough,4441,232,1430,1084,421,55,3222
Pennsylvania,Houtzdale borough,684,63,263,125,27,26,504
Pennsylvania,Warminster Heights,3948,716,835,563,325,65,2504
Pennsylvania,Spring Hill,801,51,257,151,63,24,546
Pennsylvania,Factoryville borough,1232,31,221,175,137,29,593
Pennsylvania,Clearfield borough,5970,509,1852,1248,445,274,4328
Pennsylvania,Millersburg borough,2546,310,714,463,280,103,1870
Pennsylvania,Jerseytown,82,23,24,12,3,3,65
Pennsylvania,Collingdale borough,8790,554,2204,2018,649,312,5737
Pennsylvania,Manns Choice borough,245,24,88,34,12,4,162
Pennsylvania,Avis borough,1353,95,455,242,149,37,978
Pennsylvania,Wilkinsburg borough,15637,872,3195,3583,2519,1679,11848
Pennsylvania,Grantley,3901,50,365,365,379,336,1495
Pennsylvania,Felton borough,519,35,173,92,39,12,351
Pennsylvania,Cross Roads borough,503,47,148,91,56,15,357
Pennsylvania,Liberty borough (Tioga County),269,4,69,67,6,11,157
Pennsylvania,Riverside borough,2093,58,684,199,261,305,1507
Pennsylvania,Valley View CDP (Schuylkill County),1562,126,532,313,90,50,1111
Pennsylvania,Schuylkill Haven borough,5211,361,1720,680,650,266,3677
Pennsylvania,Ravine,625,66,172,135,62,16,451
Pennsylvania,Orwigsburg borough,2990,131,987,496,365,277,2256
Pennsylvania,Ulysses borough,728,78,197,119,29,22,445
Pennsylvania,Cochranton borough,1189,86,345,224,90,43,788
Pennsylvania,West Conshohocken borough,1349,35,209,142,495,290,1171
Pennsylvania,Conneautville borough,721,58,268,73,38,24,461
Pennsylvania,New Alexandria borough,603,13,245,160,48,55,521
Pennsylvania,Herminie,474,51,147,122,37,0,357
Pennsylvania,Monessen,7397,402,2278,1502,820,346,5348
Pennsylvania,New Britain borough,2977,40,448,372,434,345,1639
Pennsylvania,Troutville borough,244,25,71,44,12,4,156
Pennsylvania,Grampian borough,396,41,127,52,18,17,255
Pennsylvania,Irvona borough,627,91,253,89,32,9,474
Pennsylvania,Sankertown borough,637,38,221,114,62,24,459
Pennsylvania,Bristol borough,9614,592,2784,1916,789,473,6554
Pennsylvania,Rainsburg borough,66,4,19,20,4,0,47
Pennsylvania,Bedford borough,2734,199,900,497,228,270,2094
Pennsylvania,Hampton,667,18,254,92,11,0,375
Pennsylvania,Bendersville borough,802,65,248,75,81,4,473
Pennsylvania,Schellsburg borough,325,29,143,41,9,10,232
Pennsylvania,Carrolltown borough,857,52,267,169,59,45,592
Pennsylvania,Ashville borough,173,13,57,51,7,2,130
Pennsylvania,Renovo borough,1089,135,423,185,37,3,783
Pennsylvania,Loganton borough,491,45,174,100,19,4,342
Pennsylvania,Paint borough,902,72,355,158,98,45,728
Pennsylvania,Meyersdale borough,1958,285,724,317,86,68,1480
Pennsylvania,Iola,212,22,67,56,3,0,148
Pennsylvania,Aristes,337,9,182,55,13,20,279
Pennsylvania,Sylvania borough,222,16,80,53,13,6,168
Pennsylvania,Scottdale borough,4191,180,1277,903,468,244,3072
Pennsylvania,Slickville,233,7,176,21,11,0,215
Pennsylvania,Economy borough,9207,358,2721,2108,1410,726,7323
Pennsylvania,Industry borough,1759,82,551,406,187,63,1289
Pennsylvania,Hallam borough,2660,99,670,732,357,38,1896
Pennsylvania,Lykens borough,1673,218,601,240,77,43,1179
Pennsylvania,Rupert,203,22,79,31,7,9,148
Pennsylvania,Millville borough,899,66,283,167,71,49,636
Pennsylvania,Lime Ridge,822,64,339,83,69,35,590
Pennsylvania,New Centerville borough,135,9,52,18,14,9,102
Pennsylvania,Jerome,757,75,230,152,125,14,596
Pennsylvania,Wilmerding borough,1949,171,480,490,70,61,1272
Pennsylvania,Salisbury borough,808,52,322,137,44,38,593
Pennsylvania,Georgetown borough,138,8,38,49,9,4,108
Pennsylvania,East Rochester borough,491,25,181,112,39,12,369
Pennsylvania,South Waverly borough,1062,65,342,228,128,80,843
Pennsylvania,Ambridge borough,6787,438,1841,1425,637,187,4528
Pennsylvania,Enola,6574,376,2079,1073,592,142,4262
Pennsylvania,Conway borough,2141,174,615,456,237,119,1601
Pennsylvania,Camp Hill borough,7911,309,1170,1293,1687,1227,5686
Pennsylvania,Sheakleyville borough,212,19,62,30,12,4,127
Pennsylvania,Fredonia borough,465,39,200,53,20,4,316
Pennsylvania,West Middletown borough,108,6,43,18,12,5,84
Pennsylvania,Marianna borough,483,34,141,116,8,0,299
Pennsylvania,Donora borough,4635,265,1463,867,362,146,3103
Pennsylvania,Baidland,1360,32,376,226,250,142,1026
Pennsylvania,Kulpmont borough,2816,279,1041,505,261,145,2231
Pennsylvania,Green Hills borough,27,0,4,5,8,2,19
Pennsylvania,Newville borough,1276,136,417,166,94,59,872
Pennsylvania,Conneaut Lake borough,731,20,261,124,91,31,527
Pennsylvania,Rome borough,500,50,158,43,21,7,279
Pennsylvania,Saxton borough,729,51,198,136,39,34,458
Pennsylvania,Waynesburg borough,4057,268,812,506,326,245,2157
Pennsylvania,Wilburton Number Two,81,8,24,18,6,0,56
Pennsylvania,Slabtown,115,7,36,27,5,6,81
Pennsylvania,Youngsville borough,1798,91,590,393,156,53,1283
Pennsylvania,Freeport borough,1841,76,607,465,128,40,1316
Pennsylvania,Jeddo borough,293,7,126,52,26,38,249
Pennsylvania,Shelocta borough,86,2,35,11,2,2,52
Pennsylvania,Marion Center borough,449,22,154,115,28,8,327
Pennsylvania,Homer City borough,1755,79,529,348,189,72,1217
Pennsylvania,Port Royal borough,830,78,351,125,62,25,641
Pennsylvania,Woodside,2468,38,151,197,460,815,1661
Pennsylvania,Trainer borough,1704,122,550,211,100,18,1001
Pennsylvania,Millbourne borough,1287,176,245,200,131,67,819
Pennsylvania,Beech Creek borough,775,59,313,133,38,19,562
Pennsylvania,Shrewsbury borough,3838,218,1126,895,484,187,2910
Pennsylvania,Shiloh,11206,805,3302,2027,1497,773,8404
Pennsylvania,New Freedom borough,4618,203,980,582,987,331,3083
Pennsylvania,Loganville borough,1329,45,328,249,153,108,883
Pennsylvania,Franklintown borough,423,15,111,103,65,13,307
Pennsylvania,Fawn Grove borough,458,41,135,85,33,29,323
Pennsylvania,Emmaus borough,11361,672,2787,2383,1739,786,8367
Pennsylvania,Tidioute borough,747,30,317,156,32,40,575
Pennsylvania,Worthington borough,676,52,193,145,31,23,444
Pennsylvania,Throop borough,3967,160,1245,838,396,237,2876
Pennsylvania,Moosic borough,5744,400,1430,1348,639,488,4305
Pennsylvania,Mount Cobb,1913,155,304,503,130,222,1314
Pennsylvania,Clairton,6640,336,2033,1605,403,215,4592
Pennsylvania,Cooperstown borough,411,19,166,90,18,7,300
Pennsylvania,Le Raysville borough,292,20,93,36,20,9,178
Pennsylvania,Roscoe borough,801,31,257,169,86,77,620
Pennsylvania,Finleyville borough,305,13,79,69,31,15,207
Pennsylvania,Sheffield,1211,61,364,237,97,13,772
Pennsylvania,Plainfield,390,14,280,44,0,10,348
Pennsylvania,Sewickley Heights borough,770,6,68,83,182,209,548
Pennsylvania,Rosslyn Farms borough,436,2,22,55,161,92,332
Pennsylvania,North Braddock borough,4758,309,1470,978,230,121,3108
Pennsylvania,Elizabeth borough,1477,77,447,342,127,42,1035
Pennsylvania,East Pittsburgh borough,1755,69,504,334,105,21,1033
Pennsylvania,Woodbury borough,270,12,94,42,28,8,184
Pennsylvania,Dormont borough,8438,178,1342,1740,2092,1043,6395
Pennsylvania,Rheems,1349,62,425,297,120,113,1017
Pennsylvania,Elizabethtown borough,11492,626,2749,1995,1020,731,7121
Pennsylvania,Big Run borough,451,7,165,113,31,7,323
Pennsylvania,Mill Creek borough,356,30,153,58,5,5,251
Pennsylvania,White Oak borough,7621,289,2217,1955,1062,493,6016
Pennsylvania,West Mifflin borough,19946,746,5553,5175,2216,1099,14789
Pennsylvania,New Holland borough,5455,481,1623,912,649,184,3849
Pennsylvania,McKees Rocks borough,5966,610,1666,1028,409,178,3891
Pennsylvania,Homestead borough,3153,279,858,646,168,128,2079
Pennsylvania,Emsworth borough,2541,100,478,649,433,236,1896
Pennsylvania,Duquesne,5544,362,1325,933,237,104,2961
Pennsylvania,Willow Street,8360,569,2267,1602,1162,938,6538
Pennsylvania,St. Clairsville borough,62,3,37,5,4,8,57
Pennsylvania,Hatboro borough,7428,317,1513,1723,957,650,5160
Pennsylvania,Stroudsburg borough,5501,747,990,1273,395,356,3761
Pennsylvania,Armagh borough,110,6,44,27,4,9,90
Pennsylvania,Mifflintown borough,1080,90,322,220,45,34,711
Pennsylvania,Tullytown borough,1922,127,666,341,167,33,1334
Pennsylvania,Espy,1658,66,441,320,221,181,1229
Pennsylvania,Bloomsburg,14275,576,2306,1663,967,499,6011
Pennsylvania,Waymart borough,1318,169,408,286,97,31,991
Pennsylvania,New Baltimore borough,185,9,84,38,4,5,140
Pennsylvania,Hooversville borough,621,69,246,98,40,12,465
Pennsylvania,Boswell borough,1345,82,579,213,60,61,995
Pennsylvania,Russellton,1447,59,380,539,258,0,1236
Pennsylvania,Oakmont borough,6450,289,1049,1099,1588,1143,5168
Pennsylvania,Laporte borough,314,57,115,70,21,17,280
Pennsylvania,Springdale borough,3353,107,1045,810,405,197,2564
Pennsylvania,Sharpsburg borough,3374,295,971,650,404,142,2462
Pennsylvania,Sewickley Hills borough,701,13,81,82,175,153,504
Pennsylvania,Aldan borough,4156,200,1231,863,608,256,3158
Pennsylvania,Martinsburg borough,1756,80,703,285,174,128,1370
Pennsylvania,Duncansville borough,1244,47,511,187,164,29,938
Pennsylvania,Courtdale borough,635,59,236,126,65,29,515
Pennsylvania,Smicksburg borough,43,0,20,14,1,0,35
Pennsylvania,Plumville borough,289,41,106,33,31,0,211
Pennsylvania,Ernest borough,514,12,131,124,67,7,341
Pennsylvania,Creekside borough,318,23,108,49,21,18,219
Pennsylvania,Black Lick,1718,206,666,306,53,25,1256
Pennsylvania,Commodore,429,95,110,30,0,0,235
Pennsylvania,Shamokin Dam borough,1926,105,589,341,231,125,1391
Pennsylvania,Heilwood,571,34,279,74,42,5,434
Pennsylvania,Freeland borough,3451,298,1116,604,199,60,2277
Pennsylvania,Benton borough,746,36,268,107,79,20,510
Pennsylvania,Yorkana borough,237,20,89,31,11,9,160
Pennsylvania,York,44044,5588,11211,5787,2237,1017,25840
Pennsylvania,Eagles Mere borough,140,0,9,19,64,30,122
Pennsylvania,Whitehall borough,13759,911,3119,2693,2145,1467,10335
Pennsylvania,Whitaker borough,1135,49,293,314,86,46,788
Pennsylvania,Berlin borough,1995,185,842,278,119,86,1510
Pennsylvania,Trappe borough,3583,49,555,790,590,407,2391
Pennsylvania,New Berlin borough,938,33,277,189,100,44,643
Pennsylvania,Yeadon borough,11487,587,2881,2379,1259,832,7938
Pennsylvania,Morrisville borough,8588,416,1877,1905,1367,644,6209
Pennsylvania,Hermitage,15812,781,4759,2996,2026,1547,12109
Pennsylvania,Coal Center borough,76,8,14,10,11,7,50
Pennsylvania,Claysville borough,929,76,322,188,83,4,673
Pennsylvania,Sligo borough,493,32,214,80,26,9,361
Pennsylvania,Callensburg borough,109,12,38,22,0,4,76
Pennsylvania,Tatamy borough,969,38,215,259,123,51,686
Pennsylvania,Glendon borough,475,47,127,49,61,18,302
Pennsylvania,Freemansburg borough,2621,273,744,489,191,102,1799
Pennsylvania,East Bangor borough,1003,104,309,176,43,9,641
Pennsylvania,Chapman borough,192,10,78,18,23,10,139
Pennsylvania,Paxtonville,267,4,104,21,16,29,174
Pennsylvania,Lucerne Mines,798,59,397,140,44,0,640
Pennsylvania,Elco borough,272,39,114,44,11,5,213
Pennsylvania,Hazleton,24812,3883,6458,3417,1339,734,15831
Pennsylvania,Levittown,51726,2758,14883,10714,4628,2597,35580
Pennsylvania,Plymptonville,1194,167,437,182,78,45,909
Pennsylvania,Worthville borough,71,0,39,7,9,4,59
Pennsylvania,Reynoldsville borough,2692,206,1099,395,122,96,1918
Pennsylvania,Shirleysburg borough,150,15,66,9,7,1,98
Pennsylvania,Mapleton borough,417,36,159,51,7,13,266
Pennsylvania,Dudley borough,208,13,84,30,9,1,137
Pennsylvania,Coalmont borough,92,7,34,19,2,4,66
Pennsylvania,Mount Union borough,2401,219,928,358,116,43,1664
Pennsylvania,Export borough,906,33,321,186,85,31,656
Pennsylvania,Derry borough,2572,161,682,644,227,123,1837
Pennsylvania,Perryopolis borough,1880,125,592,389,222,90,1418
Pennsylvania,Ohiopyle borough,25,0,4,5,6,0,15
Pennsylvania,Hopwood,1958,59,724,311,201,161,1456
Pennsylvania,Tionesta borough,326,4,157,68,27,26,282
Pennsylvania,Bryn Mawr,3740,53,278,277,460,672,1740
Pennsylvania,Blue Bell,6212,93,470,740,1700,1513,4516
Pennsylvania,West Mayfield borough,1150,57,414,280,77,15,843
Pennsylvania,South Heights borough,369,39,135,74,44,3,295
Pennsylvania,Sutersville borough,471,33,156,102,39,4,334
Pennsylvania,Centerville borough (Washington County),3189,122,970,600,356,133,2181
Pennsylvania,California borough,6441,303,1343,678,507,435,3266
Pennsylvania,Allenport borough,505,30,190,66,56,63,405
Pennsylvania,Laceyville borough,447,55,147,45,14,7,268
Pennsylvania,West York borough,4571,232,1310,856,233,80,2711
Pennsylvania,Christiana borough,1007,128,268,169,120,37,722
Pennsylvania,Columbia borough,10389,1074,3550,1626,695,267,7212
Pennsylvania,Pine Ridge,2560,171,397,631,337,255,1791
Pennsylvania,Manheim borough,4878,294,1523,750,474,237,3278
Pennsylvania,Brisbin borough,343,31,119,66,37,9,262
Pennsylvania,Dublin borough,2123,128,394,468,345,152,1487
Pennsylvania,East McKeesport borough,2106,91,674,561,140,106,1572
Pennsylvania,Lancaster,59503,8204,12363,8493,5252,3279,37591
Pennsylvania,Brickerville,1491,161,457,120,159,106,1003
Pennsylvania,Saltillo borough,302,26,124,22,24,4,200
Pennsylvania,Wernersville borough,2759,174,840,556,325,154,2049
Pennsylvania,Reading,88211,16225,17978,11161,3406,1452,50222
Pennsylvania,Lenhartsville borough,156,10,54,21,16,5,106
Pennsylvania,Muncy borough,2320,124,557,483,262,186,1612
Pennsylvania,Belleville,1726,110,681,218,294,53,1356
Pennsylvania,Hyde,1334,214,584,133,84,17,1032
Pennsylvania,Zion,2092,47,516,290,329,342,1524
Pennsylvania,Blanchard,587,70,209,77,68,17,441
Pennsylvania,Bellefonte borough,6289,269,1804,941,1394,418,4826
Pennsylvania,Laurel Run borough,566,61,181,119,53,38,452
Pennsylvania,Laflin borough,1566,35,313,260,281,239,1128
Pennsylvania,Avoca borough,2620,139,767,586,317,127,1936
Pennsylvania,Ashley borough,2733,186,808,598,159,171,1922
Pennsylvania,Rossiter,657,45,216,164,24,22,471
Pennsylvania,Glen Campbell borough,259,23,80,37,9,9,158
Pennsylvania,Plains,3997,221,1439,780,468,232,3140
Pennsylvania,Pikes Creek,445,39,118,71,28,9,265
Pennsylvania,Penryn,940,108,221,132,122,25,608
Pennsylvania,Madisonburg,233,19,68,19,16,14,136
Pennsylvania,Pringle borough,907,44,303,169,74,40,630
Pennsylvania,Lansdale borough,16579,946,3518,3018,2668,1386,11536
Pennsylvania,Central City borough,1073,91,449,155,46,65,806
Pennsylvania,Homewood borough,106,15,32,29,11,4,91
Pennsylvania,Darlington borough,211,6,63,37,19,14,139
Pennsylvania,Tuscarora,958,58,356,239,34,41,728
Pennsylvania,Minersville borough,4227,455,1405,771,258,151,3040
Pennsylvania,Friedensburg,904,34,313,229,67,67,710
Pennsylvania,Coaldale borough (Schuylkill County),2162,195,698,542,139,32,1606
Pennsylvania,Beurys Lake,133,6,38,38,8,9,99
Pennsylvania,Wattsburg borough,498,55,147,90,33,10,335
Pennsylvania,Stowe,3699,333,1112,802,242,97,2586
Pennsylvania,Pennsburg borough,3882,244,993,760,347,260,2604
Pennsylvania,Oreland,5827,166,933,967,1026,750,3842
Pennsylvania,North Wales borough,3260,69,650,646,639,351,2355
Pennsylvania,Montgomeryville,13271,246,1822,1967,3338,1838,9211
Pennsylvania,Glenside,7558,191,1042,1182,1600,877,4892
Pennsylvania,Fort Washington,5559,74,596,716,1290,1181,3857
Pennsylvania,Flourtown,4524,81,496,599,1071,832,3079
Pennsylvania,Cheswick borough,1715,40,468,381,313,215,1417
Pennsylvania,Brackenridge borough,3203,105,996,665,262,191,2219
Pennsylvania,Jenkintown borough,4442,49,655,524,1149,775,3152
Pennsylvania,Pennville,1937,166,781,239,313,32,1531
Pennsylvania,Jacobus borough,1853,38,482,354,219,148,1241
Pennsylvania,Dallastown borough,3822,305,1117,988,199,148,2757
Pennsylvania,Blossburg borough,1909,105,438,341,270,75,1229
Pennsylvania,Eastvale borough,210,22,97,12,10,0,141
Pennsylvania,Ellwood City borough,7972,520,2370,1589,694,394,5567
Pennsylvania,Freedom borough,1537,106,395,372,134,39,1046
Pennsylvania,Midland borough,3003,325,565,908,75,24,1897
Pennsylvania,Mountainhome,1073,41,346,232,175,90,884
Pennsylvania,East Stroudsburg borough,10279,891,2047,1403,837,623,5801
Pennsylvania,Wellersburg borough,210,16,74,31,17,3,141
Pennsylvania,Seven Springs borough,20,5,1,4,10,0,20
Pennsylvania,Belmont,2452,107,962,443,185,212,1909
Pennsylvania,Mill Hall borough,1642,73,557,224,138,106,1098
Pennsylvania,Lock Haven,9345,518,1858,1269,636,364,4645
Pennsylvania,Orangeville borough,433,41,165,52,27,35,320
Pennsylvania,Lightstreet,914,71,257,146,144,82,700
Pennsylvania,Jamison City,138,14,51,40,10,0,115
Pennsylvania,Foundryville,96,19,25,52,0,0,96
Pennsylvania,Williamstown borough,1187,106,409,287,48,12,862
Pennsylvania,Centralia borough,7,1,2,4,0,0,7
Pennsylvania,Sayre borough,5491,511,1532,926,498,193,3660
Pennsylvania,Pleasantville borough (Bedford County),144,14,55,19,12,6,106
Pennsylvania,Pocono Pines,972,8,206,287,206,98,805
Pennsylvania,Prompton borough,273,19,106,57,24,5,211
Pennsylvania,Bethany borough,217,7,40,54,34,21,156
Pennsylvania,Casselman borough,76,7,36,7,0,0,50
Pennsylvania,Callimont borough,67,6,11,27,1,7,52
Pennsylvania,Addison borough,258,25,94,39,8,5,171
Pennsylvania,Troy borough,1534,141,420,266,180,76,1083
Pennsylvania,Monroe borough,576,21,211,86,45,17,380
Pennsylvania,Ambler borough,6488,403,1300,980,1200,817,4700
Pennsylvania,Almedia,999,82,326,210,57,85,760
Pennsylvania,Delaware Water Gap borough,636,12,126,168,114,60,480
Pennsylvania,Honesdale borough,4308,325,1346,814,374,243,3102
Pennsylvania,Etna borough,3388,212,819,828,422,164,2445
Pennsylvania,Bradford,8424,741,2448,1408,696,401,5694
Pennsylvania,Richland borough,1544,93,575,295,145,31,1139
Pennsylvania,Quentin,620,24,223,94,36,17,394
Pennsylvania,Pleasant Hill,2825,246,824,368,146,128,1712
Pennsylvania,Palmyra borough,7498,411,2213,1355,856,462,5297
Pennsylvania,Myerstown borough,3178,313,1207,485,118,93,2216
Pennsylvania,Mount Gretna borough,225,1,17,33,40,101,192
Pennsylvania,Lebanon South,2317,63,660,392,259,213,1587
Pennsylvania,North East borough,4138,226,1151,784,495,170,2826
Pennsylvania,Erie,98156,8885,26101,15450,9442,4297,64175
Pennsylvania,Skippack,4116,47,565,668,913,516,2709
Pennsylvania,King of Prussia,20428,793,2442,2694,5521,3646,15096
Pennsylvania,Red Hill borough,2498,142,826,491,291,121,1871
Pennsylvania,Spring Mount,2338,66,460,430,429,208,1593
Pennsylvania,Aliquippa,9066,547,2870,2404,560,281,6662
Pennsylvania,West Leechburg borough,1428,54,464,333,149,64,1064
Pennsylvania,Trafford borough,3039,117,778,738,378,304,2315
Pennsylvania,Smithton borough,460,26,152,100,36,5,319
Pennsylvania,Seward borough,393,51,139,66,22,2,280
Pennsylvania,North Irwin borough,911,49,315,171,60,35,630
Pennsylvania,New Stanton borough,2351,96,612,444,352,149,1653
Pennsylvania,New Florence borough,660,70,227,131,38,11,477
Pennsylvania,Lawson Heights,2245,0,576,748,236,100,1660
Pennsylvania,Grapeville,284,9,116,74,6,18,223
Pennsylvania,Penn Wynne,5758,91,362,528,1270,1888,4139
Pennsylvania,Hopewell borough,303,25,93,55,2,2,177
Pennsylvania,Eldred borough,649,65,213,98,56,29,461
Pennsylvania,Lewis Run borough,666,34,226,137,71,25,493
Pennsylvania,Curtisville,1097,21,408,214,191,41,875
Pennsylvania,Coraopolis borough,5587,359,1553,1161,798,284,4155
Pennsylvania,Churchill borough,2963,16,369,429,816,685,2315
Pennsylvania,Castle Shannon borough,8229,361,2336,1649,1424,641,6411
Pennsylvania,Bellevue borough,8196,425,1754,1998,1806,727,6710
Pennsylvania,Paradise,1201,134,303,170,94,46,747
Pennsylvania,Brodheadsville,1459,108,482,344,180,23,1137
Pennsylvania,Swissvale borough,8808,402,1931,1707,1476,1227,6743
Pennsylvania,Mayfield borough,1753,81,512,411,205,74,1283
Pennsylvania,Hatfield borough,3332,255,716,700,441,214,2326
Pennsylvania,Mount Wolf borough,1720,89,648,284,133,74,1228
Pennsylvania,Kane borough,3557,169,1233,553,365,155,2475
Pennsylvania,Tyrone borough,5281,345,1820,960,337,191,3653
Pennsylvania,Confluence borough,583,42,205,103,57,11,418
Pennsylvania,West Homestead borough,1778,57,448,437,268,129,1339
Pennsylvania,Versailles borough,1631,108,690,329,90,51,1268
Pennsylvania,Pine Grove Mills,1168,0,190,103,410,211,914
Pennsylvania,North Philipsburg,613,37,362,120,11,13,543
Pennsylvania,Spring Mills,419,8,176,55,48,10,297
Pennsylvania,Rebersburg,708,39,207,112,28,13,399
Pennsylvania,Pleasant Gap,2917,61,953,554,536,131,2235
Pennsylvania,Houserville,2013,11,252,206,502,495,1466
Pennsylvania,Maple Glen,6614,121,887,991,1354,1143,4496
Pennsylvania,Kulpsville,8208,363,1202,1441,1869,1189,6064
Pennsylvania,Indian Lake borough,437,15,96,95,104,70,380
Pennsylvania,Railroad borough,274,4,104,44,28,18,198
Pennsylvania,McClure borough,1278,193,406,166,74,32,871
Pennsylvania,Susquehanna Trails,1891,254,540,375,117,55,1341
Pennsylvania,Koppel borough,668,30,266,181,59,24,560
Pennsylvania,Bridgeport borough,4578,298,900,906,512,476,3092
Pennsylvania,Audubon,9195,157,1146,1005,2266,1613,6187
Pennsylvania,McVeytown borough,334,23,132,39,44,18,256
Pennsylvania,Kistler borough,321,40,91,46,24,7,208
Pennsylvania,Unionville borough,238,8,109,20,25,7,169
Pennsylvania,State College borough,42256,260,1377,2290,3809,5510,13246
Pennsylvania,Port Matilda borough,596,28,205,115,94,14,456
Pennsylvania,West Grove borough,2846,423,570,458,293,99,1843
Pennsylvania,Royalton borough,1259,91,450,195,92,36,864
Pennsylvania,Progress,9750,485,2510,1710,1343,655,6703
Pennsylvania,Bear Creek Village borough,252,1,10,63,59,48,181
Pennsylvania,Chevy Chase Heights,1732,85,499,258,215,209,1266
Pennsylvania,Cherry Tree borough,371,47,111,57,19,3,237
Pennsylvania,Strattanville borough,621,45,213,108,34,17,417
Pennsylvania,Blawnox borough,1543,122,329,352,220,175,1198
Pennsylvania,Terre Hill borough,1263,130,369,125,95,56,775
Pennsylvania,Mountville borough,2856,118,801,541,320,160,1940
Pennsylvania,Millersville borough,8344,396,1224,875,941,658,4094
Pennsylvania,Denver borough,3870,308,1278,541,359,164,2650
Pennsylvania,Punxsutawney borough,5808,571,1795,965,557,255,4143
Pennsylvania,Corsica borough,352,12,116,74,25,9,236
Pennsylvania,Brockway borough,2022,92,722,380,168,100,1462
Pennsylvania,Green Lane borough,454,16,162,70,63,17,328
Pennsylvania,Souderton borough,6910,704,1826,1111,751,367,4759
Pennsylvania,Youngstown borough,320,14,115,63,35,8,235
Pennsylvania,Chambersburg borough,20734,2188,5391,3098,2090,1247,14014
Pennsylvania,Snow Shoe borough,876,66,309,124,85,19,603
Pennsylvania,Mount Carmel borough,5668,545,1988,1216,397,137,4283
Pennsylvania,McEwensville borough,375,10,162,51,25,7,255
Pennsylvania,Summit Station,191,13,93,32,33,0,171
Pennsylvania,Renningers,493,53,113,29,125,19,339
Pennsylvania,Pine Grove borough,1999,121,633,303,189,59,1305
Pennsylvania,Lake Wynonah,2483,82,702,611,369,159,1923
Pennsylvania,Gordon borough,859,43,282,134,30,76,565
Pennsylvania,Frackville borough,3668,270,1201,623,274,134,2502
Pennsylvania,Cressona borough,1618,129,480,356,128,24,1117
Pennsylvania,Platea borough,406,38,171,72,16,10,307
Pennsylvania,Three Springs borough,672,48,231,124,39,16,458
Pennsylvania,Avonia,1156,0,183,236,213,232,864
Pennsylvania,Campbelltown,4561,178,964,815,818,361,3136
Pennsylvania,Lansford borough,3808,308,1106,944,144,138,2640
Pennsylvania,Waynesboro borough,10842,949,3291,2091,728,466,7525
Pennsylvania,Schwenksville borough,1483,51,362,354,221,84,1072
Pennsylvania,Horsham,14641,559,2876,2549,2431,1821,10236
Pennsylvania,Gilbertsville,5408,243,1286,1017,824,290,3660
Pennsylvania,Phoenixville borough,16815,837,3543,2597,3339,1731,12047
Pennsylvania,Downingtown borough,7929,397,1829,1655,1358,487,5726
Pennsylvania,Coatesville,13147,1724,2984,1933,850,450,7941
Pennsylvania,Chesterbrook,4714,78,358,423,1487,1262,3608
Pennsylvania,Guilford,2691,0,545,472,534,325,1876
Pennsylvania,Albion borough,1571,153,511,302,82,56,1104
Pennsylvania,Reamstown,3438,270,1216,575,340,226,2627
Pennsylvania,Marklesburg borough,250,9,86,51,9,4,159
Pennsylvania,Alexandria borough,332,18,104,38,34,34,228
Pennsylvania,Shanor-Northvue,5107,130,1254,966,995,483,3828
Pennsylvania,Seven Fields borough,2791,11,197,332,898,553,1991
Pennsylvania,Sunbury,9581,1170,3365,1344,435,151,6465
Pennsylvania,Oakland borough,601,45,212,118,21,25,421
Pennsylvania,Lanesboro borough,411,40,139,88,20,14,301
Pennsylvania,Friendsville borough,116,12,43,31,1,2,89
Pennsylvania,Forest City borough,2131,149,833,370,185,54,1591
Pennsylvania,Wyoming borough,3022,150,727,792,498,140,2307
Pennsylvania,Wilkes-Barre,40847,4380,10670,6587,2506,1591,25734
Pennsylvania,Tunnelhill borough,330,11,142,63,25,8,249
Pennsylvania,Southmont borough,2128,50,363,396,430,293,1532
Pennsylvania,South Fork borough,903,67,344,156,35,20,622
Pennsylvania,Hastings borough,1191,58,384,201,120,79,842
Pennsylvania,East Conemaugh borough,1027,112,309,204,63,25,713
Pennsylvania,Castanea,1150,51,384,196,92,64,787
Pennsylvania,Nicholson borough,769,50,185,166,88,29,518
Pennsylvania,Meshoppen borough,464,42,169,71,15,0,297
Pennsylvania,Emporium borough,2006,164,755,424,128,39,1510
Pennsylvania,Fullerton,15578,906,4026,2906,1908,911,10657
Pennsylvania,Dickson City borough,5868,281,1927,1199,652,412,4471
Pennsylvania,Dalton borough,1292,17,251,237,327,148,980
Pennsylvania,Fairdale,2282,120,683,406,264,64,1537
Pennsylvania,Kittanning borough,3838,491,1263,636,312,130,2832
Pennsylvania,West Sunbury borough,178,8,53,56,16,6,139
Pennsylvania,Atlantic,72,18,19,2,0,0,39
Pennsylvania,Cambridge Springs borough,2619,231,852,549,233,124,1989
Pennsylvania,Guys Mills,104,4,31,8,0,0,43
Pennsylvania,Whitfield,4813,182,822,835,967,655,3461
Pennsylvania,Shoemakersville borough,1373,150,443,283,106,22,1004
Pennsylvania,Laureldale borough,3903,358,1339,691,292,170,2850
Pennsylvania,Bernville borough,919,62,191,220,87,34,594
Pennsylvania,Akron borough,3989,278,1090,737,589,214,2908
Pennsylvania,St. Lawrence borough,2060,99,543,388,251,91,1372
Pennsylvania,North Apollo borough,1328,116,469,214,122,63,984
Pennsylvania,Leechburg borough,2119,117,650,462,168,125,1522
Pennsylvania,Apollo borough,1409,163,448,223,84,30,948
Pennsylvania,Paxtang borough,1650,91,310,339,277,188,1205
Pennsylvania,Harrisburg,49230,6602,10112,7866,3955,2250,30785
Pennsylvania,Huntingdon borough,6987,364,1325,1024,940,456,4109
Pennsylvania,Pen Argyl borough,3562,154,1121,576,254,213,2318
Pennsylvania,Bethlehem,75296,6054,16934,12471,8223,5699,49381
Pennsylvania,Slatington borough,4277,287,1465,924,288,121,3085
Pennsylvania,Troxelville,293,25,66,58,39,0,188
Pennsylvania,Selinsgrove borough,5897,172,1373,681,545,268,3039
Pennsylvania,Beaver Springs,640,46,236,84,26,20,412
Pennsylvania,Clarks Green borough,1532,39,152,318,402,239,1150
Pennsylvania,Carmichaels borough,408,24,105,94,45,30,298
Pennsylvania,Landisburg borough,217,24,74,32,14,1,145
Pennsylvania,Oakwood,2250,214,741,493,222,37,1707
Pennsylvania,Jefferson borough (Greene County),265,8,78,44,25,12,167
Pennsylvania,Saegertown borough,956,66,283,152,108,43,652
Pennsylvania,Northampton borough,9873,813,2831,1980,1032,329,6985
Pennsylvania,Paxtonia,5670,228,1459,1017,781,490,3975
Pennsylvania,Rothsville,2531,315,555,377,347,177,1771
Pennsylvania,Braddock borough,1729,187,599,355,109,41,1291
Pennsylvania,Skyline View,4118,149,980,766,712,571,3178
Pennsylvania,Halifax borough,954,71,388,127,17,21,624
Pennsylvania,Rohrsburg,144,10,53,30,8,11,112
Pennsylvania,York Springs borough,876,177,189,111,32,20,529
Pennsylvania,Lake Meade,2653,47,572,494,581,310,2004
Pennsylvania,Gettysburg borough,7646,559,1010,813,621,656,3659
Pennsylvania,Bonneauville borough,1772,137,495,315,119,95,1161
Pennsylvania,Abbottstown borough,911,115,273,177,36,16,617
Pennsylvania,Glenolden borough,7147,396,2445,1341,750,247,5179
Pennsylvania,Boothwyn,5596,349,1600,968,855,175,3947
Pennsylvania,Claysburg,1369,103,536,183,88,32,942
Pennsylvania,Milford borough,1179,59,322,286,150,114,931
Pennsylvania,Lewisburg borough,5740,403,797,383,497,819,2899
Pennsylvania,Cassandra borough,206,5,59,43,11,1,119
Pennsylvania,Wind Gap borough,2706,185,900,642,215,90,2032
Pennsylvania,Walnutport borough,2093,242,755,347,141,44,1529
Pennsylvania,Portland borough,428,25,125,101,37,23,311
Pennsylvania,Palmer Heights,3700,192,998,815,578,244,2827
Pennsylvania,Easton,27100,3125,6071,4073,2163,1405,16837
Pennsylvania,Quarryville borough,2749,171,816,437,135,88,1647
Pennsylvania,Mount Joy borough,8106,426,2573,1514,760,548,5821
Pennsylvania,Lititz borough,9288,438,2416,1627,1566,851,6898
Pennsylvania,Gap,2146,157,477,369,263,104,1370
Pennsylvania,Applewold borough,310,22,94,56,27,28,227
Pennsylvania,Beavertown borough,1085,107,388,161,34,31,721
Pennsylvania,Alburtis borough,2528,89,565,453,448,156,1711
Pennsylvania,Chicora borough,1017,22,430,143,75,23,693
Pennsylvania,Ashland borough,2704,367,845,556,171,26,1965
Pennsylvania,Nesquehoning borough,3251,200,1362,499,222,124,2407
Pennsylvania,Littlestown borough,4468,276,1157,1015,319,171,2938
Pennsylvania,Bolivar borough,424,32,149,91,24,9,305
Pennsylvania,Rankin borough,2100,154,468,492,133,101,1348
Pennsylvania,Orrstown borough,277,28,109,34,7,12,190
Pennsylvania,Arlington Heights,5439,535,1169,886,838,355,3783
Pennsylvania,Chalfant borough,735,29,207,173,103,61,573
Pennsylvania,East Washington borough,2041,25,404,292,327,325,1373
Pennsylvania,Philipsburg borough,2731,189,1024,445,244,173,2075
Pennsylvania,New Salem borough,777,55,194,156,99,61,565
Pennsylvania,Petersburg borough,458,48,200,76,10,3,337
Pennsylvania,Trevorton,1658,128,770,188,84,32,1202
Pennsylvania,Point Marion borough,1280,162,419,195,138,49,963
Pennsylvania,Connellsville,7427,577,2184,1383,758,275,5177
Pennsylvania,North Belle Vernon borough,1754,76,525,391,186,113,1291
Pennsylvania,South New Castle borough,745,43,222,155,52,39,511
Pennsylvania,Wyncote,3014,97,470,494,597,558,2216
Pennsylvania,Wolfdale,2808,167,1177,563,246,101,2254
Pennsylvania,New Bethlehem borough,938,115,198,200,100,39,652
Pennsylvania,Bath borough,2670,225,738,513,241,85,1802
Pennsylvania,Beaver Falls,8547,752,2046,1507,543,296,5144
Pennsylvania,Edinboro borough,5964,180,510,690,833,500,2713
Pennsylvania,Karns City borough,190,20,86,30,4,1,141
Pennsylvania,Port Clinton borough,264,38,106,45,7,3,199
Pennsylvania,Ben Avon borough,1865,26,180,281,451,370,1308
Pennsylvania,Robesonia borough,2027,121,631,422,181,84,1439
Pennsylvania,Amity Gardens,3094,180,770,598,332,369,2249
Pennsylvania,Lower Burrell,11321,419,3488,2455,1375,789,8526
Pennsylvania,Delmont borough,2605,116,569,572,492,169,1918
Pennsylvania,Adamsburg borough,129,6,50,32,7,7,102
Pennsylvania,Centre Hall borough,1244,39,316,269,165,76,865
Pennsylvania,Jessup borough,4496,142,1009,974,790,299,3214
Pennsylvania,Morrisville,1082,38,371,190,122,99,820
Pennsylvania,Julian,154,12,52,35,6,7,112
Pennsylvania,Clarksville borough,163,20,82,24,17,0,143
Pennsylvania,Fayetteville,3122,343,875,747,376,66,2407
Pennsylvania,Timblin borough,226,18,78,17,18,0,131
Pennsylvania,Sykesville borough,1020,59,393,213,50,23,738
Pennsylvania,Summerville borough,477,30,183,62,30,15,320
Pennsylvania,Cassville borough,120,13,44,27,3,1,88
Pennsylvania,Broad Top City borough,482,39,201,84,6,17,347
Pennsylvania,Wyomissing borough,10452,348,1656,1844,2296,1638,7782
Pennsylvania,Sinking Spring borough,4092,229,797,718,639,212,2595
Pennsylvania,Shillington borough,5300,449,1287,1068,655,228,3687
Pennsylvania,Bechtelsville borough,999,43,319,191,60,56,669
Pennsylvania,Valley-Hi borough,3,0,0,3,0,0,3
Pennsylvania,McConnellsburg borough,1104,98,344,155,88,56,741
Pennsylvania,Orchard Hills,2468,264,819,406,107,43,1639
Pennsylvania,Rutherford,4838,390,946,920,748,276,3280
Pennsylvania,Braddock Hills borough,1710,101,464,439,178,139,1321
Pennsylvania,Oklahoma borough,787,37,349,169,52,35,642
Pennsylvania,Vandergrift borough,4987,272,1554,1157,241,190,3414
Pennsylvania,West Newton borough,2671,122,851,613,244,130,1960
Pennsylvania,Philadelphia,1575522,170894,351167,237716,177180,126796,1063753
Pennsylvania,Fernville,414,15,94,64,57,98,328
Pennsylvania,Briar Creek borough,767,131,243,166,48,17,605
Pennsylvania,New Albany borough,282,22,112,32,8,1,175
Pennsylvania,Fleetwood borough,4103,186,1147,901,306,223,2763
Pennsylvania,Carnot-Moon,11982,482,1594,1728,2542,1221,7567
Pennsylvania,Brentwood borough,9453,498,1975,2150,1446,447,6516
Pennsylvania,Cranesville borough,558,25,208,76,28,31,368
Pennsylvania,Hughesville borough,2071,77,583,430,220,95,1405
Pennsylvania,Yeagertown,892,145,337,138,66,15,701
Pennsylvania,Newton Hamilton borough,131,7,61,24,7,0,99
Pennsylvania,Sandy Ridge,263,30,175,16,0,0,221
Pennsylvania,Birdsboro borough,5139,313,1429,990,627,265,3624
Pennsylvania,Ligonier borough,1407,30,258,362,324,129,1103
Pennsylvania,Greensburg,14377,711,3177,2858,2044,1171,9961
Pennsylvania,Ramblewood,994,0,163,173,195,241,772
Pennsylvania,South Connellsville borough,1958,203,636,379,118,31,1367
Pennsylvania,Oliver,2857,181,920,597,172,83,1953
Pennsylvania,Hiller,1074,88,403,219,91,31,832
Pennsylvania,Everson borough,911,60,336,158,60,11,625
Pennsylvania,Dawson borough,506,26,182,95,12,20,335
Pennsylvania,New Galilee borough,365,28,132,57,19,18,254
Pennsylvania,New Brighton borough,5827,358,1799,1181,418,124,3880
Pennsylvania,Frankfort Springs borough,144,5,24,53,9,5,96
Pennsylvania,Bridgewater borough,845,34,216,195,108,53,606
Pennsylvania,Hunker borough,299,16,112,68,30,5,231
Pennsylvania,Arendtsville borough,906,94,205,140,66,46,551
Pennsylvania,Gratz borough,805,127,289,99,42,18,575
Pennsylvania,Elizabethville borough,1609,162,479,320,94,61,1116
Pennsylvania,Conashaugh Lakes,1518,0,555,194,127,164,1040
Pennsylvania,Columbus,788,57,278,125,71,54,585
Pennsylvania,Colony Park,1265,38,180,167,372,153,910
Pennsylvania,Hydetown borough,816,67,275,111,34,21,508
Pennsylvania,Saxonburg borough,1531,77,459,426,193,142,1297
Pennsylvania,Fairview borough,186,20,66,24,12,1,123
Pennsylvania,Connoquenessing borough,549,30,134,124,86,39,413
Pennsylvania,Geneva,138,9,55,18,0,6,88
Pennsylvania,New Cumberland borough,7298,310,1866,1651,1095,685,5607
Pennsylvania,Sharon,13378,1542,3694,2318,1243,387,9184
Pennsylvania,Fountain Hill borough,4675,642,1078,1008,481,289,3498
Pennsylvania,Coplay borough,3216,182,1013,773,226,141,2335
Pennsylvania,Middleburg borough,1444,100,459,223,109,42,933
Pennsylvania,Dover borough,2084,142,595,342,174,84,1337
Pennsylvania,Vandling borough,670,52,221,117,74,27,491
Pennsylvania,Taylor borough,6007,421,2218,701,638,289,4267
Pennsylvania,Olyphant borough,5090,339,1364,1331,585,210,3829
Pennsylvania,Landingville borough,139,4,54,20,16,6,100
Pennsylvania,Klingerstown,98,2,42,12,2,4,62
Pennsylvania,Fountain Springs,419,24,76,140,38,0,278
Pennsylvania,Brandonville,267,23,133,34,0,0,190
Pennsylvania,Branchdale,418,28,165,64,12,0,269
Pennsylvania,Auburn borough,682,79,302,56,27,18,482
Pennsylvania,Conestoga,1129,57,358,185,128,86,814
Pennsylvania,Coral,423,98,177,100,48,0,423
Pennsylvania,Cornwells Heights,1148,47,339,202,215,103,906
Pennsylvania,Crenshaw,388,51,169,49,38,30,337
Pennsylvania,Newell borough,524,24,221,64,19,12,340
Pennsylvania,Ringtown borough,766,52,273,149,59,42,575
Pennsylvania,West Wyomissing,3578,183,906,862,321,168,2440
Pennsylvania,Ben Avon Heights borough,343,0,12,31,88,118,249
Pennsylvania,Park Forest Village,10610,67,1365,943,2133,2337,6845
Pennsylvania,McKeansburg,176,11,40,37,19,13,120
Pennsylvania,Eagleview,1715,53,192,278,557,301,1381
Pennsylvania,Eagle Lake,0,0,0,0,0,0,0
Pennsylvania,Dunlo,151,13,96,0,0,0,109
Pennsylvania,Dryville,287,0,29,97,23,45,194
Pennsylvania,Dry Tavern,598,26,199,136,68,46,475
Pennsylvania,Altamont,726,27,217,192,103,42,581
Pennsylvania,Douglassville,668,14,259,147,80,15,515
Pennsylvania,Dewart,1289,26,362,345,138,66,937
Pennsylvania,Devon,2008,15,73,118,395,566,1167
Pennsylvania,DeSales University,932,0,0,3,5,11,19
Pennsylvania,Defiance,389,39,143,27,3,20,232
Pennsylvania,Deer Lake,521,0,169,54,99,20,342
Pennsylvania,Dauberville,791,47,249,139,79,52,566
Pennsylvania,Dalmatia,404,23,181,67,33,9,313
Pennsylvania,Cumbola,396,31,145,85,23,4,288
Pennsylvania,Crucible,603,100,160,91,72,11,434
Pennsylvania,Crown,195,0,75,25,7,13,120
Pennsylvania,Cross Creek,161,6,61,37,10,0,114
Pennsylvania,Dorneyville,4226,133,585,745,1079,617,3159
Pennsylvania,Penn borough,419,12,117,77,26,9,241
Pennsylvania,Lake City borough,2944,110,1021,513,201,121,1966
Pennsylvania,Mount Pocono borough,3079,332,866,483,297,196,2174
Pennsylvania,Gold Key Lake,1622,14,508,378,130,57,1087
Pennsylvania,Glenshaw,8714,235,1866,1749,1656,1292,6798
Pennsylvania,Gibsonia,2050,51,449,302,530,172,1504
Pennsylvania,Georgetown CDP (Luzerne County),1957,131,711,309,105,53,1309
Pennsylvania,Georgetown CDP (Lancaster County),1193,294,243,57,55,14,663
Pennsylvania,Canton borough,1747,110,629,228,136,84,1187
Pennsylvania,Gibraltar,518,0,138,84,83,35,340
Pennsylvania,Buckhorn,394,16,61,71,47,40,235
Pennsylvania,Newry borough,216,16,74,22,19,14,145
Pennsylvania,Warren,9250,428,2965,1793,1173,512,6871
Pennsylvania,Rural Valley borough,892,64,279,217,95,23,678
Pennsylvania,Lenape Heights,1216,72,414,210,62,71,829
Pennsylvania,Ford Cliff borough,474,29,189,115,29,6,368
Pennsylvania,Elderton borough,362,26,142,56,33,19,276
Pennsylvania,Atwood borough,110,10,52,3,3,0,68
Pennsylvania,Penbrook borough,2981,122,822,490,381,149,1964
Pennsylvania,Hershey,14542,336,1677,2084,3300,2459,9856
Pennsylvania,Waller,67,8,31,11,6,2,58
Pennsylvania,Mainville,84,18,45,13,6,2,84
Pennsylvania,Catawissa borough,1552,106,582,226,141,51,1106
Pennsylvania,Windsor borough,1245,162,390,200,73,14,839
Pennsylvania,Wellsville borough,209,5,96,34,20,10,165
Pennsylvania,Weigelstown,12879,1060,3868,2662,927,723,9240
Pennsylvania,Goodville,847,92,190,93,0,38,413
Pennsylvania,Gordonville,499,103,197,23,37,0,360
Pennsylvania,Gouglersville,420,42,183,55,55,8,343
Pennsylvania,Gouldsboro,719,36,231,144,90,44,545
Pennsylvania,McKean borough,457,23,164,60,68,35,350
Pennsylvania,Jennerstown borough,665,40,204,145,50,31,470
Pennsylvania,Catasauqua borough,6550,318,1607,1597,518,417,4457
Pennsylvania,Ancient Oaks,7554,279,997,1012,1613,1266,5167
Pennsylvania,Port Trevorton,896,154,226,96,47,10,533
Pennsylvania,Penns Creek,583,57,182,80,51,10,380
Pennsylvania,Hummels Wharf,1512,142,611,294,65,100,1212
Pennsylvania,Hebron,1023,267,419,100,39,5,830
Pennsylvania,Hawk Run,591,29,170,80,69,52,400
Pennsylvania,Haverford College,1309,0,0,7,20,134,161
Pennsylvania,Harwick,905,40,272,332,107,23,774
Pennsylvania,Elgin borough,192,8,96,26,6,6,142
Pennsylvania,Harleigh,1501,73,627,307,89,68,1164
Pennsylvania,Grindstone,464,45,157,78,7,0,287
Pennsylvania,Grill,1650,149,322,312,152,230,1165
Pennsylvania,Grier City,326,0,85,142,47,11,285
Pennsylvania,Greenwood,2537,277,755,350,217,68,1667
Pennsylvania,Greens Landing,680,69,223,77,75,61,505
Pennsylvania,Greenock,1916,56,555,506,210,115,1442
Pennsylvania,Greenfields,980,123,317,74,141,63,718
Pennsylvania,Grazierville,711,27,336,57,0,18,438
Pennsylvania,Grassflat,762,83,229,90,23,0,425
Pennsylvania,Granville,295,57,169,11,0,0,237
Pennsylvania,Graceton,83,0,61,7,15,0,83
Pennsylvania,Hannasville,183,22,46,3,19,9,99
Pennsylvania,Hookstown borough,146,16,34,36,15,0,101
Pennsylvania,Picture Rocks borough,748,37,176,177,83,48,521
Pennsylvania,Conshohocken borough,8010,228,1284,1026,2467,1294,6299
Pennsylvania,Highspire borough,2667,182,813,610,186,44,1835
Pennsylvania,Mifflinville,1218,100,440,202,133,65,940
Pennsylvania,Eyers Grove,73,3,37,12,11,0,63
Pennsylvania,Wyalusing borough,639,42,192,151,29,26,440
Pennsylvania,Alba borough,115,8,47,19,11,4,89
Pennsylvania,Locustdale,166,14,27,100,0,0,141
Pennsylvania,Roseto borough,1882,114,466,427,177,58,1242
Pennsylvania,Nazareth borough,5698,378,1255,1073,778,422,3906
Pennsylvania,Hellertown borough,5848,341,1590,1188,712,406,4237
Pennsylvania,Wickerham Manor-Fisher,2142,52,553,420,301,337,1663
Pennsylvania,Stockdale borough,430,22,177,69,61,27,356
Pennsylvania,Speers borough,1198,43,361,243,201,84,932
Pennsylvania,Monongahela,4173,316,1193,916,366,164,2955
Pennsylvania,Long Branch borough,432,23,172,63,32,25,315
Pennsylvania,Cecil-Bishop,2184,102,408,400,335,276,1521
Pennsylvania,Trooper,5936,259,1347,964,1050,582,4202
Pennsylvania,Dunmore borough,13282,559,2877,2611,1883,1715,9645
Pennsylvania,Carbondale,8565,738,2663,1657,766,359,6183
Pennsylvania,Bentleyville borough,2515,215,791,494,186,84,1770
Pennsylvania,Milroy,1504,114,564,301,113,28,1120
Pennsylvania,Paoli,5864,209,843,833,1466,1027,4378
Pennsylvania,Elverson borough,1405,117,366,359,247,117,1206
Pennsylvania,Avondale borough,1295,292,168,137,83,80,760
Pennsylvania,Middletown borough,9176,880,2521,1522,713,348,5984
Pennsylvania,Birmingham borough,139,1,19,13,11,67,111
Pennsylvania,Pitcairn borough,3230,238,884,724,308,93,2247
Pennsylvania,Haysville borough,83,9,18,25,11,3,66
Pennsylvania,Dauphin borough,855,9,178,183,149,61,580
Pennsylvania,Stillwater borough,232,12,79,34,9,15,149
Pennsylvania,Kingston borough,12935,646,3067,2398,2039,1281,9431
Pennsylvania,Hughestown borough,1480,81,457,286,187,128,1139
Pennsylvania,Harveys Lake borough,2764,176,698,643,387,329,2233
Pennsylvania,Edwardsville borough,4726,219,1361,806,619,217,3222
Pennsylvania,Marietta borough,2611,138,920,459,281,87,1885
Pennsylvania,Adamstown borough,2228,167,513,352,330,123,1485
Pennsylvania,Maytown,3815,39,915,656,458,217,2285
Pennsylvania,Nuremberg,425,33,169,67,41,3,313
Pennsylvania,New Ringgold borough,275,20,76,64,7,8,175
Pennsylvania,Atglen borough,1459,128,346,173,113,86,846
Pennsylvania,Hometown,1268,107,427,308,120,57,1019
Pennsylvania,Gilberton borough,772,66,287,139,50,8,550
Pennsylvania,Patton borough,1714,123,633,385,93,60,1294
Pennsylvania,Windber borough,3932,280,1373,736,387,116,2892
Pennsylvania,Girardville borough,1411,175,499,209,90,24,997
Pennsylvania,Ursina borough,293,37,85,44,28,1,195
Pennsylvania,Stoystown borough,358,19,116,87,46,21,289
Pennsylvania,Somerset borough,5977,495,1888,1013,604,361,4361
Pennsylvania,Rockwood borough,745,61,248,114,61,19,503
Pennsylvania,Friedens,1774,103,606,291,126,49,1175
Pennsylvania,Davidsville,750,33,285,137,108,75,638
Pennsylvania,West View borough,6640,299,1682,1363,984,411,4739
Pennsylvania,Heckscherville,121,4,73,26,0,0,103
Pennsylvania,St. Clair borough,2891,238,1128,555,144,70,2135
Pennsylvania,Pottsville,13728,1021,4354,2590,1094,711,9770
Pennsylvania,Port Carbon borough,1855,170,643,318,130,73,1334
Pennsylvania,Hallstead borough,1299,157,454,191,80,54,936
Pennsylvania,West Pittston borough,4772,220,1056,1018,740,322,3356
Pennsylvania,Sugar Notch borough,941,78,335,182,57,41,693
Pennsylvania,Shickshinny borough,664,123,201,133,28,15,500
Pennsylvania,Mountain Top,11319,395,2323,2340,1632,1241,7931
Pennsylvania,Larksville borough,4417,204,1337,964,604,266,3375
Pennsylvania,Dallas borough,2779,36,385,572,465,420,1878
Pennsylvania,Plymouth borough,5832,445,1842,1110,313,186,3896
Pennsylvania,Marshallton,1312,128,522,164,87,0,901
Pennsylvania,Fairview-Ferndale,2009,282,769,288,116,64,1519
Pennsylvania,Latrobe borough,8014,330,2260,1594,795,527,5506
Pennsylvania,Union Dale borough,238,4,104,53,26,19,206
Pennsylvania,East Waterford,254,38,103,29,7,4,181
Pennsylvania,Strasburg borough,2917,140,647,500,414,269,1970
Pennsylvania,Pomeroy,436,42,101,56,74,35,308
Pennsylvania,Pocono Woodland Lakes,3314,109,731,726,563,280,2409
Pennsylvania,Pocono Springs,1285,57,341,384,115,130,1027
Pennsylvania,Pocono Ranch Lands,1297,115,345,374,45,47,926
Pennsylvania,Pocono Mountain Lake Estates,375,66,89,125,43,20,343
Pennsylvania,Plumsteadville,2522,37,259,418,599,274,1587
Pennsylvania,Pleasant View,696,44,297,142,46,12,541
Pennsylvania,Newtown,251,34,128,40,16,4,222
Pennsylvania,Deer Lake borough,759,35,200,166,90,64,555
Pennsylvania,Spring House,3865,96,477,372,909,985,2839
Pennsylvania,Potlicker Flats,252,22,180,9,13,0,224
Pennsylvania,Spring Grove borough,2094,116,726,318,210,98,1468
Pennsylvania,Willow Grove,14800,527,2730,2710,2703,1658,10328
Pennsylvania,Shanksville borough,229,17,69,52,18,6,162
Pennsylvania,Seltzer,244,33,148,15,0,0,196
Pennsylvania,West Hazleton borough,4496,977,993,663,322,70,3025
Pennsylvania,Englewood,449,56,107,99,62,10,334
Pennsylvania,Mount Pleasant Mills,461,66,178,42,20,7,313
Pennsylvania,Kreamer,681,57,188,154,105,20,524
Pennsylvania,Freeburg borough,562,17,175,116,53,26,387
Pennsylvania,Scranton,76869,7345,19780,12509,7405,3456,50495
Pennsylvania,East Vandergrift borough,798,24,307,155,29,27,542
Pennsylvania,Avonmore borough,1099,56,374,253,67,29,779
Pennsylvania,Turtle Creek borough,5244,234,1321,1302,310,332,3499
Pennsylvania,Thornburg borough,454,3,36,62,126,127,354
Pennsylvania,Wyndmoor,5795,288,639,587,1490,1375,4379
Pennsylvania,Pennsbury Village borough,747,15,148,135,242,103,643
Pennsylvania,Ingram borough,3271,179,885,802,454,156,2476
Pennsylvania,Numidia,251,7,91,21,42,10,171
Pennsylvania,McKeesport,19365,1748,6304,4163,1226,535,13976
Pennsylvania,Nixon,1206,10,244,171,444,163,1032
Pennsylvania,Lewisberry borough,484,31,131,112,39,9,322
Pennsylvania,Glen Rock borough,2105,89,536,406,257,72,1360
Pennsylvania,East Prospect borough,1012,86,349,163,66,20,684
Pennsylvania,Wellsboro borough,3267,157,955,599,469,270,2450
Pennsylvania,Tioga borough,777,94,208,108,51,23,484
Pennsylvania,Starrucca borough,213,30,65,28,14,7,144
Pennsylvania,Hawley borough,1331,152,302,279,141,68,942
Pennsylvania,Lincoln borough,1057,43,353,275,109,40,820
Pennsylvania,Lawrenceville borough,543,52,133,107,69,17,378
Pennsylvania,Athens borough,3237,248,942,452,303,202,2147
Pennsylvania,Valley View CDP (York County),2455,166,549,430,398,296,1839
Pennsylvania,Village Green-Green Ridge,8187,444,2424,1455,1049,443,5815
Pennsylvania,Bridgeville borough,5066,282,1233,1217,747,384,3863
Pennsylvania,Dravosburg borough,1779,44,578,477,243,62,1404
Pennsylvania,Edgeworth borough,1596,25,74,126,392,482,1099
Pennsylvania,Glassport borough,4391,383,1543,1005,322,102,3355
Pennsylvania,Heidelberg borough,1285,59,403,312,168,39,981
Pennsylvania,Liberty borough (Allegheny County),2488,72,831,665,233,100,1901
Pennsylvania,Verona borough,2736,145,677,694,274,133,1923
Pennsylvania,West Elizabeth borough,501,32,120,124,13,2,291
Pennsylvania,Benson borough,208,29,67,36,6,1,139
Pennsylvania,Blain borough,255,22,73,51,5,11,162
Pennsylvania,Bloomfield borough,1487,154,478,211,146,80,1069
Pennsylvania,New Buffalo borough,128,15,40,26,5,0,86
Pennsylvania,Westover borough,353,33,153,55,6,9,256
Pennsylvania,West Hamburg,1983,263,692,365,84,127,1531
Pennsylvania,Westland,142,10,25,47,0,0,82
Pennsylvania,West Milton,1458,53,355,69,63,76,616
Pennsylvania,West Nanticoke,531,61,183,131,53,48,476
Pennsylvania,Weston,336,12,118,110,33,5,278
Pennsylvania,West Pittsburg,728,57,287,172,83,12,611
Pennsylvania,West Waynesburg,356,127,144,9,0,10,290
Pennsylvania,Westwood,1011,163,328,159,25,26,701
Pennsylvania,White Mills,911,64,194,196,87,0,541
Pennsylvania,Rose Valley borough,932,9,55,72,255,303,694
Pennsylvania,Prospect Park borough,6475,335,1870,1158,813,288,4464
Pennsylvania,Shinglehouse borough,1029,134,276,184,44,52,690
Pennsylvania,Eddystone borough,2552,214,689,432,83,55,1473
Pennsylvania,Sandy,1650,114,515,379,85,38,1131
Pennsylvania,Chalfont borough,4125,120,653,692,1089,421,2975
Pennsylvania,Hulmeville borough,965,32,274,198,122,61,687
Pennsylvania,Ivyland borough,1179,63,192,216,178,136,785
Pennsylvania,Richboro,6364,135,1018,1021,1279,1051,4504
Pennsylvania,Thompsontown borough,786,71,291,115,38,31,546
Pennsylvania,Indiana borough,13512,188,1037,1111,1024,846,4206
Pennsylvania,Duryea borough,4875,310,1188,1113,639,381,3631
Pennsylvania,East Berwick,2217,140,862,369,294,140,1805
Pennsylvania,Exeter borough,5603,420,1850,974,552,329,4125
Pennsylvania,Glen Lyon,1860,93,651,453,57,39,1293
Pennsylvania,Wiconsico,842,110,271,123,42,15,561
Pennsylvania,Pittston,7697,773,2100,1590,564,221,5248
Pennsylvania,White Haven borough,1203,80,453,252,78,36,899
Pennsylvania,Little Meadows borough,175,9,86,44,4,9,152
Pennsylvania,Thompson borough,342,44,94,61,21,16,236
Pennsylvania,Oil City,9982,538,2932,1895,1084,334,6783
Pennsylvania,Sugarcreek borough,5065,421,2246,1022,235,112,4036
Pennsylvania,Utica borough,177,25,70,30,11,7,143
Pennsylvania,Schlusser,4857,268,1306,1013,651,438,3676
Pennsylvania,Butler,13182,902,3575,2898,1336,563,9274
Pennsylvania,Callery borough,437,30,120,87,63,23,323
Pennsylvania,East Butler borough,801,29,320,159,42,14,564
Pennsylvania,Mars borough,1450,85,412,323,158,82,1060
Pennsylvania,Swoyersville borough,4972,251,1543,1414,624,267,4099
Pennsylvania,Dicksonville,645,17,169,117,35,10,348
Pennsylvania,Wilcox,318,6,145,64,25,12,252
Pennsylvania,Winfield,808,52,198,182,78,85,595
Pennsylvania,Folcroft borough,6630,509,2089,1036,601,280,4515
Pennsylvania,Media borough,5423,184,580,1092,1352,1075,4283
Pennsylvania,Forest Hills borough,6401,72,948,1010,1695,1280,5005
Pennsylvania,Fox Chapel borough,5331,49,143,426,983,1922,3523
Pennsylvania,Green Tree borough,4913,140,805,981,1208,670,3804
Pennsylvania,Munhall borough,11229,394,2894,2612,1635,693,8228
Pennsylvania,Oakdale borough,1548,42,455,358,220,73,1148
Pennsylvania,Pleasant Hills borough,8184,242,1273,2014,1793,946,6268
Pennsylvania,Port Vue borough,3724,186,1262,947,317,114,2826
Pennsylvania,Sewickley borough,3838,45,338,540,816,916,2655
Pennsylvania,Delano,309,34,153,67,12,8,274
Pennsylvania,Upper St. Clair,19592,340,1540,2228,4894,4283,13285
Pennsylvania,New Philadelphia borough,1021,61,411,175,70,28,745
Pennsylvania,Shenandoah Heights,1287,70,377,300,130,58,935
Pennsylvania,Elysburg,1908,141,639,344,219,203,1546
Pennsylvania,Milton borough,6838,709,2428,946,555,199,4837
Pennsylvania,Turbotville borough,657,47,246,109,38,49,489
Pennsylvania,Boyertown borough,4058,311,1459,630,371,139,2910
Pennsylvania,Hamburg borough,4353,351,1388,773,390,181,3083
Pennsylvania,Leesport borough,1967,132,515,362,239,60,1308
Pennsylvania,Mount Penn borough,3134,167,920,568,232,115,2002
Pennsylvania,Reiffton,4576,244,966,791,807,604,3412
Pennsylvania,West Reading borough,4215,357,1305,809,611,166,3248
Pennsylvania,Yoe borough,1052,65,261,213,88,24,651
Pennsylvania,Greenville borough,5572,289,1276,1037,316,204,3122
Pennsylvania,Thompsonville,3412,97,437,611,873,581,2599
Pennsylvania,Roaring Spring borough,2623,88,819,533,213,55,1708
Pennsylvania,Witmer,407,20,95,135,27,0,277
Pennsylvania,Wyano,622,24,281,95,0,43,443
Pennsylvania,Wylandville,253,9,94,62,50,0,215
Pennsylvania,Yorklyn,1888,89,561,331,200,56,1237
Pennsylvania,Yukon,463,37,264,79,56,0,436
Pennsylvania,Blue Ball,745,146,216,97,65,19,543
Pennsylvania,Blue Ridge Summit,818,26,217,259,46,42,590
Pennsylvania,Bobtown,573,45,183,99,63,9,399
Pennsylvania,Boston,336,60,197,13,0,49,319
Pennsylvania,Bowers,173,16,63,0,27,20,126
Pennsylvania,Bowmansville,2123,308,486,251,311,125,1481
Pennsylvania,Wind Ridge,199,18,107,21,2,2,150
Pennsylvania,Bradenville,396,48,205,64,17,0,334
Pennsylvania,Breinigsville,5975,228,775,1130,1108,684,3925
Pennsylvania,Bressler,1547,74,368,456,80,74,1052
Pennsylvania,Brittany Farms-The Highlands,3656,142,648,673,728,435,2626
Pennsylvania,Brownstown,2290,268,505,435,275,177,1660
Pennsylvania,Browntown,1342,39,465,383,112,114,1113
Pennsylvania,Ardmore,13083,481,1013,1483,2941,3347,9265
Pennsylvania,Harleysville,9553,306,1792,1718,1796,1265,6877
Pennsylvania,Drexel Hill,28188,692,5504,5302,5073,2932,19503
Pennsylvania,Jefferson borough (York County),594,74,214,108,36,29,461
Pennsylvania,Parkville,7162,667,2207,1314,507,280,4975
Pennsylvania,Seven Valleys borough,475,54,130,81,35,34,334
Pennsylvania,Brave,196,19,73,43,5,0,140
Pennsylvania,Womelsdorf borough,2887,225,877,452,252,70,1876
Pennsylvania,Blairsville borough,3281,145,1002,662,279,216,2304
Pennsylvania,Stormstown,2422,45,347,289,466,461,1608
Pennsylvania,Beech Mountain Lakes,1913,46,419,468,423,218,1574
Pennsylvania,Bethel,583,15,248,60,32,0,355
Pennsylvania,Big Bass Lake,1236,72,282,251,168,73,846
Pennsylvania,Bigler,320,50,119,0,28,33,230
Pennsylvania,Birchwood Lakes,1178,51,382,220,91,26,770
Pennsylvania,Bird-in-Hand,508,137,95,43,12,0,287
Pennsylvania,Blandburg,348,17,130,51,16,3,217
Pennsylvania,Blandon,7837,327,1631,1807,1329,497,5591
Pennsylvania,Wagner,162,11,42,41,0,17,111
Pennsylvania,Wakefield,522,74,131,63,39,19,326
Pennsylvania,Wallenpaupack Lake Estates,1154,25,473,236,100,82,916
Pennsylvania,Walnuttown,710,67,264,60,85,26,502
Pennsylvania,Wanamie,512,57,150,111,19,57,394
Pennsylvania,Washington Boro,881,33,366,70,79,70,618
Pennsylvania,Waverly,639,0,51,55,169,168,443
Pennsylvania,Webster,152,7,35,39,32,0,113
Pennsylvania,Weedville,472,50,206,79,24,38,397
Pennsylvania,Wescosville,6213,58,888,1038,1384,962,4330
Pennsylvania,West Alexander,398,24,92,95,29,17,257
Pennsylvania,West Decatur,452,37,199,74,13,24,347
Pennsylvania,West Falls,359,9,137,64,54,11,275
Pennsylvania,Great Bend borough,923,96,303,164,49,34,646
Pennsylvania,Stockertown borough,1212,48,301,249,101,82,781
Pennsylvania,Beaverdale,830,55,264,194,53,21,587
Pennsylvania,Bear Rocks,961,43,291,289,89,89,801
Pennsylvania,Berwyn,3268,142,214,385,725,781,2247
Pennsylvania,Baumstown,646,73,127,176,0,6,382
Pennsylvania,Aaronsburg CDP (Washington County),123,31,46,46,0,0,123
Pennsylvania,Ackermanville,724,25,232,102,115,0,474
Pennsylvania,Albrightsville,173,0,62,53,0,0,115
Pennsylvania,Alfarata,209,0,123,46,5,0,174
Pennsylvania,Alleghenyville,1090,26,240,152,218,154,790
Pennsylvania,Allenport,687,50,285,88,37,24,484
Pennsylvania,Allensville,460,124,89,27,6,15,261
Pennsylvania,Allenwood,306,16,110,91,21,15,253
Pennsylvania,Allison,563,76,238,83,49,0,446
Pennsylvania,Allison Park,22855,406,3798,3433,4687,3830,16154
Pennsylvania,Allport,478,105,143,61,17,19,345
Pennsylvania,East Brady borough,948,111,336,161,63,30,701
Pennsylvania,Alsace Manor,488,69,219,62,35,0,385
Pennsylvania,Arnold City,391,14,188,79,43,0,324
Pennsylvania,Arnot,407,84,119,62,19,2,286
Pennsylvania,Atkinson Mills,113,5,59,21,4,0,89
Pennsylvania,Atlas,900,158,547,108,0,10,823
Pennsylvania,Atlasburg,497,30,155,37,35,8,265
Pennsylvania,Avella,922,92,249,154,81,20,596
Pennsylvania,Baileyville,112,19,72,21,0,0,112
Pennsylvania,Bainbridge,1639,49,635,208,107,43,1042
Pennsylvania,Bairdford,1054,45,409,109,215,63,841
Pennsylvania,Bakerstown,2558,47,318,384,520,512,1781
Pennsylvania,Barrville,324,155,18,0,0,0,173
Pennsylvania,Arcadia University,614,0,0,0,7,0,7
Pennsylvania,Mexico,366,44,120,56,11,15,246
Pennsylvania,Flemington borough,1442,57,459,249,132,102,999
Pennsylvania,Ferndale borough,1576,62,412,319,178,67,1038
Pennsylvania,Cherryville,1767,148,368,420,302,120,1358
Pennsylvania,Cheyney University,438,0,0,22,1,0,23
Pennsylvania,Chinchilla,2192,79,572,330,339,196,1516
Pennsylvania,Church Hill,1597,37,501,314,234,112,1198
Pennsylvania,Churchtown,489,153,73,42,30,18,316
Pennsylvania,Clay,2235,292,514,240,234,129,1409
Pennsylvania,Clinton,595,37,210,98,65,26,436
Pennsylvania,Cochranville,740,95,227,102,77,42,543
Pennsylvania,Collinsburg,1006,87,357,145,92,30,711
Pennsylvania,Riceville,35,3,14,9,0,3,29
Pennsylvania,Susquehanna Depot borough,1692,175,496,308,90,78,1147
Pennsylvania,Clarendon borough,393,18,158,70,18,13,277
Pennsylvania,Canadohta Lake,461,42,188,82,46,13,371
Pennsylvania,Meadowood,2846,55,841,711,429,156,2192
Pennsylvania,Greensboro borough,326,32,120,38,35,14,239
Pennsylvania,Kratzerville,369,30,111,70,43,20,274
Pennsylvania,Sandy Lake borough,627,28,249,68,79,20,444
Pennsylvania,New Castle,22188,1839,7133,4341,1841,657,15811
Pennsylvania,Chest Springs borough,156,10,37,32,5,2,86
Pennsylvania,St. Marys,12535,619,4562,2194,1481,523,9379
Pennsylvania,South Park Township,13363,369,3023,2930,2314,1347,9983
Pennsylvania,Tipton,1464,34,346,254,283,101,1018
Pennsylvania,Norristown borough,34490,4637,7547,5185,3069,1906,22344
Pennsylvania,Chase,855,24,179,199,178,102,682
Pennsylvania,Chalkhill,127,0,57,32,9,17,115
Pennsylvania,Chewton,389,33,169,74,29,12,317
Pennsylvania,Cementon,1703,127,394,401,184,82,1188
Pennsylvania,Scalp Level borough,722,93,284,99,51,19,546
Pennsylvania,Burnside borough,215,12,113,32,0,2,159
Pennsylvania,Curwensville borough,2467,137,874,525,179,72,1787
Pennsylvania,Newburg borough (Clearfield County),56,11,28,7,4,0,50
Pennsylvania,Ramey borough,418,41,132,78,27,11,289
Pennsylvania,Royersford borough,4773,259,1063,958,731,263,3274
Pennsylvania,Sanatoga,8564,491,2214,1624,952,536,5817
Pennsylvania,Malvern borough,3440,101,405,366,744,740,2356
Pennsylvania,Modena borough,873,90,222,103,51,12,478
Pennsylvania,Patterson Heights borough,547,7,65,97,147,73,389
Pennsylvania,Shippingport borough,158,10,78,28,4,1,121
Pennsylvania,Brownstown borough,863,41,281,179,82,21,604
Pennsylvania,Dunbar borough,1162,129,388,223,85,26,851
Pennsylvania,Waterford borough,1330,97,463,209,128,77,974
Pennsylvania,Exton,5332,160,592,782,1382,978,3894
Pennsylvania,Schaefferstown,1105,92,382,78,104,63,719
Pennsylvania,Buffington,71,9,19,41,1,0,70
Pennsylvania,Bulger,387,0,117,77,34,24,252
Pennsylvania,Byrnedale,599,20,204,100,28,13,365
Pennsylvania,Cairnbrook,593,46,215,74,57,7,399
Pennsylvania,Caln,1231,39,311,253,120,137,860
Pennsylvania,Calumet,1698,63,523,366,147,73,1172
Pennsylvania,Cashtown,199,17,106,52,0,0,175
Pennsylvania,Cedar Crest,284,10,156,17,5,0,188
Pennsylvania,Corry,6396,526,2146,1085,551,169,4477
Pennsylvania,Tower City borough,1299,105,428,224,65,28,850
Pennsylvania,Coalport borough,417,13,186,83,10,2,294
Pennsylvania,DuBois,7530,431,2214,1605,774,379,5403
Pennsylvania,Hyde Park,2945,338,576,558,167,94,1733
Pennsylvania,Hunterstown,569,102,238,94,42,0,476
Pennsylvania,Hudson,1362,92,359,391,143,56,1041
Pennsylvania,Hublersburg,71,0,16,16,15,0,47
Pennsylvania,Hostetter,513,3,189,122,69,9,392
Pennsylvania,Hopeland,459,108,181,69,10,12,380
Pennsylvania,Holiday Pocono,461,44,225,75,17,0,361
Pennsylvania,Hilldale,1495,72,401,168,269,192,1102
Pennsylvania,Hickory Hills,538,19,212,92,52,8,383
Pennsylvania,Hickory,752,8,167,160,95,29,459
Pennsylvania,Hereford,731,99,318,112,33,11,573
Pennsylvania,Hendersonville,205,16,81,39,23,15,174
Pennsylvania,Hemlock Farms,3387,87,739,693,515,320,2354
Pennsylvania,Heidlersburg,760,106,228,155,30,24,543
Pennsylvania,Hegins,954,84,351,161,50,14,660
Pennsylvania,Frystown,385,131,95,33,0,0,259
Pennsylvania,Frizzleburg,420,44,195,100,13,7,359
Pennsylvania,Fredericktown,475,19,164,58,0,46,287
Pennsylvania,Gardners,147,8,116,0,4,10,138
Pennsylvania,Fox Chase,1694,111,423,425,300,25,1284
Pennsylvania,Foster Brook,1058,60,370,231,58,61,780
Pennsylvania,Woxall,1499,27,311,177,198,144,857
Pennsylvania,Snydertown,367,2,101,47,46,31,227
Pennsylvania,Idaville,191,20,45,31,5,39,140
Pennsylvania,Imperial,2620,191,528,374,359,363,1815
Pennsylvania,Indian Mountain Lake,4158,270,999,778,390,237,2674
Pennsylvania,Inkerman,1950,136,608,470,153,202,1569
Pennsylvania,Langeloth,714,89,208,82,25,72,476
Pennsylvania,Landisville,1954,23,416,335,412,293,1479
Pennsylvania,Lampeter,1276,66,294,175,246,63,844
Pennsylvania,Lamar,567,38,281,74,25,3,421
Pennsylvania,Lake Winola,626,36,184,131,84,67,502
Pennsylvania,Lakemont,2091,127,569,454,374,85,1609
Pennsylvania,Lake Latonka,816,0,175,183,225,61,644
Pennsylvania,Lake Arthur Estates,606,41,229,121,34,0,425
Pennsylvania,Kylertown,272,49,152,45,11,0,257
Pennsylvania,Kutztown University,3686,7,3,40,5,6,61
Pennsylvania,Kiskimere,130,0,69,16,15,3,103
Pennsylvania,Lionville,6323,97,780,1164,1553,991,4585
Pennsylvania,Kirkwood,355,63,58,27,46,8,202
Pennsylvania,Kerrtown,239,0,18,29,13,0,60
Pennsylvania,Kennerdell,169,9,64,60,6,0,139
Pennsylvania,Kenmar,4203,287,1068,819,430,386,2990
Pennsylvania,Kempton,83,7,16,14,16,17,70
Pennsylvania,Kelayres,439,38,166,89,11,10,314
Pennsylvania,Kapp Heights,877,148,291,100,60,19,618
Pennsylvania,Joffre,603,25,223,115,31,8,402
Pennsylvania,James City,270,9,139,28,9,16,201
Pennsylvania,Jacksonwald,2961,123,719,573,416,327,2158
Pennsylvania,Jacksonville CDP (Indiana County),653,28,224,117,44,14,427
Pennsylvania,Intercourse,1815,371,310,242,126,89,1138
Pennsylvania,Kersey,1229,74,425,289,68,16,872
Pennsylvania,Lattimer,391,0,123,144,0,18,285
Pennsylvania,Leola,7352,766,1641,1196,870,565,5038
Pennsylvania,Cetronia,2558,75,496,433,515,133,1652
Pennsylvania,Eagleville CDP (Montgomery County),4934,321,1822,615,421,460,3639
Pennsylvania,Eagleville CDP (Centre County),487,35,169,89,20,4,317
Pennsylvania,Salladasburg borough,234,18,75,41,17,11,162
Pennsylvania,Jersey Shore borough,4237,296,1184,928,280,83,2771
Pennsylvania,Duboistown borough,1146,77,355,230,153,57,872
Pennsylvania,Lewistown borough,8228,624,3070,1396,338,90,5518
Pennsylvania,Lemont,2439,110,139,341,523,531,1644
Pennsylvania,Clarence,620,24,285,101,37,3,450
Pennsylvania,Reedsville,640,75,173,89,24,28,389
Pennsylvania,Shiremanstown borough,1576,59,354,398,230,99,1140
Pennsylvania,Newburg borough (Cumberland County),318,20,133,55,22,7,237
Pennsylvania,Mount Holly Springs borough,1932,146,628,342,150,53,1319
Pennsylvania,Clark borough,602,10,174,145,58,30,417
Pennsylvania,West Brownsville borough,935,33,376,157,110,55,731
Pennsylvania,Bellwood borough,1699,67,620,297,166,43,1193
Pennsylvania,York Haven borough,766,110,230,124,34,4,502
Pennsylvania,Chester,33977,3841,9424,4997,1569,690,20521
Pennsylvania,Winterstown borough,567,64,241,107,36,23,471
Pennsylvania,Dunnstown,1528,114,440,220,214,104,1092
Pennsylvania,Spry,4745,336,1145,1033,739,351,3604
Pennsylvania,North York borough,1957,206,602,286,140,55,1289
Pennsylvania,Steelton borough,5954,412,1612,980,264,200,3468
Pennsylvania,Manchester borough,2748,348,1078,399,202,0,2027
Pennsylvania,Earlston,1096,159,402,173,16,45,795
Pennsylvania,East Earl,1269,78,296,160,233,0,767
Pennsylvania,East Freedom,944,76,342,197,57,0,672
Pennsylvania,East Salem,205,17,35,71,3,0,126
Pennsylvania,Fort Loudon,802,107,373,118,16,0,614
Pennsylvania,Force,189,14,79,19,4,0,116
Pennsylvania,Foot of Ten,715,60,291,138,46,3,538
Pennsylvania,Flora Dale,0,0,0,0,0,0,0
Pennsylvania,Fivepointville,1550,129,495,267,63,18,972
Pennsylvania,Fellsburg,1351,11,303,347,219,109,989
Pennsylvania,Feasterville,2879,152,487,517,580,225,1961
Pennsylvania,Faxon,1360,37,179,344,200,262,1022
Pennsylvania,Fawn Lake Forest,502,0,46,163,77,101,387
Pennsylvania,Farmington,851,28,142,214,65,69,518
Pennsylvania,Farmersville,1017,389,159,52,73,18,691
Pennsylvania,Jacksonville CDP (Centre County),77,6,30,6,4,0,46
Pennsylvania,Falmouth,446,57,136,35,45,26,299
Pennsylvania,Enlow,1107,143,180,308,107,50,788
Pennsylvania,Enhaut,912,121,225,264,22,21,653
Pennsylvania,Emerald Lakes,3954,326,1106,844,275,130,2681
Pennsylvania,Elrama,353,0,136,52,40,25,253
Pennsylvania,Eighty Four,483,34,170,129,19,26,378
Pennsylvania,Egypt,2102,26,606,507,274,175,1588
Pennsylvania,Effort,2350,187,517,473,195,235,1607
Pennsylvania,Edie,60,0,40,17,3,0,60
Pennsylvania,Edenburg,763,76,257,164,69,24,590
Pennsylvania,Edenborn,255,55,53,72,9,0,189
Pennsylvania,Eddington,2047,102,599,350,168,174,1393
Pennsylvania,Fairhope,1062,39,417,193,76,26,751
Pennsylvania,Laurelton,373,23,148,45,6,8,230
Pennsylvania,Laurys Station,1119,69,273,224,164,93,823
Pennsylvania,Lavelle,552,64,163,185,77,16,505
Pennsylvania,Pennside,4323,488,1077,1015,360,233,3173
Pennsylvania,Penn Estates,5708,145,965,1513,553,325,3501
Pennsylvania,Pen Mar,1046,63,249,270,98,43,723
Pennsylvania,Park Crest,666,18,199,133,76,45,471
Pennsylvania,Paris,866,120,303,173,110,12,718
Pennsylvania,Pardeesville,512,132,166,111,9,21,439
Pennsylvania,Palmdale,1137,37,376,126,216,69,824
Pennsylvania,Oval,414,29,90,74,56,29,278
Pennsylvania,Orwin,325,19,102,68,14,10,213
Pennsylvania,Orviston,121,22,38,12,7,16,95
Pennsylvania,Oley,1148,34,488,95,150,33,800
Pennsylvania,Oklahoma,817,38,184,145,84,110,561
Pennsylvania,Oberlin,400,0,113,102,15,14,244
Pennsylvania,Oakland CDP (Lawrence County),1469,93,449,236,72,55,905
Pennsylvania,Oakland CDP (Cambria County),1377,47,608,346,192,14,1207
Pennsylvania,Noxen,567,58,193,68,18,26,363
Pennsylvania,Northwood,161,0,96,21,5,9,131
Pennsylvania,North Warren,1821,93,525,475,224,54,1371
Pennsylvania,North Vandergrift,401,76,124,73,21,0,294
Pennsylvania,Norvelt,779,26,214,251,129,47,667
Pennsylvania,Noblestown,497,14,102,93,102,0,311
Pennsylvania,Nittany,905,76,457,91,68,18,710
Pennsylvania,New Tripoli,1022,22,188,212,165,47,634
Pennsylvania,Penn State Erie (Behrend),1644,0,0,5,14,0,19
Pennsylvania,Pennwyn,612,8,196,115,185,0,504
Pennsylvania,Arona borough,342,35,121,71,17,15,259
Pennsylvania,Irwin borough,3829,150,1072,901,602,255,2980
Pennsylvania,Fairless Hills,8376,515,2496,1597,961,398,5967
Pennsylvania,Newtown Grant,3636,46,385,564,1036,654,2685
Pennsylvania,Riegelsville borough,752,13,232,171,103,93,612
Pennsylvania,Trumbauersville borough,950,35,275,178,164,52,704
Pennsylvania,Parkside borough,2291,75,508,501,224,101,1409
Pennsylvania,Morton borough,2666,123,614,520,396,340,1993
Pennsylvania,Marcus Hook borough,2393,316,609,366,178,21,1490
Pennsylvania,Broomall,11154,529,2419,2007,2080,1224,8259
Pennsylvania,Hollidaysburg borough,5705,143,1694,1163,1172,355,4527
Pennsylvania,Dunlevy borough,380,28,125,69,32,17,271
Pennsylvania,Cokeburg borough,543,36,268,81,42,12,439
Pennsylvania,New Schaefferstown,150,13,47,43,13,19,135
Pennsylvania,Arnold,4930,281,1772,987,231,107,3378
Pennsylvania,Brookhaven borough,8043,480,1989,1976,943,695,6083
Pennsylvania,Sheppton,236,20,95,52,0,1,168
Pennsylvania,Shenandoah borough,4853,618,1403,772,248,96,3137
Pennsylvania,Buck Run,248,27,92,43,16,3,181
Pennsylvania,Northwest Harborcreek,9034,498,2241,1961,1226,578,6504
Pennsylvania,Emigsville,3063,192,957,442,281,92,1964
Pennsylvania,Dillsburg borough,2546,109,688,431,350,162,1740
Pennsylvania,Delta borough,591,40,203,87,39,24,393
Pennsylvania,Mansfield borough,3174,63,689,379,375,315,1821
Pennsylvania,Knoxville borough,703,46,256,142,35,4,483
Pennsylvania,New Kensington,12568,1199,3674,2605,1381,631,9490
Pennsylvania,Big Beaver borough,1829,75,590,327,233,141,1366
Pennsylvania,New Salem,584,36,275,69,32,0,412
Pennsylvania,New Market,775,174,218,158,71,0,621
Pennsylvania,New Jerusalem,469,71,174,74,37,30,386
Pennsylvania,Mattawana,541,93,209,58,20,3,383
Pennsylvania,Mather,422,38,196,75,21,9,339
Pennsylvania,Masthope,691,49,131,139,140,85,544
Pennsylvania,Martins Creek,578,8,212,176,73,0,469
Pennsylvania,Marion,1222,196,111,205,195,31,738
Pennsylvania,Marienville,4367,820,2095,697,90,58,3760
Pennsylvania,Marianne,1127,48,282,149,160,181,820
Pennsylvania,Mapletown,96,16,57,12,6,0,91
Pennsylvania,Mammoth,419,8,142,94,74,0,318
Pennsylvania,Maitland,282,0,127,116,27,0,270
Pennsylvania,McKnightstown,151,0,132,0,19,0,151
Pennsylvania,Meadowlands,1152,55,363,284,32,0,734
Pennsylvania,McElhattan,550,36,277,67,21,6,407
Pennsylvania,Lumber City,173,15,93,49,10,0,167
Pennsylvania,Loyalhanna,3487,294,1042,659,378,193,2566
Pennsylvania,Longfellow,141,41,74,17,4,0,136
Pennsylvania,Lincoln University,1861,0,5,30,0,7,42
Pennsylvania,Lincoln Park,1519,93,302,296,304,135,1130
Pennsylvania,Level Green,3939,97,1080,641,648,463,2929
Pennsylvania,Little Britain,487,41,134,102,0,15,292
Pennsylvania,Lenkerville,527,11,133,127,58,13,342
Pennsylvania,Lemont Furnace,901,164,280,66,11,6,527
Pennsylvania,Leeper,173,12,90,37,11,9,159
Pennsylvania,Lawrence,438,25,170,82,62,8,347
Pennsylvania,McConnellstown,1501,64,438,244,231,86,1063
Pennsylvania,Aaronsburg CDP (Centre County),494,41,250,58,47,21,417
Pennsylvania,Mertztown,788,63,344,140,18,0,565
Pennsylvania,Milford Square,973,18,201,75,230,93,617
Pennsylvania,New Freeport,52,8,29,1,1,0,39
Pennsylvania,New Columbia,836,12,468,80,38,63,661
Pennsylvania,New Berlinville,1513,78,555,225,392,11,1261
Pennsylvania,New Bedford,920,75,279,181,62,35,632
Pennsylvania,Needmore,99,17,37,11,0,3,68
Pennsylvania,Naomi,111,18,56,37,0,0,111
Pennsylvania,Muse,2720,80,486,467,443,265,1741
Pennsylvania,Mundys Corner,1529,69,582,345,116,60,1172
Pennsylvania,Muir,459,47,181,80,10,24,342
Pennsylvania,Muhlenberg Park,1780,105,614,302,162,56,1239
Pennsylvania,Mount Morris,711,52,259,125,71,47,554
Pennsylvania,Messiah College,2278,0,0,6,8,42,56
Pennsylvania,Mount Eagle,52,0,30,10,9,0,49
Pennsylvania,Moshannon,314,31,154,55,0,0,240
Pennsylvania,Morrisdale,624,88,284,86,13,38,509
Pennsylvania,Morgantown,705,101,237,115,69,9,531
Pennsylvania,Montrose Manor,479,17,178,88,52,47,382
Pennsylvania,Montandon,1069,103,471,107,49,47,777
Pennsylvania,Mohrsville,674,66,205,94,32,37,434
Pennsylvania,Mocanaqua,733,47,282,152,6,30,517
Pennsylvania,Mingoville,627,0,245,92,106,16,459
Pennsylvania,Millwood,611,91,248,69,20,8,436
Pennsylvania,Millsboro,567,12,157,99,75,19,362
Pennsylvania,Millerton,325,25,120,78,11,19,253
Pennsylvania,Mount Aetna,366,55,145,43,20,4,267
Pennsylvania,Strausstown,396,42,140,39,17,8,246
Pennsylvania,Jeannette,9280,404,2999,2178,1037,284,6902
Pennsylvania,Virginville,249,6,93,91,11,0,201
Pennsylvania,Beaver Meadows borough,756,45,338,147,52,14,596
Pennsylvania,Upland borough,3304,307,1083,324,233,59,2006
Pennsylvania,Mifflinburg borough,3526,242,1104,607,401,246,2600
Pennsylvania,Mount Gretna Heights,393,16,70,40,80,112,318
Pennsylvania,Millheim borough,606,37,231,120,65,28,481
Pennsylvania,Uniontown,9908,1111,3493,1712,718,260,7294
Pennsylvania,South Temple,1738,160,496,314,136,58,1164
Pennsylvania,Woodlyn,9326,526,2869,1659,1018,395,6467
Pennsylvania,Lilly borough,854,44,373,122,70,41,650
Pennsylvania,Vintondale borough,400,47,153,56,17,5,278
Pennsylvania,Parkesburg borough,3781,362,958,653,350,122,2445
Pennsylvania,Spring City borough,3320,193,1035,621,477,157,2483
Pennsylvania,Weissport East,1431,53,711,302,133,46,1245
Pennsylvania,Toughkenamon,1345,261,241,138,111,75,826
Pennsylvania,Ebensburg borough,3173,129,899,397,639,431,2495
Pennsylvania,West Chester borough,19888,720,1774,1940,3680,1838,9952
Pennsylvania,Bradford Woods borough,1201,12,98,195,360,236,901
Pennsylvania,Aspers,249,0,44,47,51,0,142
Pennsylvania,Rauchtown,590,49,210,104,41,16,420
Pennsylvania,Raubsville,1433,0,352,333,120,190,995
Pennsylvania,Ranshaw,367,70,152,64,26,23,335
Pennsylvania,Queens Gate,1420,53,259,143,160,91,706
Pennsylvania,Prospect Park,397,7,94,113,49,8,271
Pennsylvania,West Fairview,1335,151,339,315,107,23,935
Pennsylvania,Glen Osborne borough,576,1,34,58,176,123,392
Pennsylvania,Temple,1476,82,528,357,53,18,1038
Pennsylvania,Murrysville municip,19908,328,3074,3259,4309,3795,14765
Pennsylvania,Monroeville municip,27893,849,5587,6040,5331,3325,21132
Pennsylvania,Fairview,3015,87,651,600,542,240,2120
Pennsylvania,Bethel Park municip,32185,994,5751,6156,7059,4078,24038
Pennsylvania,West Lawn,1719,149,395,257,257,73,1131
Pennsylvania,Forestville,477,43,193,65,34,10,345
Pennsylvania,Rockhill borough,432,38,152,90,9,10,299
Pennsylvania,Rouzerville,926,19,370,256,31,9,685
Pennsylvania,Cleona borough,2091,88,700,385,235,112,1520
Pennsylvania,Washingtonville borough,163,13,80,12,6,6,117
Pennsylvania,Driftwood borough,31,7,14,10,0,0,31
Pennsylvania,Foxburg borough,149,16,40,34,13,26,129
Pennsylvania,Knox borough,1010,57,307,178,71,95,708
Pennsylvania,Rimersburg borough,913,66,335,108,48,45,602
Pennsylvania,Wrightsville borough,2299,278,871,318,160,34,1661
Pennsylvania,Flying Hills,2327,43,481,582,577,232,1915
Pennsylvania,Old Orchard,2432,139,568,631,300,244,1882
Pennsylvania,Kenhorst borough,2870,177,789,601,295,127,1989
Pennsylvania,Orbisonia borough,446,74,179,45,24,3,325
Pennsylvania,East Petersburg borough,4508,154,1024,1060,647,440,3325
Pennsylvania,Ephrata borough,13802,1387,3716,2217,1407,604,9331
Pennsylvania,Baldwin borough,19651,1066,5352,4326,2377,1246,14367
Pennsylvania,Chester Heights borough,2630,71,420,423,412,485,1811
Pennsylvania,Lima,1763,51,499,301,383,305,1539
Pennsylvania,Topton borough,1947,79,651,431,222,68,1451
Pennsylvania,North Catasauqua borough,2841,133,944,569,241,143,2030
Pennsylvania,Schnecksville,3250,118,579,633,515,327,2172
Pennsylvania,Hokendauqua,2996,200,921,564,380,114,2179
Pennsylvania,Port Allegany borough,2226,94,668,399,194,135,1490
Pennsylvania,Edgewood borough,3070,42,276,499,621,1000,2438
Pennsylvania,Jefferson Hills borough,11231,232,2125,2281,2198,1197,8033
Pennsylvania,Millvale borough,3636,230,1022,1015,299,90,2656
Pennsylvania,Pittsburgh,303587,15678,53929,48037,46703,41773,206120
Pennsylvania,Wall borough,667,40,240,132,38,7,457
Pennsylvania,Dushore borough,650,55,258,140,54,28,535
Pennsylvania,Forksville borough,147,0,60,23,8,3,94
Pennsylvania,Lorane,4037,202,1196,605,671,326,3000
Pennsylvania,Lyons borough,567,74,174,87,69,0,404
Pennsylvania,New Morgan borough,75,3,5,2,0,0,10
Pennsylvania,Spring Ridge,947,35,258,87,273,170,823
Pennsylvania,Macungie borough,3144,114,858,573,535,202,2282
Pennsylvania,Pymatuning North,302,24,125,54,17,6,226
Pennsylvania,Coopersburg borough,2467,243,695,453,332,114,1837
Pennsylvania,Refton,369,63,105,17,31,0,216
Pennsylvania,Ridley Park borough,7035,233,1795,1352,1055,626,5061
Pennsylvania,Rehrersburg,204,0,60,43,20,12,135
Pennsylvania,Fallston borough,221,15,65,79,25,4,188
Pennsylvania,Homeacre-Lyndora,6714,287,1793,1670,944,437,5131
Pennsylvania,Allentown,120410,15735,27279,19202,7273,3961,73450
Pennsylvania,Colonial Park,12886,620,3085,2693,1776,988,9162
Pennsylvania,East Berlin borough,1645,82,507,289,127,86,1091
Pennsylvania,Norwood borough,5890,241,1813,1192,535,257,4038
Pennsylvania,Altoona,44372,3430,13957,7626,3603,1711,30327
Pennsylvania,Bessemer borough,1219,66,444,240,115,42,907
Pennsylvania,Ellport borough,1053,82,379,216,70,12,759
Pennsylvania,Canonsburg borough,8864,530,2275,1994,1116,479,6394
Pennsylvania,Sharon Hill borough,5691,310,1610,1418,426,230,3994
Pennsylvania,Crafton borough,5839,232,1429,1206,849,425,4141
Pennsylvania,Mohnton borough,3019,213,692,422,376,268,1971
Pennsylvania,Hop Bottom borough,301,23,114,46,17,7,207
Pennsylvania,Penn Lake Park borough,312,8,66,76,49,38,237
Pennsylvania,Twilight borough,198,6,58,47,28,7,146
Pennsylvania,Geistown borough,2410,64,698,592,312,185,1851
Pennsylvania,Hummelstown borough,4650,111,969,1029,723,427,3259
Pennsylvania,Old Forge borough,8038,310,2637,1555,1025,549,6076
Pennsylvania,Brookville borough,3842,237,1129,551,467,339,2723
Pennsylvania,Ridgway borough,3862,161,1054,801,403,198,2617
Pennsylvania,Wilson borough,7795,585,2269,1683,867,379,5783
Pennsylvania,Kutztown borough,5042,205,901,655,664,635,3060
Pennsylvania,Plum borough,27304,846,6016,6218,4832,2525,20437
Pennsylvania,Glenfield borough,209,6,39,64,36,11,156
Pennsylvania,Venango borough,283,18,97,41,18,9,183
Pennsylvania,Shippensburg borough,5479,610,1464,577,736,493,3880
Pennsylvania,Parker,615,80,220,87,42,20,449
Pennsylvania,South Coatesville borough,1276,71,449,259,81,57,917
Pennsylvania,East Uniontown,2540,136,1106,358,111,54,1765
Pennsylvania,Kennett Square borough,6159,1160,1062,727,828,329,4106
Pennsylvania,Daisytown borough,375,12,115,67,47,8,249
Pennsylvania,Belfast,1052,35,338,175,169,111,828
Pennsylvania,South Pottstown,2286,105,620,411,293,153,1582
Pennsylvania,McSherrystown borough,3071,288,838,751,79,84,2040
Pennsylvania,Ford City borough,2848,191,1036,628,209,41,2105
Pennsylvania,Centerville borough (Crawford County),195,21,66,43,21,6,157
Pennsylvania,Snydertown borough,296,9,125,54,16,32,236
Pennsylvania,Shamokin,7096,663,2375,1204,434,260,4936
Pennsylvania,Northumberland borough,3692,235,1060,689,456,280,2720
Pennsylvania,Marion Heights borough,676,43,218,154,46,28,489
Pennsylvania,Edgewood,2376,238,802,384,86,92,1602
Pennsylvania,Tamaqua borough,6796,615,2045,1351,466,193,4670
Pennsylvania,Watsontown borough,2496,241,874,424,193,102,1834
Pennsylvania,Palo Alto borough,887,105,382,143,36,12,678
Pennsylvania,Middleport borough,426,28,193,56,30,8,315
Pennsylvania,Wayne Heights,2438,106,622,471,226,160,1585
Pennsylvania,South Renovo borough,458,64,187,59,31,12,353
Pennsylvania,Yardley borough,2472,6,252,455,548,571,1832
Pennsylvania,Warrior Run borough,633,36,206,132,29,7,410
Pennsylvania,Bryn Athyn borough,1282,5,114,210,258,209,796
Pennsylvania,Oneida,110,7,60,25,0,0,92
Pennsylvania,Bowmanstown borough,1019,112,377,146,45,31,711
Pennsylvania,Palmerton borough,5314,566,1525,993,315,204,3603
Pennsylvania,Parryville borough,503,67,172,99,41,13,392
Pennsylvania,Midway borough,876,34,356,146,45,9,590
Pennsylvania,Middletown,7386,511,1904,1749,1032,315,5511
Pennsylvania,Franklin Park borough,14448,135,1268,1650,3571,3349,9973
Pennsylvania,Galeton borough,998,87,375,232,57,36,787
Pennsylvania,Forty Fort borough,4129,178,997,898,563,471,3107
Pennsylvania,Yatesville borough,617,23,157,102,70,54,406
Pennsylvania,Nuangola borough,759,35,222,168,98,66,589
Pennsylvania,Wilmore borough,245,11,81,37,21,9,159
Pennsylvania,Johnstown,19812,2081,6285,3594,1054,655,13669
Pennsylvania,Franklin,6216,677,1947,771,587,433,4415
Pennsylvania,Juniata Terrace borough,513,33,170,95,35,10,343
Pennsylvania,Highland Park,1233,94,479,192,115,55,935
Pennsylvania,Coburn,139,6,43,9,9,5,72
Pennsylvania,Boalsburg,4666,42,463,622,1171,1133,3431
Pennsylvania,Weatherly borough,2615,184,869,474,287,94,1908
Pennsylvania,Reinerton,520,46,208,82,46,10,392
Pennsylvania,Swarthmore borough,6304,91,332,313,933,1629,3298
Pennsylvania,Darby borough,10699,884,2829,1721,598,285,6317
Pennsylvania,Lansdowne borough,10628,481,2283,2053,1557,1184,7558
Pennsylvania,Burlington borough,210,5,64,20,23,2,114
Pennsylvania,Towanda borough,2850,260,695,591,215,161,1922
Pennsylvania,West Kittanning borough,1161,49,352,264,154,53,872
Pennsylvania,Blakely borough,6316,313,1780,1248,1004,638,4983
Pennsylvania,Glenburn,920,26,160,157,162,194,699
Pennsylvania,Jermyn borough,2164,152,592,491,244,132,1611
Pennsylvania,New Paris borough,190,20,86,23,5,2,136
Pennsylvania,Moscow borough,1859,56,465,384,328,234,1467
Pennsylvania,New Wilmington borough,2297,63,215,165,244,254,941
Pennsylvania,Duncannon borough,1489,126,537,232,118,56,1069
Pennsylvania,Mechanicsburg borough,8987,606,2353,1634,1528,686,6807
Pennsylvania,Evans City borough,1844,101,439,437,197,152,1326
Pennsylvania,Harrisville borough,899,66,302,122,110,62,662
Pennsylvania,Meridian,3765,59,970,926,574,338,2867
Pennsylvania,New Castle Northwest,1284,42,476,273,182,83,1056
Pennsylvania,Zelienople borough,3683,62,724,644,858,506,2794
Pennsylvania,Hyndman borough,824,70,341,128,30,24,593
Pennsylvania,Matamoras borough,2250,166,531,487,243,161,1588
Pennsylvania,Lebanon,25739,3460,7941,3470,1057,416,16344
Pennsylvania,Fairchance borough,2094,102,821,295,146,76,1440
Pennsylvania,Fayette City borough,496,46,177,98,20,5,346
Pennsylvania,Masontown borough,3358,225,1359,518,201,94,2397
Pennsylvania,Harrison City,69,0,54,0,15,0,69
Pennsylvania,Lynnwood-Pricedale,1774,107,648,264,209,69,1297
Pennsylvania,Coaldale borough (Bedford County),137,17,66,12,6,0,101
Pennsylvania,Madison borough,354,21,156,83,13,16,289
Pennsylvania,South Greensburg borough,2217,83,700,477,231,111,1602
Pennsylvania,Southwest Greensburg borough,2187,85,565,451,318,144,1563
Pennsylvania,Youngwood borough,2923,208,958,643,255,104,2168
Pennsylvania,Beaver borough,4368,104,790,895,919,574,3282
Pennsylvania,Monaca borough,5570,249,1701,1408,708,123,4189
Pennsylvania,Ohioville borough,3364,99,1013,798,380,185,2475
Pennsylvania,Mount Pleasant borough,4299,300,1394,806,617,186,3303
Pennsylvania,Pymatuning Central,2088,191,756,408,193,186,1734
Pennsylvania,Townville borough,297,17,103,55,25,10,210
Pennsylvania,St. Petersburg borough,294,37,114,49,23,10,233
Pennsylvania,Mahaffey borough,391,29,191,64,16,2,302
Pennsylvania,New Washington borough,39,4,25,2,3,0,34
Pennsylvania,Osceola Mills borough,1051,84,389,220,54,27,774
Pennsylvania,Treasure Lake,3357,0,879,771,463,262,2375
Pennsylvania,Wallaceton borough,316,38,125,38,11,2,214
Pennsylvania,Croydon,9675,999,3139,1474,678,331,6621
Pennsylvania,Glen Hope borough,163,13,70,38,14,1,136
Pennsylvania,Langhorne Manor borough,1563,68,212,297,195,131,903
Pennsylvania,Richfield,564,70,244,65,26,29,434
Pennsylvania,Biglerville borough,1208,131,311,183,84,62,771
Pennsylvania,Carroll Valley borough,3907,96,765,1086,538,280,2765
Pennsylvania,Fairfield borough,544,28,193,119,49,31,420
Pennsylvania,Nemacolin,640,15,178,176,54,0,423
Pennsylvania,Rices Landing borough,494,40,147,103,31,28,349
Pennsylvania,Richlandtown borough,1202,59,379,141,166,75,820
Pennsylvania,Woodward,156,10,48,23,7,0,88
Pennsylvania,Oxford borough,5420,751,1355,488,493,215,3302
Pennsylvania,Williamsport,28757,2085,6448,5022,2794,1344,17693
Pennsylvania,Ehrenfeld borough,167,16,63,31,6,1,117
Pennsylvania,Northern Cambria borough,3618,204,1315,554,286,103,2462
Pennsylvania,Summerhill borough,430,20,145,83,46,24,318
Pennsylvania,Vinco,1200,112,402,226,171,42,953
Pennsylvania,Westmont borough,4866,78,620,914,1152,812,3576
Pennsylvania,Grove City borough,8053,231,1496,675,938,665,4005
Pennsylvania,New Milford borough,965,103,296,202,59,7,667
Pennsylvania,McDonald borough,2135,201,675,366,223,89,1554
Pennsylvania,New Kingstown,711,38,171,94,55,122,480
Pennsylvania,McGovern,2632,111,784,560,441,73,1969
Pennsylvania,Stoneboro borough,850,42,328,169,95,36,670
Pennsylvania,Carlisle borough,19116,1057,3721,2504,2413,2249,11944
Pennsylvania,Kenilworth,1991,146,455,332,340,174,1447
Pennsylvania,Garden View,2726,221,901,453,365,131,2071
Pennsylvania,Montoursville borough,4483,152,1114,936,722,289,3213
Pennsylvania,Cornwall borough,4270,189,1524,579,727,474,3493
Pennsylvania,Summit Hill borough,2958,138,892,780,180,190,2180
Pennsylvania,Lehighton borough,5313,609,1677,807,453,221,3767
Pennsylvania,Mont Alto borough,1767,104,498,326,79,74,1081
Pennsylvania,Petrolia borough,174,4,72,37,7,1,121
Pennsylvania,Prospect borough,1052,40,313,220,154,55,782
Pennsylvania,Valencia borough,517,29,143,157,82,52,463
Pennsylvania,West Liberty borough,368,17,111,67,39,13,247
Pennsylvania,Adamsville,59,16,19,12,5,0,52
Pennsylvania,Shippenville borough,585,55,169,86,88,27,425
Pennsylvania,Eau Claire borough,348,30,121,52,22,9,234
Pennsylvania,Rochester borough,3530,223,1165,871,197,56,2512
Pennsylvania,Brownsville borough,2046,189,636,338,155,108,1426
Pennsylvania,Dayton borough,530,38,227,65,53,6,389
Pennsylvania,Timber Hills,611,39,202,65,98,83,487
Pennsylvania,Danville borough,4646,352,1476,425,686,521,3460
Pennsylvania,Mount Jewett borough,1012,61,368,149,54,50,682
Pennsylvania,Smethport borough,1649,90,457,288,137,169,1141
Pennsylvania,Belle Vernon borough,1016,141,363,185,78,20,787
Pennsylvania,Wormleysburg borough,3061,103,556,470,586,397,2112
Pennsylvania,West Middlesex borough,764,40,224,158,56,52,530
Pennsylvania,Jackson Center borough,197,28,73,27,11,4,143
Pennsylvania,Austin borough,548,49,250,108,18,2,427
Pennsylvania,Coudersport borough,2699,214,800,500,276,137,1927
Pennsylvania,Oswayo borough,198,12,58,25,15,0,110
Pennsylvania,Linntown,1344,44,248,269,303,212,1076
Pennsylvania,Beallsville borough,511,27,158,107,47,20,359
Pennsylvania,Charleroi borough,3976,215,1290,788,258,146,2697
Pennsylvania,Ellsworth borough,625,40,227,107,44,14,432
Pennsylvania,Gastonville,2687,145,984,467,365,126,2087
Pennsylvania,New Eagle borough,2118,167,739,494,155,35,1590
Pennsylvania,Volant borough,111,2,32,22,15,12,83
Pennsylvania,Harmonsburg,468,30,81,35,87,32,265
Pennsylvania,Newport borough,1585,131,542,266,121,39,1099
Pennsylvania,Lincolnville,192,10,60,17,13,7,107
Pennsylvania,Pymatuning South,329,26,95,83,29,34,267
Pennsylvania,Marysville borough,2543,141,869,502,240,115,1867
Pennsylvania,West Hills,1171,21,364,249,110,115,859
Pennsylvania,Eastlawn Gardens,3387,58,787,654,454,290,2243
Pennsylvania,Archbald borough,7002,323,1625,1561,1159,404,5072
Pennsylvania,Oak Hills,2258,73,401,508,395,284,1661
Pennsylvania,Berwick borough,10167,993,3118,1759,856,364,7090
Pennsylvania,Jonestown,83,17,41,6,3,5,72
Pennsylvania,Wilburton Number One,184,23,88,19,1,4,135
Pennsylvania,Lawnton,3986,293,1011,703,583,183,2773
Pennsylvania,Linglestown,5742,223,1355,1351,1047,336,4312
Pennsylvania,Pillow borough,256,27,100,31,17,1,176
Pennsylvania,Berrysburg borough,323,24,115,61,35,7,242
Pennsylvania,Manorville borough,447,13,128,89,44,22,296
Pennsylvania,Hawthorn borough,416,57,167,47,25,4,300
Pennsylvania,Markleysburg borough,279,42,101,22,2,1,168
Pennsylvania,Tunkhannock borough,1771,68,466,382,246,130,1292
Pennsylvania,Chester Hill borough,830,70,258,139,57,29,553
Pennsylvania,Jim Thorpe borough,4643,524,1393,1014,382,176,3489
Pennsylvania,Greencastle borough,4021,147,1160,648,463,398,2816
Pennsylvania,West Easton borough,1387,111,464,285,68,27,955
Pennsylvania,Bell Acres borough,1434,22,221,207,342,232,1024
Pennsylvania,Vowinckel,82,5,54,16,7,0,82
Pennsylvania,Aspinwall borough,2756,58,262,359,656,727,2062
Pennsylvania,Hartstown,198,13,78,34,8,5,138
Pennsylvania,Springboro borough,435,38,143,56,23,11,271
Pennsylvania,Woodcock borough,122,14,55,19,13,2,103
Pennsylvania,Linesville borough,1002,43,346,148,80,82,699
Pennsylvania,New Beaver borough,1413,126,537,233,72,44,1012
Pennsylvania,S.N.P.J. borough,31,2,12,9,3,3,29
Pennsylvania,Wampum borough,628,30,258,137,26,20,471
Pennsylvania,Liverpool borough,855,77,294,163,54,48,636
Pennsylvania,Millerstown borough,791,23,182,152,101,61,519
Pennsylvania,Colver,810,70,232,249,68,32,651
Pennsylvania,Cresson borough,1709,84,487,355,182,101,1209
Pennsylvania,Dale borough,1056,115,378,179,39,21,732
Pennsylvania,Gallitzin borough,1599,63,606,279,138,57,1143
Pennsylvania,Bally borough,1264,79,372,224,111,58,844
Pennsylvania,Centerport borough,240,10,65,50,23,25,173
Pennsylvania,Clarks Summit borough,4915,119,830,1031,885,794,3659
Pennsylvania,Honey Brook borough,1865,130,535,240,238,96,1239
Pennsylvania,Avalon borough,4626,163,1283,1111,884,327,3768
Pennsylvania,Falls Creek borough,1019,40,378,222,56,15,711
Pennsylvania,Sunrise Lake,1239,15,106,174,446,121,862
Pennsylvania,Sun Valley,2013,238,430,382,205,27,1282
Pennsylvania,Swartzville,2463,273,821,321,250,117,1782
Pennsylvania,Sweden Valley,231,25,60,47,24,9,165
Pennsylvania,Table Rock,40,0,20,5,5,5,35
Pennsylvania,Taylorstown,226,8,72,28,24,0,132
Pennsylvania,Washington,13590,1049,3918,2230,1398,523,9118
Pennsylvania,Templeton,290,20,138,31,6,6,201
Pennsylvania,The Hideout,1438,75,413,224,152,119,983
Pennsylvania,Toftrees,2861,0,216,429,873,860,2378
Pennsylvania,Towamensing Trails,1924,23,560,535,146,190,1454
Pennsylvania,Trexlertown,2182,71,482,228,493,334,1608
Pennsylvania,Trucksville,2084,53,335,469,421,135,1413
Pennsylvania,Tyler Run,1775,121,306,424,345,160,1356
Pennsylvania,Tharptown (Uniontown),438,39,229,77,18,28,391
Pennsylvania,Boiling Springs,3144,71,643,573,497,531,2315
Pennsylvania,Lemoyne borough,4641,188,707,1263,823,352,3333
Pennsylvania,Portage borough,2491,174,854,459,219,109,1815
Pennsylvania,Stouchsburg,422,53,107,90,26,11,287
Pennsylvania,Strodes Mills,969,27,522,106,48,19,722
Pennsylvania,Strong,0,0,0,0,0,0,0
Pennsylvania,Howard borough,670,53,216,146,77,19,511
Pennsylvania,Dupont borough,2693,232,767,645,217,172,2033
Pennsylvania,Seneca,1162,88,423,132,218,57,918
Pennsylvania,East Lansdowne borough,2678,186,800,470,292,76,1824
Pennsylvania,New Oxford borough,2099,244,606,247,133,79,1309
Pennsylvania,McAlisterville,1068,52,336,32,171,67,658
Pennsylvania,Sellersville borough,4255,289,1056,703,633,202,2883
Pennsylvania,Johnsonburg borough,2353,177,880,360,146,47,1610
Pennsylvania,Nanty-Glo borough,2570,197,944,467,154,61,1823
Pennsylvania,Lorain borough,716,46,297,111,47,33,534
Pennsylvania,Elim,3376,60,1108,480,602,262,2512
Pennsylvania,Quakertown borough,8836,598,2754,1566,976,450,6344
Pennsylvania,Tylersburg,89,12,16,38,9,0,75
Pennsylvania,Sturgeon,1580,135,382,233,148,187,1085
Pennsylvania,Union Deposit,415,52,43,74,29,45,243
Pennsylvania,University of Pittsburgh Johnstown,1552,0,0,0,0,0,0
Pennsylvania,Nescopeck borough,1565,102,598,340,129,42,1211
Pennsylvania,Hartleton borough,260,47,78,32,21,2,180
Pennsylvania,Rutledge borough,729,9,120,118,142,129,518
Pennsylvania,Linwood,3267,281,1090,441,121,95,2028
Pennsylvania,Folsom,8707,313,2517,1568,1261,486,6145
Pennsylvania,Clifton Heights borough,6680,590,1910,1230,685,224,4639
Pennsylvania,West Wyoming borough,2692,166,767,630,366,170,2099
Pennsylvania,Orrtanna,156,5,45,40,9,11,110
Pennsylvania,Lake Heritage,2303,28,360,586,368,382,1724
Pennsylvania,Herndon borough,387,33,125,59,19,17,253
Pennsylvania,Williamsburg borough,1104,65,379,172,91,46,753
Pennsylvania,Thorndale,3956,160,669,947,870,345,2991
Pennsylvania,Garrett borough,392,49,178,42,13,8,290
Pennsylvania,Van Voorhis,182,12,86,45,10,8,161
Pennsylvania,Midway,1969,87,769,414,174,86,1530
Pennsylvania,Luzerne borough,2809,271,970,652,251,83,2227
Pennsylvania,Nanticoke,10302,939,3103,2130,843,394,7409
Pennsylvania,Hasson Heights,1586,53,426,357,198,111,1145
Pennsylvania,Upper Exeter,810,29,215,183,129,45,601
Pennsylvania,North Charleroi borough,1347,92,487,246,101,63,989
Pennsylvania,Houston borough,1371,74,517,228,114,48,981
Pennsylvania,Enon Valley borough,377,29,77,103,31,8,248
Pennsylvania,Sharpsville borough,4202,217,1245,1002,383,139,2986
Pennsylvania,Manor borough,3294,88,657,611,406,374,2136
Pennsylvania,Laurel Mountain borough,179,0,29,56,38,5,128
Pennsylvania,Hyde Park borough,464,27,145,95,36,17,320
Pennsylvania,Crabtree,190,16,20,56,0,0,92
Pennsylvania,Conyngham borough,1928,55,390,437,356,267,1505
Pennsylvania,Saltsburg borough,738,74,241,154,76,25,570
Pennsylvania,Clymer borough,1235,76,477,175,95,45,868
Pennsylvania,Mifflin borough,534,72,203,46,15,7,343
Pennsylvania,Woodbourne,4006,57,473,575,1056,703,2864
Pennsylvania,Polk borough,788,244,229,76,41,10,600
Pennsylvania,Unionville,811,58,364,150,107,32,711
Pennsylvania,Stony Creek Mills,777,137,242,122,66,36,603
Pennsylvania,Trevose,3716,234,1062,801,286,132,2515
Pennsylvania,Stonerstown,423,3,160,89,26,9,287
Pennsylvania,Jamestown borough,648,36,197,130,58,40,461
Pennsylvania,Vicksburg,769,149,190,38,39,33,449
Pennsylvania,Cherry Valley borough,62,5,19,14,10,1,49
Pennsylvania,Rennerdale,914,16,173,317,180,97,783
Pennsylvania,Revloc,696,75,272,32,18,0,397
Pennsylvania,Rew,136,23,45,8,33,0,109
Pennsylvania,South Bethlehem borough,439,61,141,68,28,33,331
Pennsylvania,Reynolds Heights,1636,132,622,191,141,131,1217
Pennsylvania,Riverview Park,2726,155,931,406,367,218,2077
Pennsylvania,Robinson,542,38,237,102,9,15,401
Pennsylvania,Rogersville,252,14,86,49,24,12,185
Pennsylvania,Ronco,133,15,61,29,0,0,105
Pennsylvania,Ronks,130,17,27,39,0,0,83
Pennsylvania,Rote,558,51,263,41,38,19,412
Pennsylvania,Riverside,273,36,124,44,16,8,228
Pennsylvania,Reinholds,2600,187,568,503,188,89,1535
Pennsylvania,Mount Oliver borough,3340,323,991,489,131,125,2059
Pennsylvania,South Williamsport borough,6193,198,1666,1334,717,408,4323
Pennsylvania,Carnegie borough,7905,362,1868,1789,1484,585,6088
Pennsylvania,New Columbus borough,206,10,53,44,11,12,130
Pennsylvania,Bruin borough,440,37,173,65,11,16,302
Pennsylvania,Stonybrook,2250,104,397,393,351,369,1614
Pennsylvania,Burgettstown borough,1385,111,430,269,146,52,1008
Pennsylvania,Baden borough,3977,239,1384,870,364,238,3095
Pennsylvania,Donegal borough,218,31,92,29,4,3,159
Pennsylvania,Collegeville borough,5170,57,448,483,930,481,2399
Pennsylvania,Glasgow borough,104,4,24,19,2,1,50
Pennsylvania,Emlenton borough,706,24,180,139,110,44,497
Pennsylvania,Westfield borough,1295,184,425,197,82,22,910
Pennsylvania,Bangor borough,5225,585,1510,806,376,139,3416
Pennsylvania,McMurray,4414,66,547,603,1242,674,3132
Pennsylvania,Telford borough,4793,447,1321,771,558,184,3281
Pennsylvania,Shade Gap borough,83,17,26,12,1,2,58
Pennsylvania,Roulette,895,61,318,130,54,19,582
Pennsylvania,Rowes Run,640,52,235,85,27,0,399
Pennsylvania,Farrell,4722,352,1397,924,352,62,3087
Pennsylvania,St. Michael,339,49,109,58,44,22,282
Pennsylvania,Slippery Rock University,2266,4,4,23,0,9,40
Pennsylvania,Slovan,490,62,146,134,20,0,362
Pennsylvania,Smock,556,42,187,95,47,5,376
Pennsylvania,Smoketown,372,148,29,18,41,0,236
Pennsylvania,Soudersburg,830,231,106,19,39,9,404
Pennsylvania,South Philipsburg,353,0,194,30,11,9,244
Pennsylvania,South Uniontown,1415,118,377,315,215,88,1113
Pennsylvania,Southview,352,60,154,40,19,0,273
Pennsylvania,Spinnerstown,1822,50,383,367,262,110,1172
Pennsylvania,Springmont,553,13,123,186,103,21,446
Pennsylvania,Starbrick,377,26,223,75,8,0,332
Pennsylvania,Star Junction,397,27,194,35,24,16,296
Pennsylvania,Stevens,445,84,149,72,58,0,363
Pennsylvania,Stiles,1220,63,293,259,118,107,840
Pennsylvania,Russell,1383,85,401,219,184,182,1071
Pennsylvania,Slatedale,862,37,219,55,9,140,460
Pennsylvania,Simpson,1238,60,409,261,80,65,875
Pennsylvania,State Line,2287,152,818,328,141,96,1535
Pennsylvania,Siglerville,158,19,91,26,0,0,136
Pennsylvania,Silkworth,928,79,234,103,135,108,659
Pennsylvania,Salix,1340,46,496,195,86,44,867
Pennsylvania,Salunga,3100,166,750,362,731,239,2248
Pennsylvania,Saw Creek,3757,325,816,1042,435,242,2860
Pennsylvania,Saylorsburg,552,96,131,74,67,40,408
Pennsylvania,Schoeneck,1057,210,258,160,67,11,706
Pennsylvania,Schubert,264,0,138,32,39,0,209
Pennsylvania,St. Vincent College,1274,6,20,12,7,39,84
Pennsylvania,Shartlesville,587,36,261,70,45,28,440
Pennsylvania,Shavertown,2216,53,454,705,283,162,1657
Pennsylvania,Sheatown,840,39,232,106,93,69,539
Pennsylvania,Shippensburg University,1940,13,8,7,12,0,40
Pennsylvania,Sierra View,4487,297,892,1112,438,407,3146
Pennsylvania,Scotland,836,28,242,294,18,59,641
Pennsylvania,Sidman,462,7,96,52,12,110,277
Puerto Rico,Culebra zona urb,1182,,,,,,0
Puerto Rico,Las Ochenta comunidad,792,,,,,,0
Puerto Rico,Jobos comunidad,2103,,,,,,0
Puerto Rico,Rafael Capó comunidad,1709,,,,,,0
Puerto Rico,Humacao zona urb,18487,,,,,,0
Puerto Rico,Bartolo comunidad,1232,,,,,,0
Puerto Rico,Río Grande zona urb,12973,,,,,,0
Puerto Rico,Central Aguirre comunidad,1318,,,,,,0
Puerto Rico,Playita comunidad (Salinas Municipio),523,,,,,,0
Puerto Rico,G. L. García comunidad,1851,,,,,,0
Puerto Rico,Las Ollas comunidad,1722,,,,,,0
Puerto Rico,Galateo comunidad,3097,,,,,,0
Puerto Rico,San Antonio comunidad (Quebradillas Municipio),1591,,,,,,0
Puerto Rico,Levittown comunidad,25225,,,,,,0
Puerto Rico,Pole Ojea comunidad,1684,,,,,,0
Puerto Rico,Benítez comunidad,1444,,,,,,0
Puerto Rico,Caguas zona urb,74980,,,,,,0
Puerto Rico,Vieques comunidad,2527,,,,,,0
Puerto Rico,Suárez comunidad,1877,,,,,,0
Puerto Rico,Puerto Real comunidad,6892,,,,,,0
Puerto Rico,Barranquitas zona urb,2276,,,,,,0
Puerto Rico,Sabana Hoyos comunidad,2244,,,,,,0
Puerto Rico,La Playa comunidad,2131,,,,,,0
Puerto Rico,Isabela zona urb,10708,,,,,,0
Puerto Rico,Adjuntas zona urb,4222,,,,,,0
Puerto Rico,Playa Fortuna comunidad,1119,,,,,,0
Puerto Rico,Guayanilla zona urb,4634,,,,,,0
Puerto Rico,Pájaros comunidad,9554,,,,,,0
Puerto Rico,Rosa Sánchez comunidad,415,,,,,,0
Puerto Rico,Lomas comunidad,1267,,,,,,0
Puerto Rico,Monserrate comunidad,2462,,,,,,0
Puerto Rico,Palmer comunidad,1017,,,,,,0
Puerto Rico,Barahona comunidad,2241,,,,,,0
Puerto Rico,Coto Norte comunidad,1225,,,,,,0
Puerto Rico,Villalba zona urb,3028,,,,,,0
Puerto Rico,Ingenio comunidad,3896,,,,,,0
Puerto Rico,Marueño comunidad,838,,,,,,0
Puerto Rico,Capitanejo comunidad,3038,,,,,,0
Puerto Rico,Palo Seco comunidad,681,,,,,,0
Puerto Rico,María Antonia comunidad,944,,,,,,0
Puerto Rico,Río Lajas comunidad,2394,,,,,,0
Puerto Rico,Corozal zona urb,8871,,,,,,0
Puerto Rico,Palmarejo comunidad (Coamo Municipio),676,,,,,,0
Puerto Rico,Piedra Gorda comunidad,1392,,,,,,0
Puerto Rico,Jayuya zona urb,2506,,,,,,0
Puerto Rico,Barceloneta zona urb,3851,,,,,,0
Puerto Rico,Las Marías comunidad,2286,,,,,,0
Puerto Rico,Yauco zona urb,16802,,,,,,0
Puerto Rico,Potala Pastillo comunidad,2927,,,,,,0
Puerto Rico,Aguadilla zona urb,11170,,,,,,0
Puerto Rico,Imbéry comunidad,4280,,,,,,0
Puerto Rico,Comerío zona urb,4661,,,,,,0
Puerto Rico,Parcelas Nuevas comunidad,1399,,,,,,0
Puerto Rico,Cidra zona urb,5620,,,,,,0
Puerto Rico,Cataño zona urb,24888,,,,,,0
Puerto Rico,Loíza zona urb,3343,,,,,,0
Puerto Rico,Garrochales comunidad,1125,,,,,,0
Puerto Rico,Bajadero comunidad,3411,,,,,,0
Puerto Rico,Cabán comunidad,3419,,,,,,0
Puerto Rico,Añasco zona urb,5526,,,,,,0
Puerto Rico,Río Cañas Abajo comunidad,1242,,,,,,0
Puerto Rico,Aibonito zona urb,8352,,,,,,0
Puerto Rico,Santa Clara comunidad,747,,,,,,0
Puerto Rico,Moca zona urb,3486,,,,,,0
Puerto Rico,Breñas comunidad,4030,,,,,,0
Puerto Rico,Coquí comunidad,3187,,,,,,0
Puerto Rico,Miranda comunidad,1495,,,,,,0
Puerto Rico,Magas Arriba comunidad,910,,,,,,0
Puerto Rico,La Parguera comunidad,772,,,,,,0
Puerto Rico,Lares zona urb,3983,,,,,,0
Puerto Rico,Las Marías zona urb,704,,,,,,0
Puerto Rico,Sabana Grande zona urb,9357,,,,,,0
Puerto Rico,Coco comunidad,5328,,,,,,0
Puerto Rico,San Lorenzo zona urb,7629,,,,,,0
Puerto Rico,Vega Baja zona urb,22815,,,,,,0
Puerto Rico,La Fermina comunidad,2574,,,,,,0
Puerto Rico,Playita comunidad (Yabucoa Municipio),1755,,,,,,0
Puerto Rico,Santa Isabel zona urb,6196,,,,,,0
Puerto Rico,Luquillo zona urb,7841,,,,,,0
Puerto Rico,Pueblito del Río comunidad,1418,,,,,,0
Puerto Rico,Duque comunidad,1643,,,,,,0
Puerto Rico,Juana Díaz zona urb,7095,,,,,,0
Puerto Rico,Arroyo zona urb,6134,,,,,,0
Puerto Rico,Tiburones comunidad,2072,,,,,,0
Puerto Rico,Ciales zona urb,2274,,,,,,0
Puerto Rico,Campo Rico comunidad,2493,,,,,,0
Puerto Rico,Quebrada comunidad,1087,,,,,,0
Puerto Rico,Celada comunidad,4543,,,,,,0
Puerto Rico,Sabana Eneas comunidad,1120,,,,,,0
Puerto Rico,San Antonio comunidad (Aguadilla Municipio),1544,,,,,,0
Puerto Rico,Florida zona urb,4274,,,,,,0
Puerto Rico,Hatillo zona urb,4235,,,,,,0
Puerto Rico,El Ojo comunidad,1391,,,,,,0
Puerto Rico,La Dolores comunidad,2911,,,,,,0
Puerto Rico,H. Rivera Colón comunidad,2594,,,,,,0
Puerto Rico,Patillas zona urb,3292,,,,,,0
Puerto Rico,Tallaboa comunidad,882,,,,,,0
Puerto Rico,Ponce zona urb,116796,,,,,,0
Puerto Rico,El Negro comunidad,1221,,,,,,0
Puerto Rico,Mucarabones comunidad,1092,,,,,,0
Puerto Rico,Toa Alta zona urb,3829,,,,,,0
Puerto Rico,Vieques zona urb,3096,,,,,,0
Puerto Rico,Carolina zona urb,140072,,,,,,0
Puerto Rico,Indios comunidad,1367,,,,,,0
Puerto Rico,Lajas zona urb,4642,,,,,,0
Puerto Rico,Las Piedras zona urb,6402,,,,,,0
Puerto Rico,Orocovis zona urb,969,,,,,,0
Puerto Rico,Palomas comunidad (Comerío Municipio),1462,,,,,,0
Puerto Rico,Utuado zona urb,7160,,,,,,0
Puerto Rico,Olimpo comunidad,2300,,,,,,0
Puerto Rico,Carrizales comunidad,3052,,,,,,0
Puerto Rico,Manatí zona urb,12899,,,,,,0
Puerto Rico,Mayagüez zona urb,62579,,,,,,0
Puerto Rico,Río Blanco comunidad,1631,,,,,,0
Puerto Rico,Peñuelas zona urb,5253,,,,,,0
Puerto Rico,Quebradillas zona urb,4495,,,,,,0
Puerto Rico,Vázquez comunidad,1839,,,,,,0
Puerto Rico,Toa Baja zona urb,1370,,,,,,0
Puerto Rico,Morovis zona urb,1941,,,,,,0
Puerto Rico,Hato Arriba comunidad,387,,,,,,0
Puerto Rico,Maricao zona urb,789,,,,,,0
Puerto Rico,San Juan zona urb,331165,,,,,,0
Puerto Rico,La Alianza comunidad,1602,,,,,,0
Puerto Rico,Bayamón comunidad,1784,,,,,,0
Puerto Rico,Jagual comunidad,1479,,,,,,0
Puerto Rico,Quebrada del Agua comunidad,1244,,,,,,0
Puerto Rico,Tibes comunidad,403,,,,,,0
Puerto Rico,Rodríguez Hevia comunidad,66,,,,,,0
Puerto Rico,Vayas comunidad,631,,,,,,0
Puerto Rico,Cerrillos Hoyos comunidad,985,,,,,,0
Puerto Rico,Corral Viejo comunidad,514,,,,,,0
Puerto Rico,Pastos comunidad,1174,,,,,,0
Puerto Rico,Liborio Negrón Torres comunidad,1228,,,,,,0
Puerto Rico,Yaurel comunidad,1302,,,,,,0
Puerto Rico,Rafael Hernández comunidad,1029,,,,,,0
Puerto Rico,Búfalo comunidad,992,,,,,,0
Puerto Rico,Aguilita comunidad,3928,,,,,,0
Puerto Rico,Guayabal comunidad,1579,,,,,,0
Puerto Rico,Camuy zona urb,3834,,,,,,0
Puerto Rico,Cayey zona urb,14610,,,,,,0
Puerto Rico,Guánica zona urb,6781,,,,,,0
Puerto Rico,Hormigueros zona urb,11009,,,,,,0
Puerto Rico,Antón Ruíz comunidad,2279,,,,,,0
Puerto Rico,Bajandas comunidad,637,,,,,,0
Puerto Rico,Esperanza comunidad,775,,,,,,0
Puerto Rico,Punta Santiago comunidad,4880,,,,,,0
Puerto Rico,Cacao comunidad,1364,,,,,,0
Puerto Rico,Campanilla comunidad,5304,,,,,,0
Puerto Rico,San José comunidad,2483,,,,,,0
Puerto Rico,Vega Alta zona urb,9394,,,,,,0
Puerto Rico,Pueblito del Carmen comunidad,623,,,,,,0
Puerto Rico,Piedra Aguza comunidad,2697,,,,,,0
Puerto Rico,Parcelas Viejas Borinquen comunidad,665,,,,,,0
Puerto Rico,Parcelas Mandry comunidad,481,,,,,,0
Puerto Rico,San Sebastián zona urb,8490,,,,,,0
Puerto Rico,Fránquez comunidad,1912,,,,,,0
Puerto Rico,Trujillo Alto zona urb,44689,,,,,,0
Puerto Rico,Boquerón comunidad (Cabo Rojo Municipio),2401,,,,,,0
Puerto Rico,Boquerón comunidad (Las Piedras Municipio),1168,,,,,,0
Puerto Rico,Bairoa La Veinticinco comunidad,350,,,,,,0
Puerto Rico,Hacienda San José comunidad,2843,,,,,,0
Puerto Rico,Alianza comunidad,2786,,,,,,0
Puerto Rico,Anon Raices comunidad,129,,,,,,0
Puerto Rico,Buena Vista comunidad (Arroyo Municipio),1298,,,,,,0
Puerto Rico,Buena Vista comunidad (Humacao Municipio),962,,,,,,0
Puerto Rico,Calzada comunidad,178,,,,,,0
Puerto Rico,Peña Pobre comunidad,680,,,,,,0
Puerto Rico,Candelero Abajo comunidad,386,,,,,,0
Puerto Rico,El Paraiso comunidad,1757,,,,,,0
Puerto Rico,El Tumbao comunidad,2079,,,,,,0
Puerto Rico,La Liga comunidad,241,,,,,,0
Puerto Rico,Las Carolinas comunidad,2023,,,,,,0
Puerto Rico,Las Croabas comunidad,905,,,,,,0
Puerto Rico,La Yuca comunidad,458,,,,,,0
Puerto Rico,Los Panes comunidad,115,,,,,,0
Puerto Rico,Los Prados comunidad,2068,,,,,,0
Puerto Rico,Maguayo comunidad,996,,,,,,0
Puerto Rico,Monte Verde comunidad,28,,,,,,0
Puerto Rico,Palmas del Mar comunidad,1897,,,,,,0
Puerto Rico,Parcelas de Navarro comunidad,1569,,,,,,0
Puerto Rico,El Combate comunidad,207,,,,,,0
Puerto Rico,Naguabo zona urb,5220,,,,,,0
Puerto Rico,Guayama zona urb,22063,,,,,,0
Puerto Rico,Tierras Nuevas Poniente comunidad,3397,,,,,,0
Puerto Rico,Palmas comunidad,1088,,,,,,0
Puerto Rico,Jauca comunidad,1615,,,,,,0
Puerto Rico,Playita Cortada comunidad,946,,,,,,0
Puerto Rico,Ceiba zona urb,5613,,,,,,0
Puerto Rico,El Mangó comunidad,1458,,,,,,0
Puerto Rico,Juncos zona urb,7970,,,,,,0
Puerto Rico,Canóvanas zona urb,7351,,,,,,0
Puerto Rico,Santa Bárbara comunidad,4673,,,,,,0
Puerto Rico,Coamo zona urb,11148,,,,,,0
Puerto Rico,Fajardo zona urb,25229,,,,,,0
Puerto Rico,Gurabo zona urb,7515,,,,,,0
Puerto Rico,Parcelas Peñuelas comunidad,795,,,,,,0
Puerto Rico,La Plena comunidad,609,,,,,,0
Puerto Rico,Luis M. Cintrón comunidad,1866,,,,,,0
Puerto Rico,Corcovado comunidad,1744,,,,,,0
Puerto Rico,Daguao comunidad,1983,,,,,,0
Puerto Rico,San Antonio comunidad (Dorado Municipio),8144,,,,,,0
Puerto Rico,Salinas zona urb,4694,,,,,,0
Puerto Rico,Luis Lloréns Torres comunidad,3192,,,,,,0
Puerto Rico,Mora comunidad,1780,,,,,,0
Puerto Rico,Juncal comunidad,759,,,,,,0
Puerto Rico,Mariano Colón comunidad,2757,,,,,,0
Puerto Rico,Stella comunidad,1610,,,,,,0
Puerto Rico,Palomas comunidad (Yauco Municipio),1761,,,,,,0
Puerto Rico,Yabucoa zona urb,6829,,,,,,0
Puerto Rico,Martorell comunidad,2181,,,,,,0
Puerto Rico,Palmarejo comunidad (Lajas Municipio),1390,,,,,,0
Puerto Rico,Emajagua comunidad,2739,,,,,,0
Puerto Rico,Ramos comunidad,1536,,,,,,0
Puerto Rico,Aceitunas comunidad,1764,,,,,,0
Puerto Rico,Lamboglia comunidad,865,,,,,,0
Puerto Rico,Aguada zona urb,2675,,,,,,0
Puerto Rico,Luyando comunidad,2766,,,,,,0
Puerto Rico,Espino comunidad,843,,,,,,0
Puerto Rico,Arecibo zona urb,40108,,,,,,0
Puerto Rico,Betances comunidad,910,,,,,,0
Puerto Rico,Lluveras comunidad,1213,,,,,,0
Puerto Rico,San Germán zona urb,11117,,,,,,0
Puerto Rico,Rafael González comunidad,1865,,,,,,0
Puerto Rico,Sabana comunidad,1064,,,,,,0
Puerto Rico,La Luisa comunidad,2445,,,,,,0
Puerto Rico,Maunabo zona urb,1788,,,,,,0
Puerto Rico,Guaynabo zona urb,69697,,,,,,0
Puerto Rico,Corazón comunidad,1724,,,,,,0
Puerto Rico,Fuig comunidad,1253,,,,,,0
Puerto Rico,Pajonal comunidad,707,,,,,,0
Puerto Rico,Los Llanos comunidad,1990,,,,,,0
Puerto Rico,Parcelas La Milagrosa comunidad,1081,,,,,,0
Puerto Rico,Naranjito zona urb,1605,,,,,,0
Puerto Rico,Candelaria Arenas comunidad,3453,,,,,,0
Puerto Rico,Cayuco comunidad,1210,,,,,,0
Puerto Rico,Sabana Seca comunidad,7731,,,,,,0
Puerto Rico,Hato Candal comunidad,1673,,,,,,0
Puerto Rico,Tallaboa Alta comunidad,1472,,,,,,0
Puerto Rico,Rincón zona urb,1077,,,,,,0
Puerto Rico,Candelero Arriba comunidad,1184,,,,,,0
Puerto Rico,Aguas Claras comunidad,2310,,,,,,0
Puerto Rico,San Isidro comunidad,6915,,,,,,0
Puerto Rico,Comunas comunidad,1209,,,,,,0
Puerto Rico,Bayamón zona urb,165383,,,,,,0
Puerto Rico,Santo Domingo comunidad,3284,,,,,,0
Puerto Rico,Monte Grande comunidad,3446,,,,,,0
Puerto Rico,Candelaria comunidad,15846,,,,,,0
Puerto Rico,Animas comunidad,1190,,,,,,0
Puerto Rico,Aguas Buenas zona urb,2866,,,,,,0
Puerto Rico,Ceiba comunidad,2078,,,,,,0
Puerto Rico,Dorado zona urb,12330,,,,,,0
Puerto Rico,Coto Laurel comunidad,1639,,,,,,0
Puerto Rico,Cabo Rojo zona urb,8862,,,,,,0
Rhode Island,Chepachet,1529,169,358,359,211,83,1180
Rhode Island,Clayville,223,0,21,7,65,47,140
Rhode Island,Greene,734,54,186,155,139,71,605
Rhode Island,Harmony,1128,44,348,261,125,46,824
Rhode Island,Misquamicut,361,12,51,96,92,78,329
Rhode Island,Watch Hill,144,5,41,23,52,4,125
Rhode Island,Weekapaug,457,5,57,84,121,85,352
Rhode Island,Hopkinton,722,49,274,113,149,0,585
Rhode Island,Charlestown,1241,51,153,324,290,284,1102
Rhode Island,Pawtucket,71756,9807,16214,13668,6261,3794,49744
Rhode Island,Westerly,17435,1236,3700,3963,2407,1530,12836
Rhode Island,Wyoming,284,50,46,104,0,0,200
Rhode Island,Providence,179435,21496,31315,22054,17348,15115,107328
Rhode Island,Narragansett Pier,3725,149,533,545,830,646,2703
Rhode Island,Cumberland Hill,8142,419,1382,1792,1264,936,5793
Rhode Island,Hope Valley,1633,24,349,342,127,143,985
Rhode Island,Warwick,81079,5049,17154,18796,12870,7036,60905
Rhode Island,Pascoag,4824,298,1311,1095,720,188,3612
Rhode Island,Central Falls,19382,4326,4390,1987,628,297,11628
Rhode Island,Quonochontaug,560,0,79,124,83,102,388
Rhode Island,Newport East,11561,759,2113,2346,2025,1306,8549
Rhode Island,Woonsocket,41539,5575,10315,8037,3095,1716,28738
Rhode Island,Carolina,602,79,115,99,108,71,472
Rhode Island,Foster Center,418,84,39,98,93,11,325
Rhode Island,Melville,1305,5,164,275,191,156,791
Rhode Island,Cranston,81196,6525,17885,15914,10858,7212,58394
Rhode Island,Greenville,8387,547,1763,1933,1336,855,6434
Rhode Island,Valley Falls,11828,1290,2439,2538,1729,612,8608
Rhode Island,Newport,24762,1021,3163,3780,5916,3597,17477
Rhode Island,Tiverton,7757,521,1956,1708,994,821,6000
Rhode Island,Kingston,6789,44,147,238,412,312,1153
Rhode Island,Ashaway,1186,31,234,270,184,57,776
Rhode Island,Wakefield-Peacedale,9092,345,1611,1297,1403,1411,6067
Rhode Island,Harrisville,1348,53,247,358,55,162,875
Rhode Island,Bradford,1432,249,297,252,84,91,973
Rhode Island,East Providence,47449,5360,10406,9689,5943,3604,35002
South Carolina,Lane,460,54,156,72,28,19,329
South Carolina,Clarks Hill,367,89,51,66,10,0,216
South Carolina,Lesslie,2809,283,696,655,238,133,2005
South Carolina,Clover,5955,634,1256,1125,521,184,3720
South Carolina,Smoaks,91,7,25,29,6,11,78
South Carolina,Cameron,416,22,95,105,74,25,321
South Carolina,Denmark,3062,313,484,710,192,95,1794
South Carolina,Pelzer,1407,209,411,280,68,0,968
South Carolina,Iva,1515,286,453,208,45,47,1039
South Carolina,North Augusta,22603,1406,4403,4758,4000,1847,16414
South Carolina,Walterboro,5503,461,1293,860,423,336,3373
South Carolina,Lodge,46,1,19,13,4,5,42
South Carolina,Irwin,1303,175,402,316,64,41,998
South Carolina,Buffalo,1655,260,539,238,68,29,1134
South Carolina,Little River,9523,346,2859,2771,1380,590,7946
South Carolina,Atlantic Beach,242,18,90,25,15,14,162
South Carolina,Lugoff,8360,413,1941,1753,732,567,5406
South Carolina,Bethune,253,29,92,41,12,20,194
South Carolina,Great Falls,1988,211,561,265,92,64,1193
South Carolina,Plum Branch,84,4,28,15,14,2,63
South Carolina,Charleston,133762,5047,16450,23449,30798,17966,93710
South Carolina,Bradley,57,0,22,18,6,6,52
South Carolina,Norway,334,18,44,116,39,15,232
South Carolina,Wilkinson Heights,1546,275,335,363,172,151,1296
South Carolina,Woodford,164,26,52,14,9,5,106
South Carolina,Saluda,3613,600,708,536,137,53,2034
South Carolina,Chapin,1755,39,347,441,248,87,1162
South Carolina,Mount Croghan,133,14,36,29,15,3,97
South Carolina,Kline,172,19,37,20,17,0,93
South Carolina,Arcadia,4073,629,802,574,210,113,2328
South Carolina,Alcolu,499,60,88,123,42,24,337
South Carolina,Van Wyck,683,47,253,96,28,33,457
South Carolina,Pelion,741,59,221,149,72,17,518
South Carolina,McCormick,2654,593,871,526,142,48,2180
South Carolina,New Ellenton,2158,228,636,441,172,66,1543
South Carolina,Jackson,1953,113,578,505,115,68,1379
South Carolina,Lowndesville,96,9,33,21,5,0,68
South Carolina,York,8062,738,1819,1856,508,334,5255
South Carolina,Smyrna,28,9,6,6,0,0,21
South Carolina,Wellford,2561,260,655,654,164,25,1758
South Carolina,Boiling Springs,9282,589,1495,2108,1059,611,5862
South Carolina,South Congaree,2395,315,646,515,170,67,1713
South Carolina,Ridgeway,358,31,66,56,69,27,249
South Carolina,Cottageville,821,86,212,185,62,36,581
South Carolina,Bluffton,18835,866,2431,3599,3279,2283,12458
South Carolina,Belton,4309,695,1115,979,333,140,3262
South Carolina,Seabrook Island,1694,3,111,305,607,611,1637
South Carolina,Goose Creek,41339,2081,6517,10387,4557,2126,25668
South Carolina,North Hartsville,2588,199,735,608,245,87,1874
South Carolina,Patrick,355,60,128,88,10,2,288
South Carolina,Camden,7060,552,1353,1491,1180,616,5192
South Carolina,Chesterfield,1512,166,339,349,109,91,1054
South Carolina,Eureka Mill,1527,135,491,192,106,11,935
South Carolina,Hollywood,5119,431,1517,964,833,434,4179
South Carolina,Jefferson,981,172,235,114,74,27,622
South Carolina,Edgefield,4735,945,1644,978,214,160,3941
South Carolina,Luray,173,8,66,21,8,0,103
South Carolina,Langley,1309,300,443,136,13,23,915
South Carolina,East Gaffney,2944,782,639,480,132,52,2085
South Carolina,Clio,957,108,188,209,58,27,590
South Carolina,McColl,1981,337,718,310,43,26,1434
South Carolina,Scotia,252,21,83,51,2,0,157
South Carolina,Burton,8199,578,1865,1524,486,256,4709
South Carolina,Wedgefield,1865,131,561,423,50,47,1212
South Carolina,Powdersville,8991,488,1843,1996,1231,714,6272
South Carolina,James Island,12010,261,2127,2591,2951,1390,9320
South Carolina,Society Hill,669,108,120,123,40,15,406
South Carolina,Summerville,50894,2646,8680,11433,6534,3652,32945
South Carolina,Bonneau Beach,1870,66,653,659,91,48,1517
South Carolina,Boykin,198,0,11,116,29,17,173
South Carolina,Catawba,1151,180,316,251,93,0,840
South Carolina,Mulberry,233,68,55,60,0,0,183
South Carolina,Clifton,576,144,168,127,0,9,448
South Carolina,Cross Anchor,172,0,61,0,0,0,61
South Carolina,Enoree,682,179,107,131,13,12,442
South Carolina,Fairforest,1644,207,299,359,16,64,945
South Carolina,Fair Play,475,15,168,130,88,22,423
South Carolina,Fingerville,26,13,13,0,0,0,26
South Carolina,Gadsden,1873,108,604,698,62,124,1596
South Carolina,Glendale,293,20,65,56,39,0,180
South Carolina,Gramling,43,20,0,0,23,0,43
South Carolina,Graniteville,3415,528,654,566,105,87,1940
South Carolina,Hopkins,2956,277,1110,392,172,16,1967
South Carolina,Islandton,64,5,23,10,10,0,48
South Carolina,Jacksonboro,511,66,149,69,63,26,373
South Carolina,Converse,737,48,164,108,22,27,369
South Carolina,Cane Savannah,1035,77,367,186,70,32,732
South Carolina,Bishopville,3122,449,970,432,154,67,2072
South Carolina,Gifford,287,18,119,48,0,3,188
South Carolina,Hampton,2608,353,702,558,197,96,1906
South Carolina,Arial,2030,287,391,484,131,141,1434
South Carolina,Five Forks,18004,232,1191,2811,4183,2568,10985
South Carolina,Parker,12850,3310,2685,1506,848,292,8641
South Carolina,Lydia,499,124,243,48,0,0,415
South Carolina,Kingstree,3122,301,614,782,272,121,2090
South Carolina,Campobello,468,63,123,119,33,22,360
South Carolina,Duncan,3375,233,845,650,206,82,2016
South Carolina,Greer,29717,2736,4354,5954,4283,2242,19569
South Carolina,Inman,2694,450,588,620,145,109,1912
South Carolina,Roebuck,2352,204,701,499,201,94,1699
South Carolina,Landrum,2534,218,571,575,254,152,1770
South Carolina,Varnville,1877,126,609,332,180,74,1321
South Carolina,Mayo,1416,93,399,380,126,0,998
South Carolina,Elgin,3610,235,1585,561,189,76,2646
South Carolina,Eastover,800,143,168,125,3,31,470
South Carolina,East Sumter,1172,211,268,315,72,7,873
South Carolina,Mayesville,523,50,119,125,63,32,389
South Carolina,Whitmire,1561,229,343,268,83,71,994
South Carolina,Westminster,2512,355,551,613,112,91,1722
South Carolina,Columbia,133352,8447,15407,19656,18096,14529,76135
South Carolina,Tatum,79,2,37,21,5,1,66
South Carolina,Pinewood,492,51,104,80,35,25,295
South Carolina,Shiloh,211,51,85,0,5,5,146
South Carolina,Blacksburg,2008,327,442,247,59,54,1129
South Carolina,Estill,2856,358,966,328,182,30,1864
South Carolina,Reidville,869,61,152,137,165,54,569
South Carolina,Piedmont,6401,1071,1714,1091,373,215,4464
South Carolina,Rockville,120,0,19,34,44,9,106
South Carolina,Pinopolis,1247,15,111,408,305,259,1098
South Carolina,Gayle Mill,1075,207,320,146,7,0,680
South Carolina,Heath Springs,640,78,181,129,27,6,421
South Carolina,Central,5241,366,866,832,496,308,2868
South Carolina,Holly Hill,1359,237,364,181,101,58,941
South Carolina,Neeses,281,37,59,61,21,9,187
South Carolina,Woodruff,4164,727,899,790,329,192,2937
South Carolina,North,664,101,154,194,32,19,500
South Carolina,Vance,92,28,20,19,2,0,69
South Carolina,Rowesville,267,55,47,70,23,14,209
South Carolina,Ridgeland,3948,440,958,824,237,109,2568
South Carolina,Furman,250,60,78,32,10,5,185
South Carolina,Lyman,3481,215,741,1080,340,161,2537
South Carolina,Turbeville,1002,146,259,160,47,52,664
South Carolina,Troy,102,2,43,28,5,6,84
South Carolina,Springdale,2733,199,733,606,347,128,2013
South Carolina,West Columbia,17296,1639,3553,4003,2290,1462,12947
South Carolina,Beaufort,13336,699,2045,2940,1609,1190,8483
South Carolina,Elko,182,29,43,32,6,12,122
South Carolina,Red Bank,9623,831,2222,2448,855,446,6802
South Carolina,Cayce,13621,752,2104,3185,1879,1048,8968
South Carolina,Joanna,1329,287,422,240,59,30,1038
South Carolina,Rock Hill,71903,5438,11610,15004,8692,4653,45397
South Carolina,Gilbert,733,43,146,148,75,25,437
South Carolina,Greenwood,23230,3059,4515,3911,1967,915,14367
South Carolina,Jamestown,71,3,23,15,19,4,64
South Carolina,Swansea,880,105,231,203,43,19,601
South Carolina,Lowrys,245,26,45,53,9,29,162
South Carolina,Springfield,539,66,132,112,39,37,386
South Carolina,Orangeburg,13120,867,1561,3056,1386,693,7563
South Carolina,Eutawville,249,45,101,44,13,7,210
South Carolina,Edisto,2290,399,422,268,139,165,1393
South Carolina,Fairfax,2093,232,657,277,168,26,1360
South Carolina,Ninety Six,1839,163,352,444,118,116,1193
South Carolina,Newry,140,77,28,35,0,0,140
South Carolina,Jenkinsville,73,16,24,17,0,0,57
South Carolina,Chesnee,664,150,189,143,49,10,541
South Carolina,Stateburg,1611,44,285,260,290,192,1071
South Carolina,Fountain Inn,8684,784,1707,1711,869,414,5485
South Carolina,Aynor,721,67,170,160,59,46,502
South Carolina,Salley,245,27,71,49,21,20,188
South Carolina,Jonesville,678,127,227,98,29,26,507
South Carolina,Judson,1777,520,326,210,73,14,1143
South Carolina,Garden City,10070,625,2849,3277,1280,591,8622
South Carolina,Harleyville,802,77,237,148,41,26,529
South Carolina,Honea Path,3687,335,615,1056,355,93,2454
South Carolina,Calhoun Falls,1924,288,600,370,79,40,1377
South Carolina,Utica,1501,235,277,303,64,24,903
South Carolina,Bowman,705,118,233,122,67,23,563
South Carolina,Greenville,65727,4443,7778,10785,12908,8626,44540
South Carolina,Rembert,229,42,39,88,7,0,176
South Carolina,Lamar,983,157,251,193,70,27,698
South Carolina,Cheraw,5701,881,1170,928,380,133,3492
South Carolina,Promised Land,432,176,149,75,0,12,412
South Carolina,Pickens,3153,495,754,661,195,71,2176
South Carolina,Riverview,833,62,171,158,136,51,578
South Carolina,Union,7878,990,1881,1510,578,305,5264
South Carolina,Andrews,2981,212,781,635,130,50,1808
South Carolina,Barnwell,4502,555,1099,963,122,180,2919
South Carolina,Snelling,267,46,54,55,16,14,185
South Carolina,Mount Carmel,255,73,112,39,15,0,239
South Carolina,Williston,2995,368,646,565,70,71,1720
South Carolina,Moncks Corner,10169,760,2078,2566,668,498,6570
South Carolina,Edisto Beach,574,9,72,146,197,133,557
South Carolina,Abbeville,5079,909,1093,851,403,101,3357
South Carolina,Little Mountain,225,8,31,55,34,24,152
South Carolina,Lynchburg,361,33,117,68,10,22,250
South Carolina,St. Stephen,1787,197,540,328,74,27,1166
South Carolina,Modoc,202,14,70,29,25,38,176
South Carolina,Six Mile,872,49,140,205,95,97,586
South Carolina,Easley,20784,2261,4303,4432,2474,1338,14808
South Carolina,City View,1448,480,170,317,44,0,1011
South Carolina,Taylors,21923,1123,3990,5759,3066,1638,15576
South Carolina,Welcome,7394,1503,1941,1175,283,56,4958
South Carolina,Branchville,1132,100,303,268,44,27,742
South Carolina,Cowpens,1782,232,284,415,229,63,1223
South Carolina,Pacolet,2456,339,691,561,79,53,1723
South Carolina,Watts Mills,1384,273,360,253,0,0,886
South Carolina,Simpsonville,21423,986,3712,4761,3240,1779,14478
South Carolina,Walhalla,4293,958,1145,742,170,96,3111
South Carolina,Paxville,474,56,104,147,26,11,344
South Carolina,Summerton,997,120,334,157,70,54,735
South Carolina,McClellanville,545,9,73,125,123,75,405
South Carolina,Central Pacolet,138,30,57,17,2,2,108
South Carolina,Inman Mills,1306,172,364,176,93,7,812
South Carolina,Saxon,3710,638,678,572,129,24,2041
South Carolina,Stuckey,215,13,73,52,10,25,173
South Carolina,Cross Hill,572,89,208,62,18,3,380
South Carolina,Mauldin,25009,1043,4416,5993,3879,2139,17470
South Carolina,Forestbrook,5682,222,1162,1594,869,314,4161
South Carolina,Kiawah Island,1525,0,69,215,629,596,1509
South Carolina,North Charleston,109886,11348,22092,21905,11049,4567,70961
South Carolina,Ravenel,2655,437,836,433,182,139,2027
South Carolina,Ridgeville,2135,616,731,288,108,22,1765
South Carolina,Anderson,27129,3144,5010,5557,2725,1376,17812
South Carolina,Centerville,7303,591,1333,2160,645,394,5123
South Carolina,North Myrtle Beach,15862,988,3410,4441,3106,1703,13648
South Carolina,Northlake,3793,130,877,896,460,582,2945
South Carolina,Bamberg,3317,412,539,556,308,303,2118
South Carolina,Olar,183,32,69,29,16,3,149
South Carolina,Laurel Bay,6470,332,1021,1333,196,193,3075
South Carolina,Port Royal,12446,382,1501,2399,1187,723,6192
South Carolina,Trenton,316,25,66,57,35,15,198
South Carolina,Briarcliffe Acres,547,7,40,97,156,144,444
South Carolina,Williams,164,21,30,29,12,16,108
South Carolina,Sullivan's Island,2148,12,77,225,652,589,1555
South Carolina,Wagener,889,88,212,201,80,27,608
South Carolina,Georgetown,8936,695,2098,2241,670,318,6022
South Carolina,Norris,856,109,177,150,62,26,524
South Carolina,Cordova,240,8,17,86,12,11,134
South Carolina,Greeleyville,398,40,140,97,30,6,313
South Carolina,Hemingway,562,40,138,81,74,35,368
South Carolina,Southern Shops,3667,882,668,470,113,17,2150
South Carolina,West Union,313,55,74,49,8,7,193
South Carolina,Travelers Rest,5063,259,753,1351,359,378,3100
South Carolina,Dentsville,14887,1063,2500,3634,1338,838,9373
South Carolina,Peak,51,1,12,9,8,12,42
South Carolina,Dalzell,3795,236,941,876,252,33,2338
South Carolina,Privateer,1939,338,599,483,130,29,1579
South Carolina,Sans Souci,8776,1656,1557,1716,693,402,6024
South Carolina,Sumter,39964,3527,6283,8639,3566,2518,24533
South Carolina,Latta,1377,185,352,207,115,80,939
South Carolina,Lake Murray of Richland,6427,204,598,1268,1720,1112,4902
South Carolina,Lake Wylie,12569,241,1485,2389,2982,1396,8493
South Carolina,Santee,1003,104,317,190,35,92,738
South Carolina,Reevesville,260,29,38,57,23,13,160
South Carolina,Elgin,1705,144,429,271,171,73,1088
South Carolina,Red Hill,15459,889,4045,3232,1674,740,10580
South Carolina,Monarch Mill,1416,250,529,261,11,43,1094
South Carolina,Lake City,6658,1239,1278,1041,440,215,4213
South Carolina,Scranton,786,125,244,210,26,13,618
South Carolina,Loris,2625,394,818,492,179,108,1991
South Carolina,Coronaca,146,0,22,28,30,0,80
South Carolina,Batesburg-Leesville,5424,676,1496,876,276,234,3558
South Carolina,Florence,37802,2749,7664,7393,4606,3158,25570
South Carolina,Olanta,561,91,142,97,28,6,364
South Carolina,Conway,22661,1391,4352,5120,1635,1382,13880
South Carolina,Myrtle Beach,31783,2592,6760,7411,4478,2126,23367
South Carolina,Surfside Beach,4312,298,1038,1175,630,535,3676
South Carolina,Meggett,1211,71,248,323,239,113,994
South Carolina,Winnsboro Mills,1944,606,562,209,100,15,1492
South Carolina,Perry,197,21,58,21,8,2,110
South Carolina,St. George,2581,379,370,574,169,49,1541
South Carolina,Chester,5433,878,1441,851,324,200,3694
South Carolina,Sharon,480,47,119,110,40,8,324
South Carolina,Allendale,3072,623,774,400,118,45,1960
South Carolina,Sycamore,144,14,34,66,8,0,122
South Carolina,Ulmer,37,6,3,9,2,2,22
South Carolina,Hilda,448,73,157,68,22,1,321
South Carolina,Bonneau,668,49,158,118,53,6,384
South Carolina,Richburg,405,41,90,60,23,18,232
South Carolina,Darlington,6034,911,1270,1250,662,308,4401
South Carolina,Awendaw,1308,127,345,263,178,47,960
South Carolina,Cokesbury,306,26,31,64,7,30,158
South Carolina,Summit,568,36,104,117,68,23,348
South Carolina,Homeland Park,6157,1270,1669,1191,14,39,4183
South Carolina,Valley Falls,6522,290,1077,1254,499,329,3449
South Carolina,Princeton,33,0,0,18,0,0,18
South Carolina,Aiken,30464,1901,5078,5477,5590,4234,22280
South Carolina,Fort Mill,15924,645,1984,2904,3196,1303,10032
South Carolina,Arcadia Lakes,741,11,74,128,231,200,644
South Carolina,St. Andrews,21494,1316,3738,5070,2143,1208,13475
South Carolina,Prosperity,1281,207,288,237,108,50,890
South Carolina,Clearwater,4319,498,1177,674,136,55,2540
South Carolina,Silverstreet,146,11,37,48,14,9,119
South Carolina,Lake Secession,1050,239,292,328,67,67,993
South Carolina,Clinton,8508,999,1997,1300,618,496,5410
South Carolina,Lancaster,9150,1353,1776,1878,635,343,5985
South Carolina,Sellers,200,67,66,22,9,6,170
South Carolina,Hodges,101,5,19,44,9,2,79
South Carolina,Lockhart,440,58,154,45,7,0,264
South Carolina,Ward,139,29,54,29,0,9,121
South Carolina,Folly Beach,2647,48,268,666,928,516,2426
South Carolina,Bucksport,792,63,302,165,41,9,580
South Carolina,Quinby,1233,67,251,292,167,63,840
South Carolina,Coward,711,131,220,87,32,8,478
South Carolina,Pawleys Island,89,0,2,17,38,32,89
South Carolina,Winnsboro,3280,509,837,526,163,94,2129
South Carolina,Ehrhardt,445,69,103,143,11,18,344
South Carolina,Williamston,4130,307,1122,988,146,312,2875
South Carolina,Lincolnville,1280,138,429,243,52,25,887
South Carolina,Antreville,101,9,36,53,0,0,98
South Carolina,Pageland,2684,492,584,383,207,65,1731
South Carolina,Ruby,442,56,103,91,34,26,310
South Carolina,Manning,3984,570,757,808,338,125,2598
South Carolina,Kershaw,2021,199,632,385,122,58,1396
South Carolina,Due West,1361,70,156,140,72,123,561
South Carolina,Mountville,127,0,37,28,18,0,83
South Carolina,Oakland,1140,110,198,326,40,40,714
South Carolina,Lake View,838,113,283,162,62,32,652
South Carolina,Slater-Marietta,2009,516,400,349,94,35,1394
South Carolina,Brookdale,4588,363,836,1081,365,142,2787
South Carolina,Livingston,127,6,22,26,12,4,70
South Carolina,West Pelzer,821,128,255,148,34,7,572
South Carolina,Hilton Head Island,39820,1943,5617,7816,10197,6995,32568
South Carolina,Pamplico,1091,96,284,168,89,32,669
South Carolina,McConnells,263,16,53,50,33,25,177
South Carolina,India Hook,4275,354,518,964,901,516,3253
South Carolina,Hickory Grove,516,92,140,72,31,18,353
South Carolina,Donalds,277,52,70,63,10,8,203
South Carolina,Willington,64,0,0,32,0,0,32
South Carolina,Parksville,218,13,47,56,8,1,125
South Carolina,Johnston,2221,336,769,272,83,75,1535
South Carolina,Warrenville,1004,178,243,252,104,32,809
South Carolina,Ware Place,170,18,84,8,0,0,110
South Carolina,Wallace,695,144,223,95,43,17,522
South Carolina,Tigerville,2016,0,19,33,13,20,85
South Carolina,Sangaree,7760,437,1514,2177,703,364,5195
South Carolina,Russellville,197,8,61,78,0,10,157
South Carolina,Golden Grove,3335,446,674,621,196,358,2295
South Carolina,Dunean,3605,822,801,643,276,64,2606
South Carolina,Gantt,15178,2540,3080,2549,969,553,9691
South Carolina,Brunson,471,26,198,95,34,0,353
South Carolina,Clemson,15966,376,877,1692,1601,2810,7356
South Carolina,Berea,14923,2274,3863,2656,964,359,10116
South Carolina,Wade Hampton,20925,1467,3021,4598,3963,2007,15056
South Carolina,Mullins,4429,879,1051,652,471,99,3152
South Carolina,Gray Court,787,218,174,159,36,6,593
South Carolina,Cope,49,8,6,17,6,7,44
South Carolina,Laurens,8914,1340,1850,1872,698,375,6135
South Carolina,Ware Shoals,2547,372,786,421,145,37,1761
South Carolina,Nichols,262,29,97,36,41,6,209
South Carolina,Elloree,637,60,166,143,75,36,480
South Carolina,Oswego,223,66,90,10,28,0,194
South Carolina,South Sumter,2294,270,577,340,166,59,1412
South Carolina,Seneca,8290,1106,1727,1903,888,487,6111
South Carolina,Blythewood,3148,76,389,481,584,458,1988
South Carolina,Forest Acres,10433,356,729,2162,2333,1860,7440
South Carolina,Irmo,12087,498,1695,3152,1935,1097,8377
South Carolina,Gaffney,12526,1726,2926,1996,807,466,7921
South Carolina,Dillon,6456,1154,1327,1156,250,255,4142
South Carolina,Hardeeville,5836,429,998,1283,1128,580,4418
South Carolina,Yemassee,985,125,210,217,74,34,660
South Carolina,Marion,6548,590,1322,1385,521,338,4156
South Carolina,Ridge Spring,678,97,203,137,51,14,502
South Carolina,Gloverville,2788,550,754,430,160,8,1902
South Carolina,Pendleton,3158,373,437,605,323,272,2010
South Carolina,Starr,141,7,17,59,13,4,100
South Carolina,Monetta,209,29,75,29,20,5,158
South Carolina,Spartanburg,37370,3863,6610,6822,4261,2614,24170
South Carolina,Startex,1437,376,210,199,22,0,807
South Carolina,Belvedere,4925,446,1320,1199,282,141,3388
South Carolina,Springdale,2355,288,878,342,123,0,1631
South Carolina,Waterloo,148,35,26,35,9,5,110
South Carolina,Gaston,1621,159,333,473,116,23,1104
South Carolina,Lexington,21040,1033,3144,4114,3824,2296,14411
South Carolina,Blackville,2027,351,516,327,69,41,1304
South Carolina,Newberry,10289,1458,2485,1526,671,366,6506
South Carolina,Liberty,3185,389,782,506,335,161,2173
South Carolina,Timmonsville,2321,383,686,389,123,4,1585
South Carolina,Johnsonville,1596,133,326,358,146,82,1045
South Carolina,Murrells Inlet,9396,621,2196,2633,1487,814,7751
South Carolina,Murphys Estates,1696,290,440,215,52,115,1112
South Carolina,St. Matthews,2410,245,603,474,265,80,1667
South Carolina,Shell Point,2694,53,634,691,276,202,1856
South Carolina,Burnettown,2718,223,707,446,157,83,1616
South Carolina,Carlisle,455,51,113,116,15,9,304
South Carolina,Seven Oaks,15559,675,2245,3455,2402,1804,10581
South Carolina,Pine Ridge,2171,103,510,594,223,143,1573
South Carolina,Govan,74,15,12,17,11,0,55
South Carolina,Mount Pleasant,83700,1248,7227,14213,23155,14132,59975
South Carolina,Windsor,117,37,20,47,4,2,110
South Carolina,Cherryvale,3202,377,663,561,41,11,1653
South Carolina,Lakewood,2644,391,873,638,71,103,2076
South Carolina,Bennettsville,8308,1857,2085,1171,397,224,5734
South Carolina,Blenheim,231,15,102,50,1,6,174
South Carolina,Pomaria,145,31,42,25,5,2,105
South Carolina,Salem,95,20,25,18,4,1,68
South Carolina,Woodfield,9730,1155,1705,2204,767,526,6357
South Carolina,Oak Grove,10993,902,2463,2873,1100,362,7700
South Carolina,Tega Cay,9954,140,667,1880,2492,1297,6476
South Carolina,Hanahan,22963,1461,3843,4932,3360,1389,14985
South Carolina,Newport,4194,175,747,1057,596,420,2995
South Carolina,Socastee,24056,2599,5194,6261,2328,1003,17385
South Carolina,Isle of Palms,4345,11,413,577,1424,1063,3488
South Carolina,Hartsville,7658,719,1251,1110,793,756,4629
South Carolina,McBee,1002,131,222,210,19,17,599
South Carolina,Ladson,15383,1636,3549,3240,950,483,9858
South Carolina,Fort Lawn,1012,116,235,204,82,35,672
South Dakota,Cow Creek,39,0,0,20,12,0,32
South Dakota,Corn Creek,122,26,24,9,5,0,64
South Dakota,Chester,331,25,79,91,30,6,231
South Dakota,Bath,220,0,65,53,12,14,144
South Dakota,Fruitdale,88,21,21,5,4,5,56
South Dakota,Peever,169,8,47,29,2,4,90
South Dakota,Ortley,47,7,18,7,6,0,38
South Dakota,Fedora,23,0,12,5,5,1,23
South Dakota,Crocker,27,0,27,0,0,0,27
South Dakota,Bijou Hills,0,0,0,0,0,0,0
South Dakota,Bath Corner,74,0,0,0,25,23,48
South Dakota,Blucksberg Mountain,492,0,172,96,85,80,433
South Dakota,Iroquois,369,17,103,74,13,24,231
South Dakota,Harrison,118,2,46,12,15,0,75
South Dakota,Mitchell,15722,900,3136,3801,1872,738,10447
South Dakota,Marty,484,46,69,80,19,0,214
South Dakota,Buffalo,337,11,70,80,77,2,240
South Dakota,La Plant,198,59,27,23,0,0,109
South Dakota,Kranzburg,219,14,60,55,12,0,141
South Dakota,Manderson-White Horse Creek,393,147,62,58,0,0,267
South Dakota,Pringle,156,11,49,39,11,1,111
South Dakota,Fairview,49,1,22,12,6,0,41
South Dakota,Woonsocket,653,26,227,120,60,19,452
South Dakota,Agency Village,305,47,63,49,0,0,159
South Dakota,Brant Lake South,187,29,46,54,24,4,157
South Dakota,Brant Lake,71,0,1,11,16,24,52
South Dakota,Platte,1501,100,416,325,181,29,1051
South Dakota,Rockham,30,2,13,5,0,0,20
South Dakota,Watertown,22124,1249,5202,5124,2552,685,14812
South Dakota,Piedmont,1030,22,267,235,100,43,667
South Dakota,Worthing,1025,36,198,287,121,25,667
South Dakota,Summerset,2412,48,346,546,326,87,1353
South Dakota,Dakota Dunes,3067,60,324,651,399,539,1973
South Dakota,Buffalo Chip,0,0,0,0,0,0,0
South Dakota,Anderson,450,42,68,72,52,23,257
South Dakota,Crooks,1363,40,212,317,212,59,840
South Dakota,Cavour,132,9,39,35,3,0,86
South Dakota,White,580,28,124,120,35,31,338
South Dakota,Sioux Falls,174151,9156,29332,36640,26625,12401,114154
South Dakota,Springfield,2045,215,713,501,135,51,1615
South Dakota,Hitchcock,130,3,27,37,39,10,116
South Dakota,Dimock,174,10,41,40,11,3,105
South Dakota,Bowdle,459,38,105,105,35,12,295
South Dakota,Eden,115,18,37,24,10,9,98
South Dakota,Ree Heights,76,2,37,16,7,0,62
South Dakota,Willow Lake,363,27,69,51,27,15,189
South Dakota,Lennox,2437,119,584,520,205,110,1538
South Dakota,Broadland,27,0,11,4,2,2,19
South Dakota,Wakonda,265,18,74,48,27,17,184
South Dakota,Doland,243,14,75,40,19,4,152
South Dakota,Sinai,91,6,12,24,15,6,63
South Dakota,Canistota,680,76,124,95,36,23,354
South Dakota,Wanblee,940,121,146,105,13,10,395
South Dakota,Kadoka,773,62,184,113,91,48,498
South Dakota,Delmont,242,16,29,66,11,10,132
South Dakota,Hoven,341,42,136,75,16,7,276
South Dakota,Quinn,44,2,15,11,2,0,30
South Dakota,Vivian,115,0,37,30,18,8,93
South Dakota,Lemmon,1265,85,329,328,106,52,900
South Dakota,Frederick,196,21,63,41,25,3,153
South Dakota,Herreid,404,22,134,74,61,6,297
South Dakota,Rosholt,537,29,96,148,54,18,345
South Dakota,Conde,123,33,39,24,14,4,114
South Dakota,Box Elder,9407,209,1447,1895,928,178,4657
South Dakota,Hartford,3145,128,483,636,494,152,1893
South Dakota,Groton,1712,31,368,396,222,60,1077
South Dakota,Warner,413,37,85,95,43,21,281
South Dakota,Westport,105,0,21,41,13,0,75
South Dakota,Lane,78,8,37,13,0,0,58
South Dakota,South Shore,208,20,66,47,17,3,153
South Dakota,Tea,5098,85,505,1111,918,179,2798
South Dakota,Wounded Knee,456,88,44,32,11,0,175
South Dakota,Altamont,33,2,14,7,0,0,23
South Dakota,Toronto,231,7,67,41,22,10,147
South Dakota,Sherman,60,3,16,25,0,1,45
South Dakota,Eagle Butte,1134,106,160,199,77,7,549
South Dakota,Irene,499,30,116,109,35,19,309
South Dakota,Bristol,370,16,125,100,39,9,289
South Dakota,Butler,9,0,7,1,1,0,9
South Dakota,Fairfax,137,9,65,24,17,0,115
South Dakota,Dante,104,6,12,18,14,3,53
South Dakota,Pickstown,225,23,43,51,33,18,168
South Dakota,Reliance,147,10,54,26,13,7,110
South Dakota,Hosmer,275,11,99,53,16,5,184
South Dakota,Ipswich,955,96,263,167,111,59,696
South Dakota,Martin,970,60,186,228,105,26,605
South Dakota,Emery,550,23,121,129,48,18,339
South Dakota,Colton,743,37,227,154,90,13,521
South Dakota,Hillsview,0,0,0,0,0,0,0
South Dakota,Belle Fourche,5610,324,1717,1089,560,148,3838
South Dakota,New Underwood,731,28,175,143,107,31,484
South Dakota,New Effington,219,19,66,66,8,4,163
South Dakota,Wilmot,536,41,129,107,74,17,368
South Dakota,Salem,1393,148,355,248,134,51,936
South Dakota,Gettysburg,1258,63,286,301,151,44,845
South Dakota,Lebanon,23,5,6,3,5,0,19
South Dakota,Beresford,2235,142,489,519,272,105,1527
South Dakota,Antelope,978,139,72,158,20,25,414
South Dakota,Chancellor,298,18,89,59,26,3,195
South Dakota,Ethan,397,19,109,113,12,6,259
South Dakota,Whitewood,1051,85,305,210,91,26,717
South Dakota,Rapid City,73721,3411,13422,17191,10435,5582,50041
South Dakota,Lower Brule,785,89,102,143,12,34,380
South Dakota,Alcester,880,136,215,183,84,38,656
South Dakota,Mission,1231,106,161,220,58,31,576
South Dakota,Glenham,113,9,72,6,7,1,95
South Dakota,Carthage,178,5,40,60,14,4,123
South Dakota,Howard,841,80,239,172,78,30,599
South Dakota,Farmer,1,0,1,0,0,0,1
South Dakota,Mobridge,3422,275,887,707,406,144,2419
South Dakota,Tulare,258,3,61,52,30,2,148
South Dakota,Wood,37,4,13,8,5,7,37
South Dakota,Two Strike,182,32,43,31,0,0,106
South Dakota,Midland,130,14,42,39,0,0,95
South Dakota,Ward,58,0,18,10,4,2,34
South Dakota,Flandreau,2438,239,468,620,250,74,1651
South Dakota,Alpena,313,47,92,61,28,11,239
South Dakota,New Witten,54,9,22,8,8,0,47
South Dakota,Porcupine,1517,145,131,297,31,0,604
South Dakota,Armour,828,62,150,253,65,43,573
South Dakota,Oelrichs,100,8,32,28,12,2,82
South Dakota,Nisland,340,56,71,98,18,0,243
South Dakota,Camp Crook,58,0,25,17,7,4,53
South Dakota,Dallas,70,22,28,18,0,0,68
South Dakota,Timber Lake,579,34,134,99,63,14,344
South Dakota,Fairburn,96,8,45,16,14,4,87
South Dakota,Stockholm,131,5,39,14,9,7,74
South Dakota,Little Eagle,278,40,39,37,11,0,127
South Dakota,Lesterville,118,15,31,39,3,2,90
South Dakota,Parkston,1649,132,300,421,193,73,1119
South Dakota,Menno,713,98,157,171,77,36,539
South Dakota,Newell,804,57,281,154,70,7,569
South Dakota,Valley Springs,757,27,180,211,64,31,513
South Dakota,Milbank,3210,182,949,733,256,116,2236
South Dakota,Tolstoy,30,5,13,11,1,0,30
South Dakota,Britton,1792,52,354,438,145,58,1047
South Dakota,Veblen,570,62,119,58,48,13,300
South Dakota,Lowry,7,3,1,3,0,0,7
South Dakota,Fort Thompson,1260,130,231,216,29,9,615
South Dakota,Tyndall,1167,126,276,257,74,41,774
South Dakota,Highmore,798,41,319,159,89,19,627
South Dakota,Okaton,6,0,6,0,0,0,6
South Dakota,Lead,2998,247,732,687,493,91,2250
South Dakota,Estelline,854,52,245,156,88,27,568
South Dakota,Belvidere,99,4,19,34,16,2,75
South Dakota,Canova,85,6,28,27,4,3,68
South Dakota,Lake City,61,6,10,29,5,3,53
South Dakota,Claremont,63,4,18,22,4,3,51
South Dakota,Fulton,132,2,44,24,15,11,96
South Dakota,Naples,18,3,7,0,0,0,10
South Dakota,Herrick,113,11,26,27,5,3,72
South Dakota,Burke,605,31,146,136,116,26,455
South Dakota,Twin Brooks,44,4,19,10,1,1,35
South Dakota,La Bolt,94,3,31,29,14,0,77
South Dakota,Whitehorse,178,17,34,12,6,0,69
South Dakota,Webster,1730,159,467,377,181,71,1255
South Dakota,Custer,2113,105,579,593,341,110,1728
South Dakota,Verdon,3,0,3,0,0,0,3
South Dakota,White Rock,4,0,4,0,0,0,4
South Dakota,Andover,110,15,25,32,18,4,94
South Dakota,Wasta,133,6,41,35,11,0,93
South Dakota,Faith,360,12,118,60,31,11,232
South Dakota,Oglala,1548,132,199,346,46,12,735
South Dakota,Kyle,966,105,94,136,9,22,366
South Dakota,McLaughlin,482,33,71,98,52,17,271
South Dakota,Bradley,75,10,30,12,6,0,58
South Dakota,Strandburg,70,7,17,15,0,2,41
South Dakota,Albee,4,2,1,1,0,0,4
South Dakota,Isabel,168,8,39,33,11,7,98
South Dakota,Waubay,498,46,132,100,41,19,338
South Dakota,Roslyn,251,19,83,57,31,9,199
South Dakota,Pierpont,154,5,62,40,13,2,122
South Dakota,Dupree,535,72,92,98,39,21,322
South Dakota,Clear Lake,1319,122,340,308,176,49,995
South Dakota,Langford,418,35,78,96,50,10,269
South Dakota,Colome,370,10,86,38,43,12,189
South Dakota,Pine Ridge,3711,517,560,706,156,21,1960
South Dakota,Harrisburg,5760,115,512,1230,1131,346,3334
South Dakota,Brookings,23863,507,3055,2878,2974,1986,11400
South Dakota,Elkton,727,57,181,143,54,25,460
South Dakota,Utica,97,15,25,20,0,4,64
South Dakota,Olivet,71,4,12,16,5,1,38
South Dakota,Tripp,676,121,152,120,62,18,473
South Dakota,Chamberlain,2486,116,528,615,291,182,1732
South Dakota,Trent,274,2,87,104,18,0,211
South Dakota,Gayville,384,9,102,97,50,10,268
South Dakota,Tabor,477,24,103,115,42,15,299
South Dakota,Pukwana,271,26,83,52,30,9,200
South Dakota,Blackhawk,3148,179,698,813,435,155,2280
South Dakota,Hudson,349,25,133,84,16,4,262
South Dakota,Wallace,109,3,20,28,12,0,63
South Dakota,Canton,3392,180,744,949,381,70,2324
South Dakota,Central City,131,20,44,17,20,0,101
South Dakota,Philip,840,51,300,157,84,30,622
South Dakota,Miller,1433,92,323,359,158,83,1015
South Dakota,Freeman,1408,142,310,255,168,74,949
South Dakota,Ramona,200,25,65,34,25,5,154
South Dakota,Brentford,69,5,14,14,8,0,41
South Dakota,Oacoma,418,29,147,60,40,22,298
South Dakota,Presho,507,15,179,125,57,17,393
South Dakota,Hetland,11,3,6,0,0,0,9
South Dakota,Jefferson,616,32,144,177,55,13,421
South Dakota,Lake Norden,436,44,140,81,27,12,304
South Dakota,Parmelee,619,108,66,108,0,0,282
South Dakota,Baltic,1069,31,211,246,154,47,689
South Dakota,Aurora Center,79,7,5,14,5,6,37
South Dakota,Long Lake,37,3,13,10,4,0,30
South Dakota,Marion,799,31,183,308,70,25,617
South Dakota,Kennebec,352,19,129,45,32,17,242
South Dakota,Plankinton,660,80,143,150,36,35,444
South Dakota,Java,152,5,49,24,15,8,101
South Dakota,Aurora,736,11,123,188,121,14,457
South Dakota,Castlewood,661,14,164,142,53,14,387
South Dakota,Badger,81,9,24,27,2,1,63
South Dakota,Sisseton,2486,295,487,574,167,109,1632
South Dakota,Clark,1448,96,413,304,150,27,990
South Dakota,White Lake,459,34,107,101,43,6,291
South Dakota,Leola,433,41,80,109,38,6,274
South Dakota,Viborg,868,60,205,217,93,39,614
South Dakota,Alexandria,743,39,154,140,70,13,416
South Dakota,Cottonwood,6,0,2,0,4,0,6
South Dakota,Eureka,979,187,258,210,92,37,784
South Dakota,Centerville,905,40,211,233,100,36,620
South Dakota,Monroe,166,22,34,28,8,4,96
South Dakota,Stickney,318,23,83,68,26,12,212
South Dakota,Cresbard,90,0,15,41,13,7,76
South Dakota,Onaka,6,0,2,0,4,0,6
South Dakota,Orient,56,6,26,9,0,0,41
South Dakota,Wetonka,12,0,0,3,5,0,8
South Dakota,Columbia,123,11,28,43,9,7,98
South Dakota,Dell Rapids,3669,104,666,883,503,255,2411
South Dakota,Brandon,9867,97,1317,2357,1638,656,6065
South Dakota,Renner Corner,357,30,100,85,50,26,291
South Dakota,Richland,124,11,35,19,11,0,76
South Dakota,Running Water,31,0,8,0,14,0,22
South Dakota,Shindler,825,29,159,137,156,45,526
South Dakota,Soldier Creek,269,56,43,9,16,0,124
South Dakota,Vale,101,3,67,4,9,0,83
South Dakota,St. Onge,122,0,122,0,0,0,122
South Dakota,Waverly,47,0,25,0,0,0,25
South Dakota,Caputa,0,0,0,0,0,0,0
South Dakota,Roswell,2,0,2,0,0,0,2
South Dakota,Kimball,572,56,135,134,50,7,382
South Dakota,Deadwood,1463,121,408,397,183,73,1182
South Dakota,Ravinia,88,6,22,12,0,2,42
South Dakota,Morristown,42,1,11,12,4,0,28
South Dakota,Winfred,88,18,52,5,0,0,75
South Dakota,Henry,316,16,108,70,15,0,209
South Dakota,Prairie City,5,0,0,2,2,0,4
South Dakota,Ola,0,0,0,0,0,0,0
South Dakota,Ferney,60,0,51,0,9,0,60
South Dakota,Forestburg,119,0,27,13,16,7,63
South Dakota,Gann Valley,16,0,2,14,0,0,16
South Dakota,Goodwill,934,67,149,154,10,0,380
South Dakota,Johnson Siding,542,10,172,170,81,44,477
South Dakota,Kidder,0,0,0,0,0,0,0
South Dakota,Pine Lakes Addition,313,7,41,78,86,11,223
South Dakota,Lake Madison,905,38,213,197,208,178,834
South Dakota,Long Hollow,198,0,28,32,0,0,60
South Dakota,Mansfield,141,12,21,20,18,0,71
South Dakota,Meadow View Addition,515,61,160,110,60,20,411
South Dakota,Morningside,167,22,87,11,0,0,120
South Dakota,Norris,232,33,52,21,0,3,109
South Dakota,Okreek,304,11,24,49,35,15,134
South Dakota,Lake Poinsett,468,12,89,112,113,47,373
South Dakota,Harrold,81,14,31,17,4,1,67
South Dakota,Astoria,156,6,56,31,6,3,102
South Dakota,Buffalo Gap,88,10,33,25,8,4,80
South Dakota,Winner,2839,209,770,669,359,123,2130
South Dakota,Raymond,47,13,19,6,7,0,45
South Dakota,Geddes,262,12,90,45,26,3,176
South Dakota,Vermillion,10700,164,840,1014,1308,1342,4668
South Dakota,Colman,639,20,133,151,80,7,391
South Dakota,Bullhead,362,66,55,31,12,0,164
South Dakota,Batesland,72,4,8,21,13,4,50
South Dakota,Wessington Springs,844,77,313,179,91,30,690
South Dakota,Artesian,255,42,67,36,21,5,171
South Dakota,Artas,29,5,4,0,20,0,29
South Dakota,Draper,77,9,41,6,5,0,61
South Dakota,Spearfish,11393,334,2040,2188,1847,949,7358
South Dakota,Keystone,435,15,104,78,47,9,253
South Dakota,Huron,13291,1498,2977,2649,1159,429,8712
South Dakota,Sturgis,6772,430,1694,1482,853,274,4733
South Dakota,Brandt,107,14,36,10,13,0,73
South Dakota,Florence,376,8,81,122,31,1,243
South Dakota,Aberdeen,28124,1357,5489,6004,3812,1493,18155
South Dakota,Hermosa,417,32,109,84,60,16,301
South Dakota,Green Grass,15,4,0,0,0,0,4
South Dakota,North Eagle Butte,2191,166,399,310,135,38,1048
South Dakota,Big Stone City,597,61,199,135,44,14,453
South Dakota,Bonesteel,441,22,92,88,53,15,270
South Dakota,St. Charles,4,0,0,4,0,0,4
South Dakota,Davis,70,8,19,19,7,1,54
South Dakota,Vienna,86,0,7,11,8,0,26
South Dakota,St. Lawrence,202,7,60,48,7,0,122
South Dakota,Kaylor,28,0,28,0,0,0,28
South Dakota,Yankton,14577,956,3127,2785,1962,1225,10055
South Dakota,Pollock,189,14,89,44,19,6,172
South Dakota,Faulkton,919,40,206,176,125,59,606
South Dakota,Spencer,147,9,79,17,3,1,109
South Dakota,Lake Andes,871,77,177,128,70,31,483
South Dakota,Dolton,54,6,16,10,0,0,32
South Dakota,Milltown,23,5,5,0,7,6,23
South Dakota,Storla,32,0,5,14,0,0,19
South Dakota,McIntosh,191,16,50,29,20,10,125
South Dakota,Hazel,113,4,31,20,3,0,58
South Dakota,Arlington,1048,75,274,116,165,47,677
South Dakota,Bancroft,20,0,4,5,5,0,14
South Dakota,Onida,601,28,132,139,87,22,408
South Dakota,Northville,130,0,17,16,31,5,69
South Dakota,Turton,59,4,0,20,9,0,33
South Dakota,Mount Vernon,547,22,106,140,48,6,322
South Dakota,Bushnell,92,5,28,12,22,1,68
South Dakota,Avon,654,36,143,128,73,31,411
South Dakota,Scotland,710,93,160,130,122,52,557
South Dakota,North Spearfish,2339,71,628,394,445,101,1639
South Dakota,Ashland Heights,796,35,239,249,68,14,605
South Dakota,Claire City,78,2,27,10,14,2,55
South Dakota,Corona,76,8,35,2,12,0,57
South Dakota,Summit,382,37,59,62,21,8,187
South Dakota,Pierre,13988,806,2722,2702,2521,1065,9816
South Dakota,White Horse,153,38,56,11,0,0,105
South Dakota,Grenville,57,8,12,12,12,7,51
South Dakota,Letcher,240,5,43,66,15,10,139
South Dakota,Goodwin,114,11,49,22,6,4,92
South Dakota,Gregory,1467,126,330,383,144,58,1041
South Dakota,Seneca,26,0,2,12,7,2,23
South Dakota,Bruce,153,16,51,30,21,3,121
South Dakota,Allen,450,72,31,13,0,0,116
South Dakota,Yale,108,6,37,30,8,0,81
South Dakota,Virgil,16,0,8,4,1,2,15
South Dakota,Parker,915,35,218,236,90,58,637
South Dakota,Bridgewater,383,45,97,79,51,0,272
South Dakota,Montrose,581,37,107,94,61,18,317
South Dakota,White River,587,49,148,130,36,10,373
South Dakota,Elk Point,2168,115,400,473,272,166,1426
South Dakota,New Holland,21,0,21,0,0,0,21
South Dakota,Mound City,56,18,25,6,2,3,54
South Dakota,Volin,189,12,59,38,3,2,114
South Dakota,Hot Springs,3515,226,883,1154,418,133,2814
South Dakota,Colonial Pine Hills,2146,73,197,477,493,297,1537
South Dakota,Oldham,153,8,39,33,18,0,98
South Dakota,Chelsea,39,0,10,10,5,2,27
South Dakota,Green Valley,946,13,218,332,158,18,739
South Dakota,Wall,729,13,116,243,61,53,486
South Dakota,Madison,7203,460,1842,944,1015,306,4567
South Dakota,Nunda,52,4,11,2,11,6,34
South Dakota,Wolsey,450,19,116,114,44,11,304
South Dakota,Volga,1799,30,324,366,234,67,1021
South Dakota,Stratford,50,1,16,12,9,0,38
South Dakota,Wagner,1525,111,353,297,132,61,954
South Dakota,Egan,336,20,79,98,17,8,222
South Dakota,Hamill,0,0,0,0,0,0,0
South Dakota,Garden City,71,1,6,24,6,0,37
South Dakota,Gary,300,21,135,44,16,8,224
South Dakota,Hill City,876,60,196,178,126,37,597
South Dakota,Bison,302,10,69,92,23,14,208
South Dakota,Marvin,34,3,16,15,0,0,34
South Dakota,Corsica,614,130,158,129,39,38,494
South Dakota,Redfield,2582,137,820,550,256,107,1870
South Dakota,Frankfort,94,10,39,18,7,0,74
South Dakota,Wentworth,196,10,92,24,37,4,167
South Dakota,Erwin,41,2,17,7,6,0,32
South Dakota,De Smet,1109,79,292,282,112,47,812
South Dakota,Blunt,413,44,112,52,23,5,236
South Dakota,North Sioux City,2781,278,657,539,279,134,1887
South Dakota,Rosebud,1715,168,220,274,46,38,746
South Dakota,St. Francis,615,67,104,112,31,13,327
South Dakota,Humboldt,784,34,196,168,76,30,504
South Dakota,Spring Creek,303,56,44,20,0,0,120
South Dakota,Interior,75,3,38,6,10,0,57
South Dakota,Selby,629,65,210,110,65,3,453
South Dakota,Bryant,534,46,159,67,24,3,299
South Dakota,Hayti,453,14,137,73,21,9,254
South Dakota,Lake Preston,504,37,163,130,44,20,394
South Dakota,Rapid Valley,9475,353,2250,2555,687,306,6151
South Dakota,Agar,73,0,30,17,7,0,54
South Dakota,Murdo,389,22,114,101,50,29,316
South Dakota,Garretson,1214,31,280,316,109,63,799
South Dakota,Akaska,44,4,27,7,3,0,41
South Dakota,Vilas,15,0,5,3,1,1,10
South Dakota,Mellette,188,2,42,64,19,2,129
South Dakota,Roscoe,341,25,91,60,51,7,234
South Dakota,Edgemont,750,71,221,145,46,12,495
South Dakota,Fort Pierre,2297,100,473,497,263,251,1584
South Dakota,Hecla,221,6,81,65,12,8,172
South Dakota,Revillo,94,7,37,16,2,2,64
South Dakota,Ashton,137,7,43,27,12,0,89
South Dakota,Hurley,361,5,92,119,36,9,261
South Dakota,Loomis,0,0,0,0,0,0,0
South Dakota,Mission Hill,218,11,73,43,10,7,144
South Dakota,Wessington,310,23,91,44,12,11,181
South Dakota,Lily,2,0,0,2,0,0,2
Tennessee,Millington,10720,1015,2556,2736,716,676,7699
Tennessee,Halls,2231,345,548,242,75,97,1307
Tennessee,Hendersonville,56421,2179,9968,13135,9342,4519,39143
Tennessee,Loretto,1838,241,537,371,117,75,1341
Tennessee,New Market,1471,187,363,256,112,102,1020
Tennessee,Middleton,660,16,253,99,55,11,434
Tennessee,Grand Junction,329,26,98,75,19,14,232
Tennessee,Bolivar,5002,594,1712,723,279,215,3523
Tennessee,Winchester,8578,815,2178,1734,953,534,6214
Tennessee,Alamo,2241,347,612,385,135,99,1578
Tennessee,Trezevant,775,125,231,148,50,13,567
Tennessee,Brentwood,41987,469,2192,4169,11532,8241,26603
Tennessee,Pine Crest,2412,180,467,535,351,173,1706
Tennessee,Central,2350,407,739,364,190,112,1812
Tennessee,Dowelltown,334,41,121,47,25,6,240
Tennessee,Charleston,844,67,234,201,36,21,559
Tennessee,Lebanon,31592,2677,7122,5733,3326,1725,20583
Tennessee,East Cleveland,1682,385,306,337,11,30,1069
Tennessee,Rutherford,1146,148,386,138,17,30,719
Tennessee,Braden,268,32,88,58,30,9,217
Tennessee,Portland,12539,1198,3250,2692,588,250,7978
Tennessee,New Johnsonville,2107,135,720,337,115,63,1370
Tennessee,Yorkville,249,18,67,49,34,15,183
Tennessee,Dandridge,3091,388,766,655,277,214,2300
Tennessee,White Pine,2135,330,563,396,98,31,1418
Tennessee,Gallatin,36139,3126,7483,7766,4344,2203,24922
Tennessee,Westmoreland,2603,290,830,359,99,30,1608
Tennessee,Pleasant Hill,426,85,68,59,70,81,363
Tennessee,Liberty,358,48,134,41,22,4,249
Tennessee,Baileyton,527,70,185,95,28,15,393
Tennessee,Mount Carmel,5327,300,1637,1096,509,146,3688
Tennessee,Murfreesboro,130968,5638,17544,23396,21368,10318,78264
Tennessee,Clarksville,150602,6774,25574,34689,16556,7604,91197
Tennessee,Greenback,1263,78,332,270,75,25,780
Tennessee,Cleveland,43924,4357,8290,8358,4121,2890,28016
Tennessee,Palmer,674,161,211,90,19,0,481
Tennessee,Huntland,821,107,244,172,51,14,588
Tennessee,Charlotte,1674,446,514,219,46,6,1231
Tennessee,Bells,2777,380,715,421,107,52,1675
Tennessee,Somerville,3139,538,769,395,262,159,2123
Tennessee,La Grange,94,8,31,30,8,13,90
Tennessee,Spring Hill,37830,663,3467,8249,7538,2981,22898
Tennessee,Fairview,8599,760,1505,1772,957,451,5445
Tennessee,Centertown,350,18,136,60,16,10,240
Tennessee,Brownsville,9715,1128,2695,1692,524,363,6402
Tennessee,Walden,1828,79,183,307,373,398,1340
Tennessee,Lakesite,2004,94,366,516,395,146,1517
Tennessee,Toone,390,55,126,60,7,4,252
Tennessee,Gruetli-Laager,2388,375,736,289,58,7,1465
Tennessee,Rutledge,1565,352,452,285,65,26,1180
Tennessee,Blaine,2053,176,586,356,139,46,1303
Tennessee,Parrottsville,289,36,83,51,12,2,184
Tennessee,Camden,3549,536,952,701,227,198,2614
Tennessee,Troy,1644,244,432,256,148,31,1111
Tennessee,Adamsville,2192,340,630,314,186,76,1546
Tennessee,Mount Pleasant,4810,552,1076,1100,384,200,3312
Tennessee,Banner Hill,1455,126,551,316,128,0,1121
Tennessee,Hopewell,1888,189,354,391,253,208,1395
Tennessee,South Cleveland,8069,813,2259,1182,878,273,5405
Tennessee,Elkton,485,46,208,47,52,22,375
Tennessee,Jamestown,2010,442,598,266,46,12,1364
Tennessee,White Bluff,3449,638,862,634,132,177,2443
Tennessee,Enville,209,30,64,39,18,5,156
Tennessee,Gatlinburg,4150,351,976,1101,407,178,3013
Tennessee,Mascot,2361,207,508,610,92,41,1458
Tennessee,Saltillo,542,81,200,129,28,14,452
Tennessee,Linden,936,141,304,200,24,25,694
Tennessee,Niota,1018,164,318,141,41,24,688
Tennessee,Baxter,1536,213,435,254,52,32,986
Tennessee,Pittman Center,627,70,126,167,65,24,452
Tennessee,Cross Plains,1769,144,572,321,105,48,1190
Tennessee,Rogersville,4341,538,1081,799,326,252,2996
Tennessee,Greeneville,14896,1829,3818,2817,1409,758,10631
Tennessee,Pleasant View,4360,303,909,807,506,348,2873
Tennessee,Puryear,720,85,275,124,29,21,534
Tennessee,Henry,624,65,207,50,15,13,350
Tennessee,Dunlap,5083,987,1455,846,222,108,3618
Tennessee,Dresden,2957,395,942,531,142,70,2080
Tennessee,Mosheim,2398,278,819,521,92,58,1768
Tennessee,Moscow,668,93,156,91,34,10,384
Tennessee,Hornsby,295,25,82,49,27,3,186
Tennessee,Tullahoma,19669,1434,4376,3993,1986,1103,12892
Tennessee,Friendship,756,111,218,102,41,6,478
Tennessee,Walnut Hill,2286,194,382,757,162,129,1624
Tennessee,Colonial Heights,3642,184,1149,680,457,221,2691
Tennessee,Millersville,6570,627,1401,1912,559,211,4710
Tennessee,McLemoresville,332,22,113,63,13,24,235
Tennessee,Three Way,1618,77,398,377,227,158,1237
Tennessee,Lawrenceburg,10684,1440,3175,2091,505,444,7655
Tennessee,Baneberry,553,18,120,141,98,69,446
Tennessee,Williston,362,52,107,65,17,6,247
Tennessee,Crump,1371,185,559,233,59,21,1057
Tennessee,Piperton,1892,128,380,408,385,196,1497
Tennessee,Celina,1803,297,507,257,73,57,1191
Tennessee,Thompson's Station,4754,115,405,743,1341,431,3035
Tennessee,Sparta,4940,617,1374,908,221,213,3333
Tennessee,McMinnville,13650,2350,3501,1996,697,560,9104
Tennessee,Coalmont,759,124,224,119,18,33,518
Tennessee,Medina,4175,191,575,955,470,227,2418
Tennessee,Bradford,1150,134,294,221,50,28,727
Tennessee,Dyer,2446,273,795,344,121,127,1660
Tennessee,Gibson,367,35,88,71,21,9,224
Tennessee,Milan,7703,921,2074,1510,617,283,5405
Tennessee,Gallaway,710,144,200,66,24,27,461
Tennessee,New Hope,831,134,212,191,28,14,579
Tennessee,Memphis,653248,62091,128072,121099,64720,42941,418923
Tennessee,Manchester,10561,1166,2547,2060,906,606,7285
Tennessee,Lenoir City,9122,1332,2145,1284,705,332,5798
Tennessee,Hohenwald,3657,491,847,765,145,75,2323
Tennessee,Smyrna,48361,3001,10266,10727,5446,1873,31313
Tennessee,Rockwood,5419,764,1666,1071,208,259,3968
Tennessee,Oak Ridge,29030,1595,4949,6237,3924,3718,20423
Tennessee,Caryville,2653,305,727,411,193,67,1703
Tennessee,Cumberland Gap,295,13,14,24,50,55,156
Tennessee,Pegram,2469,160,625,559,279,113,1736
Tennessee,Copperhill,504,97,113,114,26,19,369
Tennessee,Benton,1584,283,411,300,47,24,1065
Tennessee,Orme,80,13,27,22,2,3,67
Tennessee,Livingston,4024,727,1068,496,231,144,2666
Tennessee,Lewisburg,11638,1623,3461,1754,462,371,7671
Tennessee,Stantonville,300,38,128,40,16,7,229
Tennessee,Selmer,4422,539,1321,731,202,195,2988
Tennessee,Pigeon Forge,6197,1099,1414,1201,398,321,4433
Tennessee,Ridgetop,2274,120,610,520,241,124,1615
Tennessee,Coopertown,4455,281,1069,983,383,193,2909
Tennessee,Gleason,1462,150,491,179,132,52,1004
Tennessee,Dover,2150,155,560,383,166,120,1384
Tennessee,Erin,1315,311,308,201,107,20,947
Tennessee,Doyle,561,99,195,68,28,9,399
Tennessee,Vonore,1913,136,467,383,148,95,1229
Tennessee,Spring City,2094,325,688,331,90,52,1486
Tennessee,Carthage,2546,340,767,429,114,99,1749
Tennessee,Cumberland City,307,55,87,50,12,10,214
Tennessee,Mountain City,2349,392,630,496,180,34,1732
Tennessee,Monterey,2845,463,776,347,130,35,1751
Tennessee,Jefferson City,8235,1011,1838,1312,649,176,4986
Tennessee,Silerton,127,12,37,15,33,1,98
Tennessee,Green Hill,6695,281,1353,1645,1077,454,4810
Tennessee,Nolensville,7656,163,422,977,1783,947,4292
Tennessee,Slayden,154,25,62,27,10,0,124
Tennessee,Jackson,66878,5202,13911,11552,7770,4438,42873
Tennessee,Maury City,873,149,197,144,23,5,518
Tennessee,Gadsden,582,102,167,95,23,30,417
Tennessee,Huntingdon,3845,506,1076,629,209,137,2557
Tennessee,Atwood,992,85,310,172,39,20,626
Tennessee,Bristol,26766,2514,6331,5475,3037,1846,19203
Tennessee,Bloomingdale,8660,1294,3133,1596,493,120,6636
Tennessee,Etowah,3474,371,1144,710,99,106,2430
Tennessee,Ridgeside,689,9,26,94,159,140,428
Tennessee,Estill Springs,2282,95,665,654,204,33,1651
Tennessee,Cowan,1475,270,456,184,90,34,1034
Tennessee,Pikeville,2251,297,606,494,99,64,1560
Tennessee,Gilt Edge,439,54,129,73,30,5,291
Tennessee,Sharon,1023,126,308,220,82,21,757
Tennessee,Martin,10721,553,1370,1541,1035,682,5181
Tennessee,Plainview,1803,265,586,295,61,41,1248
Tennessee,Red Bank,11748,685,2901,2650,1613,684,8533
Tennessee,South Carthage,1233,166,384,243,40,24,857
Tennessee,Brighton,2944,152,633,649,211,99,1744
Tennessee,Pulaski,7652,786,2345,1175,456,284,5046
Tennessee,Cedar Hill,303,46,105,27,4,6,188
Tennessee,Petersburg,713,92,259,81,4,0,436
Tennessee,Ramer,444,32,155,61,15,12,275
Tennessee,Tellico Plains,961,155,284,149,46,15,649
Tennessee,Bethel Springs,766,102,232,136,14,14,498
Tennessee,Sardis,389,39,175,62,13,9,298
Tennessee,Soddy-Daisy,13460,1191,3748,3029,1134,731,9833
Tennessee,Signal Mountain,8523,56,429,1183,2267,1888,5823
Tennessee,Lookout Mountain,1992,11,69,247,660,413,1400
Tennessee,Big Sandy,666,90,212,104,33,8,447
Tennessee,Watertown,1630,193,457,305,57,54,1066
Tennessee,Mitchellville,163,35,55,23,0,2,115
Tennessee,Medon,278,46,73,57,23,4,203
Tennessee,St. Joseph,913,145,333,163,19,29,689
Tennessee,Ooltewah,786,22,173,121,242,42,600
Tennessee,Saulsbury,95,15,27,11,2,1,56
Tennessee,Allardt,625,89,190,89,75,30,473
Tennessee,Lexington,7735,875,1893,1510,635,288,5201
Tennessee,Orlinda,997,83,248,179,70,45,625
Tennessee,Madisonville,4903,859,1295,902,257,134,3447
Tennessee,Harrogate,4323,351,959,668,571,410,2959
Tennessee,Erwin,5891,711,1650,1243,522,152,4278
Tennessee,Bean Station,3089,567,1044,404,168,75,2258
Tennessee,Stanton,440,48,179,53,9,4,293
Tennessee,East Ridge,21134,2061,4839,4766,2070,1096,14832
Tennessee,Greenfield,2357,294,628,421,198,64,1605
Tennessee,Spencer,1614,310,628,160,64,34,1196
Tennessee,Seymour,10873,705,3025,2587,1126,785,8228
Tennessee,Oakdale,219,22,87,23,4,5,141
Tennessee,Michie,963,122,246,196,36,24,624
Tennessee,Englewood,1592,330,494,199,51,15,1089
Tennessee,Calhoun,554,33,149,127,26,26,361
Tennessee,Gray,1552,86,308,304,248,117,1063
Tennessee,Hartsville/Trousdale,9573,1307,2291,1879,721,387,6585
Tennessee,Watauga,345,32,109,68,10,15,234
Tennessee,Tennessee Ridge,1481,171,479,196,73,45,964
Tennessee,La Follette,6911,1308,1912,1253,241,79,4793
Tennessee,McKenzie,5363,808,1074,839,335,553,3609
Tennessee,Jonesborough,5321,618,1301,920,832,591,4262
Tennessee,Cookeville,32894,2395,6139,4224,3646,2551,18955
Tennessee,Luttrell,838,185,306,118,13,3,625
Tennessee,Sevierville,16439,1932,4151,3501,1397,653,11634
Tennessee,Paris,10042,1099,3277,1531,665,250,6822
Tennessee,Wildwood Lake,3400,505,795,538,153,210,2201
Tennessee,Ridgely,1828,324,495,269,76,71,1235
Tennessee,Tiptonville,4359,1025,1555,589,211,85,3465
Tennessee,Knoxville,185429,13786,33120,33456,21930,14259,116551
Tennessee,Athens,13752,1375,3669,2323,1328,682,9377
Tennessee,Chapel Hill,1563,143,452,325,152,40,1112
Tennessee,Decatur,1557,196,441,239,106,43,1025
Tennessee,Farragut,22260,285,2008,3449,5615,4273,15630
Tennessee,Fall Branch,1547,86,507,484,148,14,1239
Tennessee,Waverly,4069,352,1443,600,326,202,2923
Tennessee,Mount Juliet,32882,944,5168,6174,6282,2645,21213
Tennessee,Gordonsville,1703,167,562,266,77,43,1115
Tennessee,Humboldt,8226,1048,2292,1601,531,323,5795
Tennessee,Beersheba Springs,516,134,129,71,16,0,350
Tennessee,Sewanee,2352,6,76,28,139,419,668
Tennessee,Dickson,15294,1621,3735,2818,1129,746,10049
Tennessee,Dyersburg,16559,2095,3601,3375,1494,605,11170
Tennessee,Ripley,8023,959,2102,1278,384,190,4913
Tennessee,Clarksburg,540,28,177,70,19,14,308
Tennessee,Oakland,7707,420,1363,2420,911,300,5414
Tennessee,Byrdstown,1036,191,350,119,6,30,696
Tennessee,Milledgeville,316,39,96,96,3,6,240
Tennessee,Middle Valley,12097,680,2736,2799,1657,781,8653
Tennessee,Harrison,7555,415,1830,2131,844,521,5741
Tennessee,Rural Hill,1888,59,330,560,256,189,1394
Tennessee,Rossville,844,35,158,211,158,68,630
Tennessee,Sweetwater,5870,806,1503,1091,453,186,4039
Tennessee,Fairmount,2418,25,136,421,407,539,1528
Tennessee,Lake City,2148,404,662,327,62,14,1469
Tennessee,Eva,93,26,30,10,19,8,93
Tennessee,Fairfield,245,21,22,46,0,0,89
Tennessee,Fairgarden,400,0,219,68,0,19,306
Tennessee,Falling Water,1309,91,209,348,116,146,910
Tennessee,Fincastle,1276,247,419,315,45,12,1038
Tennessee,Flat Top Mountain,308,4,83,137,13,15,252
Tennessee,Elgin,303,59,150,32,8,1,250
Tennessee,Flintville,640,104,266,27,12,0,409
Tennessee,Grimsley,1219,209,468,79,54,0,810
Tennessee,Hillsboro,251,8,113,58,29,0,208
Tennessee,Lakewood Park,714,119,204,136,0,0,459
Tennessee,Lone Oak,1125,163,324,212,129,54,882
Tennessee,Lyles,1173,125,437,136,39,16,753
Tennessee,Mooresburg,832,117,337,169,0,0,623
Tennessee,Graball,206,12,63,40,6,8,129
Tennessee,Mowbray Mountain,1699,153,423,448,235,59,1318
Tennessee,Dodson Branch,1260,257,253,388,13,31,942
Tennessee,Cottontown,354,34,152,70,26,4,286
Tennessee,Iron City,222,32,77,25,0,11,145
Tennessee,Cornersville,1336,129,386,282,63,36,896
Tennessee,Bethpage,320,25,89,85,17,0,216
Tennessee,Algood,4065,322,1220,647,260,171,2620
Tennessee,Rockvale,1340,20,186,301,212,96,815
Tennessee,Andersonville,559,62,224,127,19,0,432
Tennessee,Darden,197,72,64,59,0,0,195
Tennessee,Apison,2830,384,610,585,425,158,2162
Tennessee,Bowman,133,28,27,33,0,10,98
Tennessee,Bransford,220,67,45,43,0,0,155
Tennessee,Castalian Springs,536,64,243,59,33,0,399
Tennessee,Chesterfield,606,39,183,119,0,5,346
Tennessee,Clarkrange,818,118,244,64,62,38,526
Tennessee,Coalfield,2385,193,689,579,89,76,1626
Tennessee,Bon Aqua Junction,1229,191,470,197,21,11,890
Tennessee,Munford,5998,379,1175,1533,358,339,3784
Tennessee,New Deal,354,65,111,20,19,7,222
Tennessee,Oak Grove CDP (Sumner County),204,10,69,48,0,0,127
Tennessee,Wrigley,503,0,131,24,13,0,168
Tennessee,Finger,359,58,93,55,14,8,228
Tennessee,Scotts Hill,894,136,276,158,46,19,635
Tennessee,Gainesboro,921,201,242,145,63,32,683
Tennessee,Sunbright,395,37,197,58,22,11,325
Tennessee,Wartburg,954,196,304,124,55,31,710
Tennessee,Wildwood,992,111,212,272,70,90,755
Tennessee,Graysville,1726,364,468,281,40,0,1153
Tennessee,Norris,1450,116,256,252,241,277,1142
Tennessee,Bell Buckle,446,20,99,77,40,50,286
Tennessee,Christiana,3237,206,599,716,461,197,2179
Tennessee,Nashville-Davidson metropolitan government (balance),660062,52956,103784,116405,113601,66202,452948
Tennessee,Midtown,1437,216,471,217,98,60,1062
Tennessee,Helenwood,1008,41,517,227,13,0,798
Tennessee,Eagleville,843,72,165,115,97,49,498
Tennessee,New Union,1389,60,359,355,77,74,925
Tennessee,Walnut Grove CDP (Sumner County),956,161,310,197,36,7,711
Tennessee,Walland,272,12,85,59,30,21,207
Tennessee,Oak Grove CDP (Washington County),4709,448,1069,952,536,199,3204
Tennessee,Olivet,1652,93,596,353,29,11,1082
Tennessee,Park City,2424,185,606,436,281,79,1587
Tennessee,Parker's Crossroads,337,50,98,72,15,10,245
Tennessee,Pelham,323,24,112,44,48,34,262
Tennessee,Petros,812,117,261,62,7,0,447
Tennessee,Walnut Grove CDP (Hardin County),260,134,13,97,0,0,244
Tennessee,Riceville,1140,157,382,198,18,45,800
Tennessee,Sale Creek,2872,320,877,611,169,52,2029
Tennessee,Shackle Island,3082,94,561,649,535,271,2110
Tennessee,Summertown,598,103,127,119,43,0,392
Tennessee,Telford,1161,144,365,204,87,0,800
Tennessee,Tellico Village,5612,50,955,1158,1897,1415,5475
Tennessee,Unionville,2063,547,500,355,165,20,1587
Tennessee,Robbins,178,36,104,33,0,0,173
Tennessee,Lobelville,1025,181,300,215,38,33,767
Tennessee,Lynnville,360,45,83,64,36,6,234
Tennessee,Dayton,7340,1065,1424,1208,218,305,4220
Tennessee,Decaturville,1007,120,308,170,37,36,671
Tennessee,Kimball,1697,155,488,331,131,79,1184
Tennessee,Whitwell,1897,302,583,335,54,16,1290
Tennessee,Bluff City,1867,121,463,402,153,98,1237
Tennessee,Normandy,109,21,36,18,8,0,83
Tennessee,Jellico,2289,574,644,303,68,91,1680
Tennessee,Elizabethton,13555,1519,3298,2988,1133,797,9735
Tennessee,Auburntown,216,16,59,42,24,10,151
Tennessee,Roan Mountain,1276,237,454,176,107,47,1021
Tennessee,Fairfield Glade,8564,382,2067,2356,1829,1168,7802
Tennessee,Surgoinsville,2165,257,559,420,144,69,1449
Tennessee,Kingston Springs,2754,113,467,637,417,235,1869
Tennessee,New Tazewell,2744,518,659,724,157,72,2130
Tennessee,Maryville,28520,1458,4924,5486,4074,2717,18659
Tennessee,McEwen,1615,181,642,296,90,34,1243
Tennessee,Woodland Mills,332,16,125,63,27,13,244
Tennessee,Clifton,2684,570,1094,402,71,33,2170
Tennessee,Fayetteville,6987,965,2001,1142,635,284,5027
Tennessee,Lafayette,5055,952,1577,656,102,112,3399
Tennessee,Chattanooga,177365,16055,34552,36524,23779,12556,123466
Tennessee,Arlington,11689,249,1140,2366,1909,1053,6717
Tennessee,Ashland City,4608,492,1128,1046,391,262,3319
Tennessee,Powells Crossroads,1461,138,431,297,67,53,986
Tennessee,Covington,8855,1185,2491,1445,424,383,5928
Tennessee,Bartlett,58828,2223,10066,13945,8491,5607,40332
Tennessee,Crab Orchard,724,126,230,77,21,10,464
Tennessee,Lake Tansi,4343,498,1219,1052,323,168,3260
Tennessee,Tusculum,2737,199,528,366,208,189,1490
Tennessee,Union City,10478,1158,3003,1801,592,530,7084
Tennessee,Church Hill,6681,705,1813,1506,659,311,4994
Tennessee,Henderson,6247,600,1004,922,456,349,3331
Tennessee,Forest Hills,4968,55,171,392,1630,1308,3556
Tennessee,Minor Hill,526,53,140,85,25,8,311
Tennessee,Collegedale,11256,603,1320,2245,1884,985,7037
Tennessee,White House,11513,489,2618,2429,1347,438,7321
Tennessee,Goodlettsville,16900,769,3504,3934,2785,1172,12164
Tennessee,Columbia,37455,3118,9317,8131,2978,1545,25089
Tennessee,Whiteville,4526,1170,1914,571,96,24,3775
Tennessee,Hickory Valley,86,4,46,14,9,9,82
Tennessee,Sneedville,1285,197,424,154,52,55,882
Tennessee,Tracy City,1556,247,439,255,64,55,1060
Tennessee,Altamont,1037,203,421,116,49,10,799
Tennessee,Trenton,4091,564,1107,761,243,216,2891
Tennessee,Decherd,3151,385,853,600,169,87,2094
Tennessee,Vanleer,333,71,98,46,9,2,226
Tennessee,Cottage Grove,79,3,29,14,1,10,57
Tennessee,Newbern,3327,299,751,623,147,194,2014
Tennessee,Viola,104,18,34,17,8,3,80
Tennessee,Ducktown,489,101,119,111,27,19,377
Tennessee,Unicoi,3556,311,1011,782,282,172,2558
Tennessee,Henning,908,245,242,136,16,5,644
Tennessee,Blountville,2813,495,769,730,179,197,2370
Tennessee,Lakeland,12628,315,1621,2578,2278,1207,7999
Tennessee,Collierville,49610,1283,4903,8185,11477,7523,33371
Tennessee,Gates,667,78,203,105,23,7,416
Tennessee,La Vergne,35237,2965,6541,7052,2834,1541,20933
Tennessee,Kingston,5821,512,1238,1542,718,335,4345
Tennessee,Rives,285,46,106,19,8,0,179
Tennessee,Obion,1300,120,435,214,32,4,805
Tennessee,Kenton,1193,119,497,236,64,29,945
Tennessee,Hollow Rock,785,102,238,119,29,25,513
Tennessee,Maynardville,2724,379,760,430,99,39,1707
Tennessee,Burns,1719,193,587,357,67,56,1260
Tennessee,Harriman,6136,527,1987,1598,272,171,4555
Tennessee,Waynesboro,2552,348,677,396,150,178,1749
Tennessee,Oliver Springs,4489,410,997,1116,208,157,2888
Tennessee,Trimble,495,63,192,80,28,12,375
Tennessee,Belle Meade,2401,10,47,226,770,679,1732
Tennessee,Wartrace,630,58,246,106,27,12,449
Tennessee,Shelbyville,21319,3015,5844,2968,1028,482,13337
Tennessee,Clinton,9908,1033,2344,2352,856,545,7130
Tennessee,Eagleton Village,5250,532,1148,1464,306,140,3590
Tennessee,Centerville,3555,582,819,783,278,131,2593
Tennessee,Alexandria,1112,105,389,216,36,11,757
Tennessee,Crossville,11368,1250,2892,2372,943,272,7729
Tennessee,Bruceton,1318,195,384,244,61,21,905
Tennessee,Ethridge,753,66,218,100,31,6,421
Tennessee,Savannah,6964,1018,1989,1147,271,144,4569
Tennessee,Franklin,75366,2405,6290,10759,19090,11428,49972
Tennessee,Morrison,601,111,194,62,15,5,387
Tennessee,Kingsport,53115,4867,12834,10804,6032,4045,38582
Tennessee,Townsend,373,20,85,130,69,32,336
Tennessee,Hornbeak,419,83,149,50,11,3,296
Tennessee,Bulls Gap,696,93,282,123,10,26,534
Tennessee,Alcoa,9633,690,2215,2102,1039,414,6460
Tennessee,Rockford,849,46,259,177,56,96,634
Tennessee,Newport,6757,889,1959,1232,329,122,4531
Tennessee,Ardmore,1293,228,333,272,80,54,967
Tennessee,Parsons,2263,344,564,469,83,56,1516
Tennessee,South Fulton,2449,228,816,356,170,68,1638
Tennessee,Hunter,2153,189,672,568,27,121,1577
Tennessee,Jasper,3351,500,711,800,322,73,2406
Tennessee,Monteagle,1957,239,414,404,99,132,1288
Tennessee,Oneida,3706,557,959,548,265,179,2508
Tennessee,Garland,339,17,89,63,31,26,226
Tennessee,Samburg,273,43,91,67,19,1,221
Tennessee,Philadelphia,986,165,247,186,17,31,646
Tennessee,Morristown,29547,4499,7499,4823,1850,1109,19780
Tennessee,Springfield,16787,2085,4679,2912,962,556,11194
Tennessee,Collinwood,1006,125,283,200,57,34,699
Tennessee,Smithville,4699,886,1077,629,318,202,3112
Tennessee,Friendsville,742,84,283,140,51,2,560
Tennessee,Berry Hill,1082,12,79,126,385,146,748
Tennessee,Tazewell,2312,359,716,409,137,83,1704
Tennessee,Woodbury,2735,449,858,388,150,108,1953
Tennessee,Louisville,4133,281,757,872,677,464,3051
Tennessee,Burlison,337,41,99,74,28,13,255
Tennessee,Winfield,1008,178,328,179,36,21,742
Tennessee,Walterhill,233,45,47,58,47,0,197
Tennessee,Germantown,39164,488,2628,6382,10744,7573,27815
Tennessee,Guys,543,71,169,108,30,10,388
Tennessee,Eastview,1007,57,238,157,69,22,543
Tennessee,Spurgeon,4482,317,1082,1112,519,214,3244
Tennessee,Johnson City,66037,4170,10193,10936,10015,7106,42420
Tennessee,Greenbrier,6770,478,1717,1457,542,218,4412
Tennessee,Red Boiling Springs,1516,395,320,137,21,39,912
Tennessee,Atoka,9139,341,1298,2461,1039,692,5831
Tennessee,Oak Hill,4634,52,199,464,1507,1054,3276
Tennessee,Mason,1123,160,317,175,42,35,729
Tennessee,Loudon,5687,1219,1332,859,237,214,3861
Tennessee,Jacksboro,2250,419,661,424,206,61,1771
Tennessee,Huntsville,1419,272,416,197,50,20,955
Tennessee,South Pittsburg,3045,380,904,525,111,89,2009
Tennessee,Adams,638,68,172,92,59,21,412
Texas,Weinert,240,35,79,28,10,8,160
Texas,Relampago,325,35,58,130,44,14,281
Texas,Union Valley,367,25,69,108,57,20,279
Texas,Talty,2302,114,265,497,285,225,1386
Texas,Salineño,129,41,0,32,0,0,73
Texas,Lopeño,184,43,13,11,0,0,67
Texas,Cut and Shoot,1313,185,461,157,24,14,841
Texas,Encantada-Ranchito-El Calaboz,1438,458,240,131,38,17,884
Texas,Smiley,608,135,116,107,36,5,399
Texas,China,979,109,363,229,47,14,762
Texas,Roaring Springs,186,38,75,31,23,3,170
Texas,Rosser,249,50,70,36,6,5,167
Texas,Lindsay,1156,14,174,306,175,130,799
Texas,Nixon,2987,635,706,256,23,8,1628
Texas,Stanton,2937,487,471,436,267,115,1776
Texas,Gonzales,7520,1167,1925,845,341,160,4438
Texas,Bacliff,10649,1733,2318,1702,661,309,6723
Texas,Denver City,4874,922,1088,598,262,62,2932
Texas,Merkel,2614,302,670,636,124,55,1787
Texas,Kress,808,149,175,111,29,9,473
Texas,Richland Springs,281,33,84,77,19,6,219
Texas,Laredo,257575,45037,37551,32647,18969,7856,142060
Texas,Evadale,1887,152,661,251,23,22,1109
Texas,Buna,1891,140,661,446,48,34,1329
Texas,Tierra Grande,466,59,115,48,37,20,279
Texas,Oak Ridge town (Kaufman County),529,31,107,148,57,16,359
Texas,Jolly,183,16,53,61,8,22,160
Texas,Lampasas,7611,746,1833,1833,507,264,5183
Texas,Forney,19366,762,3287,4153,2405,1039,11646
Texas,Bishop Hills,297,3,43,82,41,31,200
Texas,Ranger,2863,515,586,599,77,31,1808
Texas,Bandera,805,90,228,233,75,34,660
Texas,Lakehills,5288,513,914,1417,742,385,3971
Texas,Cinco Ranch,16977,197,939,3016,4175,2784,11111
Texas,Miami,511,36,102,90,69,15,312
Texas,Hemphill,1333,284,344,233,53,26,940
Texas,Pineland,616,96,177,131,24,15,443
Texas,Jersey Village,7945,343,1101,2107,1742,1006,6299
Texas,Southside Place,1596,31,37,71,403,479,1021
Texas,Ranchos Penitas West,1240,134,132,75,63,120,524
Texas,La Presa,244,83,10,15,15,0,123
Texas,Galveston,50039,5926,8785,10521,6175,4158,35565
Texas,Brackettville,1831,398,599,303,59,18,1377
Texas,White Oak,6358,484,1311,1384,649,203,4031
Texas,Coyote Acres,1297,59,168,282,32,0,541
Texas,Comfort,3350,586,620,496,92,162,1956
Texas,Knox City,1293,173,210,223,99,43,748
Texas,Longview,82256,8292,15351,18365,7346,3593,52947
Texas,Kennard,189,36,63,41,17,0,157
Texas,Paint Rock,411,83,93,103,37,3,319
Texas,Clarendon,1961,130,381,390,188,54,1143
Texas,Caldwell,4302,529,1026,688,289,107,2639
Texas,Putnam,78,8,27,26,9,2,72
Texas,Guerra,0,0,0,0,0,0,0
Texas,Ingram,1979,302,529,361,37,40,1269
Texas,Moore,369,53,34,116,14,28,245
Texas,Milam,1742,65,476,445,131,125,1242
Texas,Happy,612,23,99,179,58,29,388
Texas,Buffalo Gap,545,57,134,61,81,3,336
Texas,Potosi,2925,59,435,811,450,170,1925
Texas,Alto,1242,180,283,248,37,3,751
Texas,Prado Verde,243,0,25,58,10,39,132
Texas,Colorado City,3983,503,966,692,290,74,2525
Texas,Zavalla,734,119,166,150,9,0,444
Texas,Fort Worth,855786,97145,133160,149039,102244,49728,531316
Texas,Doffing,5065,1216,498,565,139,49,2467
Texas,Faysville,0,0,0,0,0,0,0
Texas,San Carlos,3659,1105,372,426,120,0,2023
Texas,Scissors,3564,1184,284,118,37,26,1649
Texas,Wellman,213,45,58,37,10,4,154
Texas,Lometa,653,53,125,111,50,12,351
Texas,Cottonwood Shores,1524,147,348,316,109,47,967
Texas,Meadowlakes,2319,16,434,438,513,301,1702
Texas,Brownsboro,1165,116,287,152,96,28,679
Texas,Malone,319,32,49,53,19,4,157
Texas,Bloomington,1855,340,677,294,64,0,1375
Texas,Tornillo,1110,316,123,110,50,23,622
Texas,Sparks,3935,1025,477,909,0,0,2411
Texas,Llano Grande,2224,708,453,231,54,40,1486
Texas,Fort Bliss,10602,79,736,1930,893,441,4079
Texas,Eustace,912,105,221,196,58,32,612
Texas,Kountze,1979,347,573,341,62,49,1372
Texas,Beasley,606,125,154,72,38,4,393
Texas,Brownfield,9596,2064,1979,1433,444,217,6137
Texas,Alvin,26154,2488,5247,6028,2016,730,16509
Texas,Wallis,1508,160,475,281,73,49,1038
Texas,Decatur,6608,553,1151,1632,562,189,4087
Texas,Deweyville,637,50,218,109,44,0,421
Texas,Texas City,47902,5860,10169,11121,3484,1130,31764
Texas,Yoakum,6233,1029,1545,899,310,14,3797
Texas,Star Harbor,443,10,52,132,113,49,356
Texas,Fort Hancock,1898,561,391,91,31,0,1074
Texas,Malakoff,2960,362,696,535,134,66,1793
Texas,Murchison,484,41,91,140,37,15,324
Texas,Granjeno,387,102,56,85,29,17,289
Texas,Edcouch,3316,900,463,469,201,34,2067
Texas,Santa Clara,769,38,204,156,97,43,538
Texas,Hico,1518,147,517,210,66,53,993
Texas,Johnson City,1885,192,583,333,154,54,1316
Texas,Woodbranch,1521,145,442,276,158,38,1059
Texas,Atlanta,5523,720,1241,928,768,236,3893
Texas,Texarkana,37277,2985,7637,7731,4096,1757,24206
Texas,Morgan's Point,314,10,47,59,48,53,217
Texas,Atascocita,79019,4057,10667,16764,13211,5415,50114
Texas,Deer Park,33935,2348,6081,8869,3224,1145,21667
Texas,Jacinto City,10747,3048,1868,1630,185,46,6777
Texas,Seabrook,13670,341,1464,3526,2760,1025,9116
Texas,Sheldon,2116,465,328,272,17,0,1082
Texas,Gregory,2065,337,501,331,69,25,1263
Texas,Mathis,4899,1212,851,712,57,47,2879
Texas,Wills Point,3571,540,832,466,243,93,2174
Texas,Winona,526,64,86,160,22,4,336
Texas,Cienegas Terrace,3489,685,570,257,60,29,1601
Texas,Austin,935755,69962,102985,145431,201944,121645,641967
Texas,Carl's Corner,180,36,44,48,0,19,147
Texas,Westway,3552,927,449,295,155,62,1888
Texas,Bedford,49306,1895,7099,13083,9230,4584,35891
Texas,Mullin,95,34,26,11,2,0,73
Texas,Bremond,875,130,242,156,94,14,636
Texas,Goldsmith,202,11,70,74,24,5,184
Texas,Argyle,3988,62,356,746,1191,628,2983
Texas,Northlake,2524,32,296,521,576,174,1599
Texas,Glen Rose,2578,218,678,651,312,149,2008
Texas,Elbert,8,0,0,3,3,2,8
Texas,San Isidro,189,33,19,67,0,4,123
Texas,Los Indios,838,225,187,130,16,33,591
Texas,Benbrook,22961,719,3940,5847,3844,2054,16404
Texas,Lake Medina Shores,1449,173,438,451,50,17,1129
Texas,Chapeno,23,6,0,0,0,0,6
Texas,Lake Colorado City,422,26,108,83,77,11,305
Texas,Yznaga,52,0,36,9,7,0,52
Texas,Round Top,90,2,10,36,15,19,82
Texas,Grays Prairie,270,28,93,51,30,0,202
Texas,Green Valley Farms,423,128,76,36,0,64,304
Texas,West Tawakoni,2189,353,670,428,90,25,1566
Texas,Freer,2714,348,659,436,112,12,1567
Texas,Volente,590,21,65,131,138,78,433
Texas,Taylor Landing,251,2,31,77,38,44,192
Texas,San Augustine,1815,331,377,341,129,70,1248
Texas,Oak Leaf,1486,79,324,329,212,96,1040
Texas,Little Elm,42889,1827,4774,8724,7055,4221,26601
Texas,Lavon,3061,52,427,797,431,162,1869
Texas,Shallowater,2535,110,455,526,253,139,1483
Texas,DISH,419,24,85,91,81,34,315
Texas,Celina,9354,169,983,1986,1972,622,5732
Texas,Brazos Bend,382,7,40,105,101,73,326
Texas,Edgecliff Village,3002,330,492,635,304,242,2003
Texas,Westbrook,177,21,50,32,22,0,125
Texas,Morning Glory,432,55,96,33,21,14,219
Texas,Canutillo,5061,1171,759,490,299,160,2879
Texas,Log Cabin,590,127,225,97,10,0,459
Texas,Enchanted Oaks,316,17,82,83,63,29,274
Texas,Berryville,1203,85,329,283,92,47,836
Texas,Athens,12677,1394,2551,2023,1099,699,7766
Texas,Trenton,789,106,198,161,45,16,526
Texas,Ackerly,186,46,20,19,5,8,98
Texas,Daingerfield,2777,314,620,633,152,68,1787
Texas,Harker Heights,30251,1696,4017,6632,4576,2248,19169
Texas,Fruitvale,479,52,142,78,13,2,287
Texas,Lakeway,14677,83,908,2592,4854,2501,10938
Texas,Bruni,294,30,119,34,26,0,209
Texas,Giddings,5043,429,1098,1019,326,167,3039
Texas,Tiki Island,963,29,117,273,307,166,892
Texas,Paducah,1325,202,279,224,82,41,828
Texas,La Marque,16225,1737,3964,3792,1106,430,11029
Texas,Bolivar Peninsula,2333,194,600,446,281,221,1742
Texas,Byers,517,14,151,118,26,10,319
Texas,Palestine,18237,2262,4079,3408,1221,613,11583
Texas,Encinal,953,253,233,100,26,8,620
Texas,Hondo,9204,1273,2212,1685,479,266,5915
Texas,Hitchcock,7730,741,1731,1685,424,117,4698
Texas,Adrian,116,28,28,15,26,12,109
Texas,Queen City,1634,123,497,294,109,29,1052
Texas,Douglassville,237,16,73,45,11,10,155
Texas,Jourdanton,4319,612,1051,491,121,33,2308
Texas,White Deer,663,26,114,132,96,45,413
Texas,Ratamosa,266,37,95,0,0,0,132
Texas,Olmito,1243,312,195,242,25,26,800
Texas,Santa Rosa,2830,600,588,243,68,18,1517
Texas,Lakeside town (San Patricio County),320,20,103,94,45,8,270
Texas,Stockdale,1295,231,257,208,95,34,825
Texas,Rosebud,1437,166,498,251,67,19,1001
Texas,Bardwell,623,190,115,58,13,5,381
Texas,Follett,479,42,69,102,47,17,277
Texas,Corral City,6,0,0,3,0,0,3
Texas,Jefferson,2533,256,811,456,205,75,1803
Texas,Uhland,1343,256,232,229,54,46,817
Texas,Gardendale,2031,32,508,503,132,0,1175
Texas,Naples,1353,118,374,247,79,15,833
Texas,Medina,5296,1273,827,265,67,0,2432
Texas,Westlake,974,9,56,118,213,203,599
Texas,Camargito,447,117,16,88,0,0,221
Texas,Callender Lake,1300,72,388,241,213,61,975
Texas,Canyon Creek,1306,265,198,239,120,0,822
Texas,Burton,560,46,82,88,122,18,356
Texas,Buena Vista,54,12,11,0,0,0,23
Texas,Buchanan Lake Village,856,177,217,262,91,11,758
Texas,Bristol,484,79,259,46,49,11,444
Texas,Boys Ranch,509,0,18,13,29,12,72
Texas,Box Canyon,43,19,9,5,7,2,42
Texas,Bonanza Hills,127,0,16,10,9,14,49
Texas,Boling,916,133,227,182,36,0,578
Texas,Bluetown,482,147,115,58,0,0,320
Texas,Campo Verde,105,69,9,0,16,0,94
Texas,Big Thicket Lake Estates,582,166,156,86,0,0,408
Texas,Bee Cave,6521,90,567,1006,2030,918,4611
Texas,Barrera,83,0,24,4,0,0,28
Texas,Banquete,389,114,98,75,27,0,314
Texas,B and E,422,174,23,11,0,0,208
Texas,Arroyo Gardens,108,97,0,0,0,0,97
Texas,Anacua,8,0,0,0,8,0,8
Texas,Amistad,23,0,15,6,0,2,23
Texas,Amaya,42,0,0,17,8,0,25
Texas,Amargosa,100,49,8,0,27,0,84
Texas,Amada Acres,0,0,0,0,0,0,0
Texas,Alto Bonito Heights,194,121,44,0,0,0,165
Texas,Alfred,0,0,0,0,0,0,0
Texas,Benjamin Perez,161,62,49,0,0,0,111
Texas,Cape Royale,445,12,65,154,163,51,445
Texas,Carlsbad,574,82,115,74,26,0,297
Texas,Casa Blanca,0,0,0,0,0,0,0
Texas,Los Ybanez,22,1,8,13,0,0,22
Texas,Grand Saline,3105,592,690,514,128,31,1955
Texas,Edom,245,21,37,67,25,9,159
Texas,Aspermont,908,83,230,214,45,27,599
Texas,Leroy,374,36,68,86,34,15,239
Texas,Hallsburg,483,25,108,152,42,5,332
Texas,Eagle Lake,3685,678,796,472,135,87,2168
Texas,Milano,416,63,117,54,10,6,250
Texas,Muenster,1477,79,280,257,225,83,924
Texas,Perryton,9167,1442,1736,1484,553,162,5377
Texas,Post Oak Bend City,420,25,76,129,47,21,298
Texas,Kaufman,7107,1036,1659,1331,366,152,4544
Texas,Livingston,5046,857,1187,893,405,174,3516
Texas,Cross Roads,1202,38,143,257,281,132,851
Texas,O'Donnell,880,182,185,165,58,9,599
Texas,Paradise,492,67,136,74,28,7,312
Texas,Crane,4051,562,746,812,214,47,2381
Texas,Yantis,407,54,117,81,4,14,270
Texas,Hawkins,1351,129,305,248,125,60,867
Texas,Leona,125,4,40,13,9,5,71
Texas,Centerville,1092,94,205,227,96,27,649
Texas,Sundown,1222,195,196,216,99,55,761
Texas,Opdyke West,232,20,47,44,3,0,114
Texas,Lumberton,12610,648,2796,2967,1187,591,8189
Texas,Old River-Winfree,2130,195,615,356,66,126,1358
Texas,Rosenberg,36509,5142,6298,6055,2879,1212,21586
Texas,Casas,27,10,0,8,0,0,18
Texas,Shiner,2139,198,501,405,320,55,1479
Texas,Lake Dunlap,2288,248,546,430,226,52,1502
Texas,Crystal City,7381,1395,1540,822,245,172,4174
Texas,Lawn,313,32,89,63,24,7,215
Texas,Hargill,826,294,77,15,21,8,415
Texas,Gutierrez,84,0,36,0,0,0,36
Texas,Guthrie,154,12,46,37,9,12,116
Texas,Glidden,911,123,256,83,25,4,491
Texas,Garza-Salinas II,570,197,62,48,19,17,343
Texas,Garden City,487,100,36,109,24,18,287
Texas,Garciasville,72,15,14,0,0,0,29
Texas,Gail,245,6,65,44,17,33,165
Texas,Four Points,0,0,0,0,0,0,0
Texas,Fort Clark Springs,1189,98,320,357,125,20,920
Texas,Flor del Rio,254,119,18,0,0,0,137
Texas,Fronton Ranchettes,234,7,36,24,29,0,96
Texas,H. Cuellar Estates,103,4,11,34,30,0,79
Texas,Fernando Salinas,27,0,0,13,0,0,13
Texas,Falman,15,15,0,0,0,0,15
Texas,Falconaire,180,84,0,16,0,0,100
Texas,Fabrica,748,224,186,39,16,0,465
Texas,Evergreen,53,15,23,0,0,0,38
Texas,Eugenio Saenz,260,49,112,0,0,0,161
Texas,Emerald Bay,1307,0,128,375,399,201,1103
Texas,El Socio,69,41,0,0,0,0,41
Texas,El Rancho Vela,569,105,105,97,18,0,325
Texas,El Quiote,193,53,18,51,0,0,122
Texas,Elmo,1351,190,603,114,13,0,920
Texas,El Mesquite,0,0,0,0,0,0,0
Texas,Elias-Fela Solis,8,8,0,0,0,0,8
Texas,Fannett,2156,102,639,486,336,96,1659
Texas,Hillside Acres,0,0,0,0,0,0,0
Texas,Hilltop CDP (Frio County),167,71,40,37,0,0,148
Texas,Hilltop CDP (Starr County),90,38,29,0,0,0,67
Texas,Lake Cherokee,2480,211,527,732,461,175,2106
Texas,Lake Bryan,1817,174,262,374,151,21,982
Texas,Laguna Park,1497,166,334,452,158,9,1119
Texas,La Esperanza,58,12,0,12,19,0,43
Texas,La Escondida,232,52,34,0,0,0,86
Texas,La Coma,66,11,19,10,0,0,40
Texas,La Chuparosa,37,0,0,11,0,0,11
Texas,La Casita,0,0,0,0,0,0,0
Texas,La Carla,209,29,4,29,10,0,72
Texas,Knollwood,537,11,134,139,73,44,401
Texas,Lost Creek,1135,0,27,130,400,194,751
Texas,Guadalupe Guerra,62,7,0,27,0,0,34
Texas,Coupland,255,32,76,39,26,7,180
Texas,Kemp,996,130,284,150,55,33,652
Texas,Juarez,1309,308,274,24,31,0,637
Texas,Jardin de San Julian,31,12,0,0,0,0,12
Texas,Ivanhoe,1391,128,394,320,76,8,926
Texas,Indio,0,0,0,0,0,0,0
Texas,Indian Springs,766,122,250,129,30,0,531
Texas,Iglesia Antigua,218,69,72,17,11,0,169
Texas,Iago,113,39,29,14,12,0,94
Texas,Hull,809,93,162,119,103,0,477
Texas,Horseshoe Bend,710,139,255,59,25,0,478
Texas,Hornsby Bend,7194,1014,1566,1078,504,331,4493
Texas,Holly Lake Ranch,2565,148,656,785,481,130,2200
Texas,Holiday Beach,648,132,169,280,29,13,623
Texas,Hilltop Lakes,783,110,184,276,110,0,680
Texas,El Chaparral,375,122,14,26,63,27,252
Texas,La Pryor,1487,430,161,213,25,23,852
Texas,El Cenizo,444,104,28,28,15,0,175
Texas,El Brazil,61,36,0,0,7,6,49
Texas,Pinewood Estates,1863,36,131,369,402,207,1145
Texas,Newton,2165,249,613,423,161,82,1528
Texas,Kendleton,328,7,124,84,14,13,242
Texas,Rendon,13616,1010,2619,2617,1900,1175,9321
Texas,North Richland Hills,69800,4055,10690,16499,11509,4390,47143
Texas,Lakeside town (Tarrant County),1524,87,274,484,229,122,1196
Texas,Flower Mound,73252,1583,5364,11359,19353,10382,48041
Texas,Blue Mound,3398,665,694,508,140,115,2122
Texas,Newark,1326,237,251,246,77,8,819
Texas,Vinton,1773,293,227,298,82,13,913
Texas,Fabens,5946,1917,875,608,91,18,3509
Texas,Clint,718,127,166,141,47,28,509
Texas,Levelland,13686,2133,2150,2964,686,386,8319
Texas,Anthony,5578,921,1132,1418,304,131,3906
Texas,Cuero,8349,1203,2497,1987,348,155,6190
Texas,Tool,2227,318,573,523,228,117,1759
Texas,Moore Station,312,36,78,68,7,2,191
Texas,Leonard,2265,203,617,434,115,37,1406
Texas,Ector,903,107,207,208,43,19,584
Texas,White Settlement,17396,2067,4733,3192,1024,336,11352
Texas,Pelican Bay,1620,222,498,259,49,3,1031
Texas,Pantego,2532,143,432,552,593,297,2017
Texas,Troup,2169,251,499,427,125,19,1321
Texas,Rusk,5563,1040,1349,1305,349,161,4204
Texas,Jacksonville,14821,2891,2553,2169,842,503,8958
Texas,North Pearsall,1211,218,517,76,19,21,851
Texas,Yorktown,1651,272,402,297,133,78,1182
Texas,Dalworthington Gardens,2456,74,238,554,475,359,1700
Texas,Euless,55047,4078,8343,12760,8997,4455,38633
Texas,Cumings,2420,98,135,582,322,244,1381
Texas,Edgewater Estates,122,90,0,0,0,0,90
Texas,East Alto Bonito,819,346,124,60,5,0,535
Texas,Driftwood,74,0,7,9,39,10,65
Texas,Dorchester,77,7,31,7,6,0,51
Texas,D'Hanis,918,90,218,217,59,11,595
Texas,Del Sol,59,59,0,0,0,0,59
Texas,Delmita,129,24,40,13,15,0,92
Texas,Country Acres,223,18,146,8,0,0,172
Texas,Colorado Acres,118,45,0,0,0,0,45
Texas,Chula Vista CDP (Zavala County),1126,277,88,232,0,0,597
Texas,Chula Vista CDP (Maverick County),3922,1188,399,361,207,49,2204
Texas,Chula Vista CDP (Cameron County),499,131,157,37,0,0,325
Texas,China Spring,990,28,304,288,31,9,660
Texas,Chilton,736,163,105,31,40,0,339
Texas,Penelope,160,31,40,30,7,1,109
Texas,Chaparrito,71,42,0,0,0,0,42
Texas,Cedar Point,806,72,204,170,123,36,605
Texas,Blanco,2550,216,492,520,338,130,1696
Texas,Normangee,760,116,193,123,52,17,501
Texas,Anton,1123,253,170,232,47,17,719
Texas,South Toledo Bend,476,34,64,223,39,18,378
Texas,Alba,774,116,197,129,60,3,505
Texas,Stowell,1291,222,336,80,30,13,681
Texas,Simonton,640,60,121,145,68,64,458
Texas,Richmond,12084,2521,2200,1753,951,379,7804
Texas,Orchard,253,57,70,55,11,2,195
Texas,Fulshear,8014,93,400,976,2038,1191,4698
Texas,El Castillo,137,54,0,0,0,0,54
Texas,Goldthwaite,2153,231,346,491,144,85,1297
Texas,Hutchins,5726,1177,1418,934,154,68,3751
Texas,Plainview,20714,2789,4210,3181,1566,719,12465
Texas,Haskell,3240,732,801,538,127,92,2290
Texas,Frankston,1053,114,319,200,69,73,775
Texas,Lamesa,9264,1517,2265,1273,618,158,5831
Texas,Muleshoe,5568,793,1359,640,516,159,3467
Texas,Neylandville,76,5,19,18,2,0,44
Texas,Commerce,9000,541,1289,1280,654,705,4469
Texas,Jewett,1009,208,250,88,51,31,628
Texas,Hallsville,4134,124,557,980,562,354,2577
Texas,Gorman,1042,119,185,170,47,10,531
Texas,Louise,935,198,137,150,47,31,563
Texas,Woodson,219,13,56,51,6,0,126
Texas,The Colony,42215,1926,6081,10500,8204,2776,29487
Texas,Shady Shores,2828,80,350,631,610,279,1950
Texas,Roanoke,7899,457,1532,1329,1389,589,5296
Texas,Krugerville,1600,75,309,442,259,106,1191
Texas,Hickory Creek,4442,171,691,1119,883,506,3370
Texas,Hebron,239,4,62,24,53,36,179
Texas,Denton,133661,7608,15246,25400,19336,10455,78045
Texas,Corinth,21158,1031,2435,5016,4139,1927,14548
Texas,Emory,1361,204,363,310,101,22,1000
Texas,Kerrville,23216,1913,4388,5727,2756,1726,16510
Texas,Rochester,365,75,82,66,15,10,248
Texas,Iraan,1215,160,233,238,94,33,758
Texas,Pyote,126,15,31,27,9,0,82
Texas,Annona,358,65,115,60,11,1,252
Texas,Powell,93,31,24,10,15,0,80
Texas,Blessing,660,69,141,29,28,0,267
Texas,Eagle Pass,29151,5425,3635,4853,1765,850,16528
Texas,Avery,518,88,159,51,48,3,349
Texas,Cross Timber,356,30,95,57,40,28,250
Texas,Briaroaks,563,13,105,117,94,36,365
Texas,Monahans,7587,973,1625,1364,505,219,4686
Texas,Hempstead,7397,1090,1403,926,487,109,4015
Texas,Bayside,417,31,112,111,39,20,313
Texas,Strawn,680,102,179,146,42,8,477
Texas,West Orange,3399,401,816,847,184,62,2310
Texas,Mauriceville,3121,167,1041,699,243,51,2201
Texas,Midlothian,23908,971,3530,5817,3113,1199,14630
Texas,Gordon,450,25,124,110,51,12,322
Texas,Floydada,2767,557,499,422,188,40,1706
Texas,Hale Center,2189,337,431,354,145,37,1304
Texas,Rotan,1345,183,389,268,108,18,966
Texas,Midland,135134,13400,21298,25912,17563,6932,85105
Texas,Edroy,523,80,135,72,0,0,287
Texas,Mobeetie,104,6,16,46,4,1,73
Texas,McKinney,173460,8645,16662,34102,33908,16173,109490
Texas,Holiday Lakes,1060,271,220,96,6,4,597
Texas,Cotulla,4162,749,1183,424,296,104,2756
Texas,Spur,1089,172,309,227,63,53,824
Texas,Granite Shoals,5057,485,1170,1001,501,60,3217
Texas,Pittsburg,4634,515,1056,586,396,105,2658
Texas,Copperas Cove,32731,1283,5341,10246,2850,1104,20824
Texas,Meadow,685,106,125,117,46,5,399
Texas,Palmview South,5352,1171,1110,695,355,92,3423
Texas,Redwood,3429,754,877,360,119,49,2159
Texas,Marquez,351,39,101,67,5,5,217
Texas,Silsbee,6640,743,1529,1605,433,137,4447
Texas,Zuehl,307,0,118,76,42,5,241
Texas,Mont Belvieu,5555,117,746,1767,725,169,3524
Texas,Progreso Lakes,292,35,55,40,54,23,207
Texas,Penitas,4834,905,894,364,251,49,2463
Texas,Midway North,5074,1390,437,592,262,0,2681
Texas,Laguna Seca,297,48,56,57,25,0,186
Texas,La Blanca,2383,441,460,291,124,36,1352
Texas,Edinburg,94019,13202,11965,13803,8749,4940,52659
Texas,Silverton,709,71,196,197,37,30,531
Texas,Gatesville,12387,2286,2855,3566,605,204,9516
Texas,Canyon Lake,25104,1606,5477,6144,3365,2147,18739
Texas,Bulverde,5104,117,865,1274,756,512,3524
Texas,Blue Ridge,1012,154,211,149,22,17,553
Texas,South Point,1598,344,412,158,42,0,956
Texas,South Padre Island,2839,190,453,853,443,497,2436
Texas,Solis,451,71,85,46,106,36,344
Texas,Kenefick,411,51,137,113,7,5,313
Texas,Southlake,30840,119,1918,4068,7616,5498,19219
Texas,Saginaw,22873,1566,4676,5074,2486,988,14790
Texas,River Oaks,7683,1221,1782,1480,501,180,5164
Texas,Pecan Acres,5670,329,743,1068,931,318,3389
Texas,Asherton,832,185,218,125,30,22,580
Texas,Keller,46175,1234,4065,7819,11252,5910,30280
Texas,Millican,214,32,72,26,16,18,164
Texas,San Angelo,99634,9191,18746,19495,10381,4941,62754
Texas,Grape Creek,2701,267,887,559,186,19,1918
Texas,Mexia,7396,1241,1621,1409,416,174,4861
Texas,Kosse,767,112,286,116,1,12,527
Texas,Littlefield,6024,946,1227,993,293,179,3638
Texas,Clifton,3369,321,848,876,396,97,2538
Texas,Shady Hollow,4272,44,437,818,1334,701,3334
Texas,Coolidge,846,204,126,175,15,8,528
Texas,Arlington,392462,37553,57997,78907,48606,24255,247318
Texas,Lockhart,13548,1878,3808,2291,1064,444,9485
Texas,Barton Creek,2928,59,107,262,1201,785,2414
Texas,Hudson Bend,2059,108,201,382,630,373,1694
Texas,Weston,305,25,113,37,50,2,227
Texas,East Mountain,1311,131,317,212,129,26,815
Texas,Murphy,20528,709,1841,3119,4816,2324,12809
Texas,New London,1037,146,275,235,25,31,712
Texas,Henderson,13355,2107,2636,2662,824,450,8679
Texas,Somerset,1720,212,387,369,80,59,1107
Texas,Olmos Park,1999,68,75,150,486,575,1354
Texas,Leon Valley,11306,730,1996,2925,1565,556,7772
Texas,Hollywood Park,3342,133,285,615,1019,545,2597
Texas,Helotes,8895,151,957,1801,1749,1253,5911
Texas,Elmendorf,2077,253,466,462,78,38,1297
Texas,Florence,981,81,228,201,57,16,583
Texas,Zapata,4585,1057,916,739,284,87,3083
Texas,Falcon Mesa,248,28,51,27,0,12,118
Texas,Liberty Hill,1218,85,219,145,153,80,682
Texas,Groveton,1302,210,275,212,80,36,813
Texas,Stratford,2108,296,375,480,210,55,1416
Texas,Mingus,208,35,83,34,8,0,160
Texas,Pinehurst,2289,186,518,686,145,51,1586
Texas,Gilmer,5122,529,1005,1083,386,243,3246
Texas,Shamrock,1934,243,411,510,100,45,1309
Texas,Bowie,5059,448,1517,1131,156,131,3383
Texas,St. Jo,930,86,235,168,52,14,555
Texas,Emhouse,162,15,61,31,5,2,114
Texas,Bogata,1190,178,312,251,56,16,813
Texas,Angus,515,116,88,77,13,8,302
Texas,Van Vleck,1286,211,302,325,99,67,1004
Texas,Teague,3533,407,618,1061,178,22,2286
Texas,Kirvin,148,14,21,33,4,0,72
Texas,Comanche,4194,756,952,589,371,149,2817
Texas,Gallatin,334,34,67,78,26,10,215
Texas,Dilley,4318,776,1031,569,83,43,2502
Texas,Orange,18901,1481,4794,4565,1505,527,12872
Texas,Impact,51,12,13,0,2,0,27
Texas,Omaha,880,65,289,170,79,18,621
Texas,Lone Star,1721,200,394,381,121,69,1165
Texas,Zapata Ranch,100,24,9,23,44,0,100
Texas,Sebastian,1772,387,371,264,39,10,1071
Texas,Santa Monica,15,9,0,0,0,0,9
Texas,Seadrift,1446,234,345,221,38,18,856
Texas,Bovina,1439,285,365,153,63,4,870
Texas,Ovilla,3800,117,519,1029,820,258,2743
Texas,Appleby,588,52,128,128,61,32,401
Texas,Tulia,4706,1085,1067,842,212,60,3266
Texas,Alamo,19591,3809,3421,2511,1180,325,11246
Texas,Wilson,402,145,66,58,20,9,298
Texas,Fort Hood,25365,352,2104,4631,1216,355,8658
Texas,Briarcliff,1576,9,135,416,403,212,1175
Texas,Lake View,303,22,0,170,0,0,192
Texas,Whitehouse,8303,585,866,2179,868,544,5042
Texas,New Chapel Hill,873,87,168,224,65,47,591
Texas,Lott,724,65,204,123,108,6,506
Texas,Golinda,614,24,110,193,35,15,377
Texas,Pattison,478,91,113,75,58,26,363
Texas,Woodsboro,1626,324,410,346,60,37,1177
Texas,Blackwell,231,9,55,68,40,8,180
Texas,Wellington,2158,370,521,394,101,47,1433
Texas,Temple,73143,5037,12732,15888,8201,4923,46781
Texas,Belton,21123,2021,2938,3466,1664,1276,11365
Texas,Luling,5779,900,1296,1171,273,122,3762
Texas,Bryan,83199,10598,13415,13640,8038,5185,50876
Texas,La Vernia,1057,79,222,235,113,56,705
Texas,Christoval,401,61,124,65,57,16,323
Texas,Ozona,2943,440,734,506,147,75,1902
Texas,Leander,46419,1970,4907,10427,7566,3438,28308
Texas,Lago Vista,6730,492,1333,1681,1350,429,5285
Texas,West Lake Hills,3314,12,128,260,1039,995,2434
Texas,Encino,44,18,9,0,0,0,27
Texas,Earth,1099,198,186,169,131,26,710
Texas,Mustang Ridge,1185,173,260,206,47,22,708
Texas,West Columbia,3896,341,693,1205,140,86,2465
Texas,Elm Creek,2730,428,211,429,92,0,1160
Texas,Godley,1142,90,242,244,57,26,659
Texas,Catarina,162,61,53,18,9,0,141
Texas,Carrizo Springs,5676,1266,1088,816,165,133,3468
Texas,Vidor,10805,1263,2931,2064,502,164,6924
Texas,New Home,743,78,99,153,81,2,413
Texas,Pecos,9814,1920,1777,1824,442,226,6189
Texas,Breckenridge,5479,929,1056,894,312,252,3443
Texas,Tahoka,2602,410,592,422,193,48,1665
Texas,Taft,3012,555,639,576,63,50,1883
Texas,Sinton,5556,849,1130,1057,93,90,3219
Texas,Navarro,193,13,63,59,0,0,135
Texas,Frost,755,131,124,143,38,29,465
Texas,Corsicana,23736,3863,3796,5112,1296,763,14830
Texas,Palacios,4629,709,1249,512,164,233,2867
Texas,Markham,1469,143,436,267,130,0,976
Texas,Bronte,945,157,257,207,36,23,680
Texas,Venus,3488,417,976,727,258,59,2437
Texas,Dodson,158,57,21,12,20,0,110
Texas,Palmer,2053,300,482,358,73,12,1225
Texas,McCamey,2184,263,537,371,58,53,1282
Texas,Geronimo,798,135,254,121,39,0,549
Texas,Lakeside City,1120,19,207,319,177,63,785
Texas,Pearsall,10252,2313,2066,1575,433,58,6445
Texas,Dickinson,20529,2362,3792,4627,2239,992,14012
Texas,Cushing,527,44,191,100,15,9,359
Texas,Reklaw,456,72,108,55,19,14,268
Texas,Sanderson,759,120,200,238,48,27,633
Texas,Kermit,6614,1333,1004,1111,211,97,3756
Texas,Toyah,77,13,15,23,15,0,66
Texas,Red Oak,12366,835,1972,3102,1158,493,7560
Texas,Cantu Addition,116,33,22,15,0,0,70
Texas,Refugio,2847,289,734,611,138,67,1839
Texas,Joaquin,956,222,248,202,13,25,710
Texas,Eureka,342,22,85,79,41,15,242
Texas,Airport Road Addition,233,24,29,34,51,11,149
Texas,Woodville,2585,272,762,456,190,127,1807
Texas,Spade,120,7,48,22,0,16,93
Texas,Taft Southwest,980,259,271,114,0,0,644
Texas,Payne Springs,789,87,237,204,62,9,599
Texas,Kempner,1173,66,293,302,69,32,762
Texas,Midway South,2842,559,378,386,49,0,1372
Texas,Evant,493,53,86,125,42,6,312
Texas,Quitman,2272,220,549,632,205,85,1691
Texas,Andrews,13525,2004,2911,2117,547,235,7814
Texas,Skellytown,485,14,118,165,36,7,340
Texas,Wyldwood,2923,172,522,571,264,139,1668
Texas,Chillicothe,764,199,121,117,77,21,535
Texas,Edmonson,76,15,21,7,1,3,47
Texas,Alpine,5992,643,860,1015,1010,684,4212
Texas,Richland Hills,8052,822,1856,1728,1068,306,5780
Texas,Vanderbilt,424,3,74,48,0,11,136
Texas,Sanford,151,22,59,22,3,7,113
Texas,La Ward,197,24,45,69,7,2,147
Texas,Megargel,243,45,90,48,15,4,202
Texas,Amherst,796,143,186,137,66,14,546
Texas,Mount Enterprise,534,101,126,91,42,17,377
Texas,Flowella,21,12,0,0,0,9,21
Texas,Scenic Oaks,6106,182,534,968,1157,977,3818
Texas,St. Hedwig,1941,71,537,445,236,106,1395
Texas,Cibolo,27963,681,3448,6201,3788,2705,16823
Texas,Taylor,16811,2485,4592,3110,1114,577,11878
Texas,Granger,1321,200,489,195,71,25,980
Texas,Bartlett,2002,442,554,347,70,11,1424
Texas,Wells,708,133,163,168,31,7,502
Texas,Groom,732,67,129,176,72,41,485
Texas,Sour Lake,1998,157,588,459,113,48,1365
Texas,Fairchilds,854,93,211,175,60,22,561
Texas,Pleasanton,10450,1004,2633,1566,880,417,6500
Texas,Borger,12856,1244,2717,2913,867,338,8079
Texas,Airport Heights,44,0,6,0,0,0,6
Texas,Las Lomas,2786,827,466,102,33,0,1428
Texas,Fronton,260,155,16,0,0,0,171
Texas,Overton,2741,202,607,673,144,43,1669
Texas,Shavano Park,3667,52,209,534,830,1064,2689
Texas,Leakey,656,60,97,80,23,27,287
Texas,Alamo Heights,8193,173,378,1111,2256,1720,5638
Texas,Hutto,23980,1227,4217,5336,2967,1166,14913
Texas,Georgetown,66804,3297,10405,15085,12251,7927,48965
Texas,Morales-Sanchez,38,4,0,34,0,0,38
Texas,Moulton,965,140,282,163,43,21,649
Texas,Watauga,24526,1881,4621,5714,2144,813,15173
Texas,Haslet,1661,60,234,393,318,157,1162
Texas,Colleyville,26037,218,1739,4367,6978,5086,18388
Texas,Homestead Meadows South,6559,1364,1306,983,210,15,3878
Texas,Nordheim,282,62,66,56,20,2,206
Texas,Everman,6252,998,1614,968,201,71,3852
Texas,Quanah,2557,332,686,542,140,59,1759
Texas,Lorenzo,1173,177,295,188,18,15,693
Texas,Round Mountain,230,22,60,35,0,52,169
Texas,Boyd,1360,116,310,313,135,36,910
Texas,Addison,15626,580,1336,3215,4771,2190,12092
Texas,Annetta North,598,20,73,119,128,103,443
Texas,Bartonville,1839,60,212,314,467,198,1251
Texas,Westworth Village,2653,180,370,680,407,160,1797
Texas,Webberville,468,67,121,93,25,13,319
Texas,Patton Village,1491,299,382,217,29,0,927
Texas,Estelline,100,15,23,24,6,0,68
Texas,Harper,1012,115,204,186,121,16,642
Texas,Llano,3429,628,752,743,165,143,2431
Texas,Shoreacres,1630,74,262,467,202,132,1137
Texas,Tuscola,683,49,149,176,52,29,455
Texas,Piney Point Village,3419,15,148,205,929,1146,2443
Texas,Missouri City,73573,3970,9457,14261,14303,8081,50072
Texas,Mission Bend,39291,4365,7035,7421,3986,1834,24641
Texas,Ranchette Estates,207,60,0,0,0,0,60
Texas,Lyford,2581,530,734,266,128,74,1732
Texas,Point Comfort,757,37,184,195,43,33,492
Texas,Menard,1562,258,434,393,81,79,1245
Texas,Seagoville,16357,3226,3787,2586,682,253,10534
Texas,Lancaster,39162,3128,6895,8668,3028,1419,23138
Texas,Irving,238637,31027,30674,34661,32691,22215,151268
Texas,Nassau Bay,4083,42,94,1013,844,940,2933
Texas,Bigfoot,286,169,42,75,0,0,286
Texas,Seagraves,2774,508,562,330,104,32,1536
Texas,Seminole,7460,1283,1307,1097,572,213,4472
Texas,Petersburg,1039,191,224,181,65,37,698
Texas,West Odessa,26278,5530,4894,3564,642,252,14882
Texas,Odessa,118582,14201,20495,22695,9579,3914,70884
Texas,Hamlin,1740,150,413,289,101,32,985
Texas,Rio Grande City,14415,3440,1833,1795,997,522,8587
Texas,North Escobares,109,79,4,0,0,0,83
Texas,Los Alvarez,281,108,100,0,0,0,208
Texas,Groves,15760,1328,4128,3707,1313,352,10828
Texas,Anderson,223,18,72,57,19,9,175
Texas,Bangs,1470,187,410,356,83,25,1061
Texas,Wharton,8718,1503,1723,1796,318,326,5666
Texas,Deport,669,86,189,180,24,8,487
Texas,Fritch,2503,212,568,675,119,45,1619
Texas,Grandview,2203,235,500,415,112,66,1328
Texas,Cleburne,29878,3886,6808,5377,2139,953,19163
Texas,Pleasant Valley,323,29,84,78,39,11,241
Texas,Brookshire,5199,746,1624,487,186,61,3104
Texas,Damon,269,28,64,59,10,0,161
Texas,Hereford,14938,2155,3045,2320,754,285,8559
Texas,Seth Ward,2054,572,374,325,23,0,1294
Texas,Tulsita,0,0,0,0,0,0,0
Texas,Annetta,3014,37,255,538,771,345,1946
Texas,Sanctuary,305,20,89,71,23,2,205
Texas,Rankin,940,140,238,189,41,9,617
Texas,Mason,2109,262,409,380,155,87,1293
Texas,Whitney,2118,285,444,459,84,59,1331
Texas,Mount Calm,331,55,48,74,23,1,201
Texas,Mertens,124,4,32,43,9,2,90
Texas,Garden Ridge,3887,44,326,442,981,1074,2867
Texas,South Mountain,432,55,116,109,50,9,339
Texas,Quitaque,447,57,85,83,37,6,268
Texas,Las Lomitas,133,36,28,0,0,0,64
Texas,Windthorst,334,66,133,31,29,8,267
Texas,Mineral Wells,15041,1783,3613,2824,917,241,9378
Texas,Realitos,280,135,64,15,12,0,226
Texas,New Falcon,330,150,39,0,9,0,198
Texas,Big Lake,3324,418,793,553,138,50,1952
Texas,New Waverly,1067,87,233,191,46,42,599
Texas,Point,830,123,246,146,34,13,562
Texas,Coyanosa,209,134,38,0,0,0,172
Texas,O'Brien,101,32,10,18,8,4,72
Texas,Henrietta,3018,159,766,712,244,91,1972
Texas,Dickens,276,35,75,78,19,1,208
Texas,Eldorado,2348,428,339,500,163,61,1491
Texas,Cooper,2213,299,456,395,131,74,1355
Texas,Iowa Park,6350,383,1607,1621,448,145,4204
Texas,Prairie View,6337,91,216,328,94,124,853
Texas,Olney,3138,488,653,566,382,141,2230
Texas,Rio Hondo,2607,552,494,512,117,79,1754
Texas,El Lago,2760,57,281,659,632,269,1898
Texas,New Boston,4694,392,1424,1097,509,108,3530
Texas,Garceno,480,87,54,55,87,18,301
Texas,Coldspring,984,137,252,118,86,62,655
Texas,Windcrest,5802,291,1000,1408,1015,645,4359
Texas,Grey Forest,428,16,64,129,92,68,369
Texas,Castle Hills,4422,344,272,988,827,753,3184
Texas,Balcones Heights,3185,359,833,762,183,79,2216
Texas,Haltom City,44275,6731,9710,7574,2149,880,27044
Texas,Santa Anna,1174,158,340,277,39,21,835
Texas,Lackland AFB,6454,22,101,667,506,125,1421
Texas,Kirby,8625,915,1464,2454,663,157,5653
Texas,Hill Country Village,679,13,31,79,148,206,477
Texas,Camp Wood,1041,139,341,142,71,30,723
Texas,Thrall,779,33,200,166,59,8,466
Texas,Matador,805,71,120,230,62,9,492
Texas,Waelder,1282,483,231,77,4,9,804
Texas,Lozano,234,81,0,23,0,0,104
Texas,Primera,4742,720,782,587,376,45,2510
Texas,Rancho Viejo,2832,145,224,604,493,442,1908
Texas,Villa Pancho,457,148,55,63,37,0,303
Texas,Scotland,471,38,113,76,27,20,274
Texas,Austwell,120,11,40,34,20,6,111
Texas,Redford,105,23,0,0,0,0,23
Texas,Presidio,4067,1698,405,231,275,66,2675
Texas,Graford,709,66,199,163,8,16,452
Texas,Rose City,419,45,100,97,13,11,266
Texas,Italy,1858,147,478,441,102,30,1198
Texas,Morgan,509,118,120,44,13,5,300
Texas,Cranfills Gap,368,69,90,64,7,7,237
Texas,Electra,2721,424,891,616,155,89,2175
Texas,Falcon Lake Estates,995,161,155,134,25,75,550
Texas,St. Paul,790,64,213,188,42,0,507
Texas,Lakeshore Gardens-Hidden Acres,952,129,261,252,11,0,653
Texas,Nacogdoches,33610,2298,4226,5049,2816,1793,16182
Texas,Princeton,9765,725,1622,2184,1176,248,5955
Texas,Nevada,814,53,179,150,104,48,534
Texas,Big Sandy,1747,205,321,332,124,24,1006
Texas,Gunter,1189,115,218,230,190,50,803
Texas,Plum Grove,588,111,101,143,6,2,363
Texas,Liberty,9103,909,1950,1680,539,419,5497
Texas,Sterling City,994,110,323,160,32,30,655
Texas,Aguilares,0,0,0,0,0,0,0
Texas,Muniz,1443,397,256,84,0,0,737
Texas,San Saba,3116,725,610,404,188,53,1980
Texas,Coppell,41512,796,2257,5895,11289,8295,28532
Texas,Dallas,1318806,200327,184050,192110,173416,101941,851844
Texas,Devine,4721,667,747,1085,406,81,2986
Texas,Natalia,1198,250,211,205,57,6,729
Texas,Dalhart,8545,1375,1487,1661,732,226,5481
Texas,San Leanna,563,18,133,122,111,72,456
Texas,Jonestown,2036,69,357,561,436,135,1558
Texas,Chico,1282,167,397,223,17,2,806
Texas,Manor,8595,710,1505,1753,708,299,4975
Texas,Round Rock,120157,5464,14703,24680,21344,9426,75617
Texas,The Hills,2559,28,96,403,858,430,1815
Texas,Big Wells,850,187,246,112,14,5,564
Texas,Avinger,251,14,87,65,28,6,200
Texas,Linden,2088,236,637,400,115,70,1458
Texas,Lefors,637,38,174,164,7,5,388
Texas,Meridian,1621,197,333,325,69,43,967
Texas,Sanger,8023,797,1737,1576,803,277,5190
Texas,Bridgeport,6406,1073,1255,1189,411,244,4172
Texas,Caddo Mills,1731,114,478,303,144,65,1104
Texas,Carrollton,133438,12142,19070,24245,24787,10363,90607
Texas,Riesel,1073,31,261,251,78,18,639
Texas,Dean,490,42,122,109,73,9,355
Texas,Petrolia,720,95,230,167,21,0,513
Texas,Goliad,2084,285,381,457,205,65,1393
Texas,Clear Lake Shores,1140,26,150,284,277,213,950
Texas,Plains,1180,296,153,178,70,39,736
Texas,Batesville,1274,470,154,88,39,0,751
Texas,Trent,324,38,73,83,14,5,213
Texas,Itasca,1373,225,351,284,49,36,945
Texas,New Braunfels,74587,4390,13892,15340,11398,4622,49642
Texas,Schertz,38991,1568,6377,8398,5689,3621,25653
Texas,Hillsboro,8333,1308,1568,1362,448,246,4932
Texas,Calvert,1249,150,288,267,89,3,797
Texas,Van Horn,1894,480,519,285,104,29,1417
Texas,Port Mansfield,88,0,35,26,2,25,88
Texas,Sun Valley,72,15,4,11,0,0,30
Texas,Crosbyton,1781,294,428,297,91,27,1137
Texas,Marlin,5653,1234,1471,877,142,91,3815
Texas,Beverly Hills,2398,383,474,462,52,9,1380
Texas,Graham,8746,995,2033,1679,695,317,5719
Texas,McAllen,141597,21502,16563,22425,18255,8137,86882
Texas,Angleton,19410,2229,4153,4025,1905,562,12874
Texas,Alice Acres,188,29,27,42,16,8,122
Texas,Roxton,677,94,131,140,32,13,410
Texas,Abram,1979,531,315,152,21,0,1019
Texas,Wylie,49248,2326,6876,9752,7727,2981,29662
Texas,La Porte,35386,2590,7616,9574,2970,1300,24050
Texas,Taylor Lake Village,3668,44,455,837,922,382,2640
Texas,Butterfield,4,4,0,0,0,0,4
Texas,West Sharyland,1931,694,193,151,41,11,1090
Texas,El Paso,680354,86051,98730,132807,69137,34801,421526
Texas,San Felipe,809,130,192,193,39,32,586
Texas,Needville,3063,404,665,640,314,71,2094
Texas,Horizon City,19479,1407,2696,4323,1773,535,10734
Texas,Lake Worth,4919,622,1403,1085,299,95,3504
Texas,Webster,11165,1354,1267,2156,1490,749,7016
Texas,Houston,2295982,322590,338735,349566,291163,187682,1489736
Texas,Savoy,824,71,281,207,55,17,631
Texas,Wilmer,4185,862,689,793,195,13,2552
Texas,Pampa,17793,2472,3375,3931,1221,376,11375
Texas,Shenandoah,2817,226,337,862,600,362,2387
Texas,Aurora,1498,113,334,251,111,78,887
Texas,Cresson,864,85,191,207,91,31,605
Texas,deCordova,2860,47,416,956,597,310,2326
Texas,East Bernard,2668,277,449,375,347,220,1668
Texas,Gun Barrel City,6057,770,1718,1348,394,190,4420
Texas,Meadows Place,4677,283,726,1042,880,447,3378
Texas,Niederwald,505,75,154,75,35,8,347
Texas,Scurry,505,56,80,135,63,15,349
Texas,Iola,260,23,106,53,10,4,196
Texas,Spring Valley Village,4239,61,256,243,1159,1188,2907
Texas,Von Ormy,1128,249,220,124,24,24,641
Texas,Weston Lakes,3490,86,375,701,1146,484,2792
Texas,De Kalb,1700,225,478,341,136,59,1239
Texas,Maud,1096,34,240,237,83,32,626
Texas,Port Aransas,4060,104,892,938,749,436,3119
Texas,Rancho Banquete,838,130,213,237,19,0,599
Texas,Three Rivers,1780,269,472,341,38,37,1157
Texas,Pharr,77835,15606,10793,9986,4837,1596,42818
Texas,San Marcos,61751,3739,7230,8151,6538,3149,28807
Texas,Columbus,3612,380,1122,585,324,124,2535
Texas,Port Arthur,55249,8969,12566,9259,3001,1137,34932
Texas,Converse,26246,1325,3786,6580,2128,1574,15393
Texas,Amarillo,198773,20065,33049,43734,19846,9643,126337
Texas,Timberwood Park,25976,814,2307,4920,4891,3362,16294
Texas,Whiteface,302,40,60,74,17,13,204
Texas,Bedias,334,55,103,58,21,11,248
Texas,Escobares,2529,689,305,137,46,10,1187
Texas,Horseshoe Bay,3587,122,625,902,1196,397,3242
Texas,China Grove,1241,78,296,344,182,76,976
Texas,Lone Oak,683,35,212,112,54,34,447
Texas,Hermleigh,503,85,134,75,26,17,337
Texas,Alvarado,4044,424,1035,836,217,110,2622
Texas,Burleson,44629,2010,8254,10882,5044,2412,28602
Texas,Eidson Road,9531,2940,1279,1121,256,3,5599
Texas,El Indio,23,23,0,0,0,0,23
Texas,Kerens,1735,161,321,463,84,33,1062
Texas,Ingleside on the Bay,881,66,220,191,112,56,645
Texas,Point Venture,1194,33,185,287,249,89,843
Texas,Weir,341,51,68,41,27,9,196
Texas,Brushy Creek,20024,428,1669,3831,4712,2223,12863
Texas,Siesta Shores,1477,261,154,222,74,0,711
Texas,Cedar Hill,48704,2560,6975,11569,5563,3437,30104
Texas,Tatum,1081,146,233,265,86,21,751
Texas,El Refugio,372,57,31,33,9,0,130
Texas,Falcon Village,0,0,0,0,0,0,0
Texas,Roma,11363,3434,1685,843,594,148,6704
Texas,Red Lick,1069,17,163,263,145,103,691
Texas,Wake Village,5435,240,1112,1374,590,250,3566
Texas,Barrett,3691,754,766,711,170,57,2458
Texas,Bunker Hill Village,3966,88,102,447,1000,908,2545
Texas,Crosby,2542,358,491,505,145,103,1602
Texas,Galena Park,11075,2679,1651,1459,366,94,6249
Texas,Hilshire Village,873,29,47,106,268,191,641
Texas,Katy,18094,1436,3344,3258,2723,1574,12335
Texas,Sansom Park,5250,818,1506,705,177,13,3219
Texas,Trophy Club,11790,204,638,2028,3245,1675,7790
Texas,Westover Hills,533,0,7,43,199,146,395
Texas,Hallettsville,2605,372,685,542,145,86,1830
Texas,Lake City,535,51,149,169,32,11,412
Texas,Springtown,2850,200,589,757,291,97,1934
Texas,Noonday,514,67,136,145,47,27,422
Texas,La Feria,7329,964,1352,1673,460,76,4525
Texas,New Summerfield,800,184,117,100,0,4,405
Texas,Streetman,295,33,54,51,33,12,183
Texas,Valentine,63,14,16,18,0,9,57
Texas,Roby,687,79,176,124,56,7,442
Texas,Lakeport,1120,118,226,272,67,25,708
Texas,Liberty City,2039,143,454,697,116,115,1525
Texas,Crowell,799,148,194,184,54,15,595
Texas,Aransas Pass,8113,1354,1952,1636,383,160,5485
Texas,Cuney,46,4,14,12,3,0,33
Texas,Cross Mountain,3798,23,244,826,860,710,2663
Texas,Live Oak,15595,770,2896,4086,1814,923,10489
Texas,Canyon,15182,400,1135,3301,2474,1067,8377
Texas,Universal City,20265,1143,3416,5331,2398,1487,13775
Texas,Morton,1937,433,374,305,72,27,1211
Texas,Novice,44,18,12,13,0,0,43
Texas,Shepherd,3296,404,710,696,109,23,1942
Texas,Terrell Hills,5330,80,211,572,1492,1052,3407
Texas,Radar Base,283,181,8,86,0,0,275
Texas,Mansfield,67492,2506,7743,14809,11640,5643,42341
Texas,Easton,373,61,98,88,16,8,271
Texas,San Benito,24466,4980,4412,3337,1049,545,14323
Texas,Tierra Bonita,112,18,24,8,0,15,65
Texas,Fort Davis,1029,221,177,147,105,62,712
Texas,Porter Heights,1206,189,267,484,81,0,1021
Texas,Rollingwood,1569,6,22,111,477,433,1049
Texas,Miller's Cove,209,39,9,13,0,0,61
Texas,Garfield,1533,279,329,162,107,57,934
Texas,Olton,2005,443,488,229,79,37,1276
Texas,Springlake,72,23,23,11,4,4,65
Texas,Groesbeck,4310,414,959,859,325,74,2631
Texas,Thornton,665,92,177,152,20,9,450
Texas,Garrison,1243,90,245,274,58,6,673
Texas,Higgins,555,81,106,99,48,18,352
Texas,Dimmitt,4251,703,739,726,191,171,2530
Texas,Ennis,19196,3093,3653,3300,1228,421,11695
Texas,Pecan Plantation,5987,120,903,1925,1083,884,4915
Texas,Forsan,224,33,42,48,22,10,155
Texas,Del Rio,35921,6999,5370,5646,2904,1270,22189
Texas,Vernon,10685,1728,2554,2069,767,219,7337
Texas,Lucas,7217,164,663,1371,1669,652,4519
Texas,Fair Oaks Ranch,10857,88,927,1818,3134,1654,7621
Texas,Jayton,662,97,151,106,60,55,469
Texas,Midway,296,46,50,60,19,5,180
Texas,Toco,104,14,22,35,0,0,71
Texas,George West,2579,537,416,427,181,30,1591
Texas,Edna,5784,722,1265,1245,396,93,3721
Texas,Ganado,2056,455,414,290,166,29,1354
Texas,Lake Bridgeport,410,33,102,55,37,9,236
Texas,Girard,11,0,5,3,0,3,11
Texas,New Fairview,1273,105,391,275,52,22,845
Texas,Cockrell Hill,4268,1197,796,488,108,40,2629
Texas,Combine,1832,302,423,336,107,79,1247
Texas,Rowlett,62127,2628,9898,15101,9688,4743,42058
Texas,LaCoste,1303,189,329,266,138,40,962
Texas,Friona,3936,858,794,450,222,64,2388
Texas,Texline,386,41,62,135,31,19,288
Texas,Mobile City,134,19,15,40,3,0,77
Texas,Balch Springs,25312,5375,3639,3564,669,252,13499
Texas,Chandler,2959,210,639,802,348,190,2189
Texas,Paloma Creek South,6624,222,583,1565,1429,815,4614
Texas,Paloma Creek,3340,76,361,801,578,105,1921
Texas,Moraida,41,19,0,0,0,0,19
Texas,Morgan Farm,378,72,78,91,14,7,262
Texas,Murillo,6236,829,796,904,501,146,3176
Texas,Myrtle Springs,606,189,167,86,63,10,515
Texas,Narciso Pena,0,0,0,0,0,0,0
Texas,Netos,0,0,0,0,0,0,0
Texas,Nina,20,0,0,8,0,0,8
Texas,Nocona Hills,770,68,174,252,120,84,698
Texas,Oakhurst,378,0,326,0,52,0,378
Texas,Oak Island,379,83,105,77,0,25,290
Texas,Olivia Lopez de Gutierrez,25,25,0,0,0,0,25
Texas,Olmito and Olmito,336,109,23,0,0,0,132
Texas,Orason,32,7,16,0,0,0,23
Texas,Owl Ranch,112,47,33,0,0,0,80
Texas,Pablo Pena,16,0,0,10,0,0,10
Texas,Paisano Park,86,0,8,53,0,0,61
Texas,Palo Blanco,80,30,8,0,9,0,47
Texas,Imperial,285,19,71,54,29,17,190
Texas,Montague,331,37,96,84,22,2,241
Texas,Ballinger,3669,579,996,748,323,49,2695
Texas,Fort Stockton,8414,1563,1881,1357,352,149,5302
Texas,Inez,2604,67,463,679,336,116,1661
Texas,Victoria,66939,7498,12752,13436,6130,2789,42605
Texas,Browndell,304,41,112,43,24,12,232
Texas,Jamaica Beach,1138,17,157,346,275,116,911
Texas,Botines,22,0,9,0,13,0,22
Texas,Laredo Ranchettes,72,30,0,0,0,0,30
Texas,Mirando City,381,102,73,28,9,0,212
Texas,Elkhart,1399,148,353,315,75,27,918
Texas,Ranchitos Las Lomas,308,131,88,33,23,0,275
Texas,Howardwick,395,23,107,101,37,13,281
Texas,Copper Canyon,1235,21,141,222,410,164,958
Texas,Vega,939,79,280,237,88,24,708
Texas,Van,2649,232,417,612,294,85,1640
Texas,Winfield,356,71,71,53,6,2,203
Texas,Laughlin AFB,2147,0,61,183,378,160,782
Texas,Lockney,1698,363,281,322,106,30,1102
Texas,Hartley,568,165,73,35,54,13,340
Texas,Bastrop,8736,450,1625,1800,1180,638,5693
Texas,Marathon,395,40,60,93,93,44,330
Texas,Benavides,1840,262,392,340,114,106,1214
Texas,Cameron Park,6226,1775,677,585,113,27,3177
Texas,Combes,3031,602,608,432,101,109,1852
Texas,Laguna Vista,3171,307,701,753,404,345,2510
Texas,San Pedro,334,65,74,40,18,8,205
Texas,Cleveland,7998,1452,1903,1301,372,67,5095
Texas,Bells,1385,60,252,342,169,41,864
Texas,Collinsville,1653,140,393,366,124,34,1057
Texas,Denison,23820,2060,5349,5856,2031,1172,16468
Texas,Howe,2945,236,758,686,177,64,1921
Texas,Tom Bean,1155,27,228,380,73,29,737
Texas,Ransom Canyon,1056,19,159,211,261,159,809
Texas,Wolfforth,4582,277,554,925,719,295,2770
Texas,Anna,12271,1025,2036,2163,1195,763,7182
Texas,Farmersville,3469,254,1206,656,349,35,2500
Texas,Lowry Crossing,1502,43,306,392,284,70,1095
Texas,Retreat,440,22,101,110,24,19,276
Texas,Seven Oaks,74,11,11,37,3,0,62
Texas,Seymour,2844,229,729,731,194,45,1928
Texas,Mi Ranchito Estate,347,126,13,12,0,0,151
Texas,Mikes,877,367,36,18,0,0,421
Texas,Miguel Barrera,204,76,11,0,0,0,87
Texas,Caney City,134,22,43,34,5,4,108
Texas,Nederland,17371,605,3345,4252,2175,955,11332
Texas,Rancho Chico,548,52,98,55,21,15,241
Texas,Tradewinds,206,49,46,25,13,0,133
Texas,Tyler,103721,10107,13837,23168,11984,6377,65473
Texas,Cedar Park,72415,1924,7189,14479,15767,7056,46415
Texas,Sunset Valley,547,5,41,97,138,98,379
Texas,Ravenna,193,29,42,63,8,1,143
Texas,Falfurrias,4644,600,727,745,340,197,2609
Texas,Sudan,942,139,187,167,80,31,604
Texas,Darrouzett,430,26,114,85,44,12,281
Texas,Lipscomb,38,2,11,18,5,0,36
Texas,Manvel,9143,333,1163,2277,1295,392,5460
Texas,Sealy,6441,1059,1263,1051,597,166,4136
Texas,Danbury,1391,110,229,380,116,49,884
Texas,Lake Jackson,27377,1232,4158,6396,4292,1811,17889
Texas,Iredell,352,49,96,40,34,14,233
Texas,Marble Falls,6382,858,957,1511,599,351,4276
Texas,South Alamo,3731,845,484,244,26,0,1599
Texas,Progreso,5905,1483,823,615,242,109,3272
Texas,Fayetteville,204,18,48,67,29,13,175
Texas,Channing,265,7,71,85,21,7,191
Texas,Tye,1273,143,440,158,31,17,789
Texas,Goodrich,265,34,77,54,11,0,176
Texas,Ropesville,300,58,50,84,18,6,216
Texas,Bellevue,360,43,93,71,31,0,238
Texas,Dumas,14597,2350,2212,2619,797,482,8460
Texas,Cove,365,13,72,123,43,8,259
Texas,Camp Swift,6553,1065,2181,958,362,102,4668
Texas,Friendswood,39319,1032,4779,7829,8439,4084,26163
Texas,Kingsland,6853,1087,1410,1967,430,263,5157
Texas,Talco,816,153,161,116,33,25,488
Texas,Pecan Hill,744,50,209,180,52,31,522
Texas,Lindsay,459,93,107,83,0,18,301
Texas,Archer City,1772,103,489,277,216,61,1146
Texas,Maypearl,781,31,214,171,27,5,448
Texas,Palmview,5740,1510,1056,564,203,188,3521
Texas,Richwood,3851,244,650,1003,304,144,2345
Texas,Elsa,7142,1638,1587,675,258,35,4193
Texas,Junction,2436,316,572,371,170,98,1527
Texas,Kingsville,25782,2951,3580,3847,2256,1001,13635
Texas,Los Minerales,33,6,12,5,0,0,23
Texas,Los Fresnos,93,9,19,17,0,0,45
Texas,Los Huisaches,13,0,0,13,0,0,13
Texas,Los Lobos,0,0,0,0,0,0,0
Texas,Los Nopalitos,79,19,0,0,0,0,19
Texas,Los Veteranos I,0,0,0,0,0,0,0
Texas,Los Veteranos II,31,7,24,0,0,0,31
Texas,McDade,748,90,188,85,37,15,415
Texas,Macdona,240,45,100,32,0,0,177
Texas,McKinney Acres,1021,288,344,66,0,0,698
Texas,Manchaca,1031,26,178,301,160,60,725
Texas,Manuel Garcia,478,190,39,0,0,0,229
Texas,Manuel Garcia II,0,0,0,0,0,0,0
Texas,Martinez,0,0,0,0,0,0,0
Texas,Matagorda,317,24,65,136,31,0,256
Texas,Mentone,33,17,0,13,0,0,30
Texas,Mesquite,338,160,25,0,10,0,195
Texas,Los Ebanos CDP (Starr County),582,159,12,124,55,0,350
Texas,Rhome,1737,178,385,381,181,34,1159
Texas,Los Ebanos CDP (Hidalgo County),112,65,0,47,0,0,112
Texas,San Elizario,9197,2188,1404,895,603,21,5111
Texas,College Station,110782,2731,5553,12129,13896,13982,48291
Texas,Alton,16566,3675,2388,1844,601,259,8767
Texas,Heidelberg,1385,324,146,262,25,35,792
Texas,Hidalgo,13760,3155,1429,1379,1342,201,7506
Texas,Lopezville,3212,1120,238,245,188,0,1791
Texas,Mission,83709,13351,10528,11280,8574,3127,46860
Texas,Monte Alto,2029,355,301,231,100,27,1014
Texas,North Alamo,4447,993,387,814,266,66,2526
Texas,Palmhurst,2698,313,201,452,482,303,1751
Texas,Sullivan City,4141,1381,553,358,112,36,2440
Texas,Villa Verde,374,163,101,87,0,0,351
Texas,Bertram,1731,95,435,348,164,23,1065
Texas,Highland Haven,523,9,138,193,105,28,473
Texas,E. Lopez,210,17,27,38,22,0,104
Texas,J.F. Villareal,0,0,0,0,0,0,0
Texas,Lago Vista,39,26,0,0,0,0,26
Texas,Ranchitos del Norte,1083,82,263,81,0,0,426
Texas,Los Corralitos,69,69,0,0,0,0,69
Texas,Alvord,1165,74,236,228,68,34,640
Texas,Reno city (Lamar County),3272,169,675,894,472,211,2421
Texas,Jacksboro,4383,804,1146,698,182,149,2979
Texas,Onalaska,2714,278,908,552,118,20,1876
Texas,Oak Ridge town (Cooke County),177,24,36,38,0,0,98
Texas,Hurst,38986,3488,6517,8708,5354,2155,26222
Texas,Briar,4685,441,1285,1220,550,130,3626
Texas,Hudson Oaks,2351,63,278,713,567,165,1786
Texas,Forest Hill,12913,2398,2331,2169,589,332,7819
Texas,Kennedale,7998,819,1538,1404,967,512,5240
Texas,Port Neches,12853,660,2501,3540,1431,720,8852
Texas,Millsap,260,37,66,70,11,6,190
Texas,El Cenizo,3248,1011,383,165,46,2,1607
Texas,Rio Bravo,4791,1416,558,348,185,6,2513
Texas,Hudson,4864,399,1047,1149,268,84,2947
Texas,Clyde,3801,264,968,538,348,79,2197
Texas,Flatonia,1556,219,524,216,110,34,1103
Texas,Double Oak,3065,57,255,566,865,385,2128
Texas,Lakewood Village,479,22,87,140,117,24,390
Texas,Riverside,475,62,164,111,22,7,366
Texas,Oak Grove,779,49,172,175,81,32,509
Texas,Cottonwood,222,12,55,68,14,26,175
Texas,Navasota,7432,1262,1502,1030,341,325,4460
Texas,Crockett,6534,1219,1424,977,402,155,4177
Texas,Mount Vernon,2746,345,519,609,305,144,1922
Texas,Abilene,123676,10470,23745,24401,11328,5704,75648
Texas,Lueders,205,54,53,27,8,1,143
Texas,Driscoll,612,158,113,26,38,0,335
Texas,Hungerford,141,0,70,0,33,0,103
Texas,Rocksprings,1401,321,328,162,55,14,880
Texas,San Diego,4109,1136,717,502,93,75,2523
Texas,Beckville,928,157,233,158,12,15,575
Texas,Gary City,397,41,86,60,18,16,221
Texas,Sabinal,1655,341,313,205,73,17,949
Texas,Beeville,13044,1722,2326,2888,478,221,7635
Texas,Normanna,138,17,48,8,0,21,94
Texas,Pawnee,151,32,50,28,0,0,110
Texas,Fulton,1451,207,292,345,152,96,1092
Texas,Marshall,23315,2537,5172,4416,1797,813,14735
Texas,Uncertain,59,13,23,15,6,2,59
Texas,Broaddus,269,19,68,50,13,5,155
Texas,Woodcreek,1543,49,186,390,427,255,1307
Texas,Sonora,3330,557,640,571,341,98,2207
Texas,Snyder,11456,1671,2005,1937,845,494,6952
Texas,Arroyo Colorado Estates,567,142,96,86,0,24,348
Texas,Bixby,471,139,41,76,19,0,275
Texas,Lasana,137,17,8,40,17,10,92
Texas,Diboll,5308,1049,1154,994,287,82,3566
Texas,Highland Village,16342,250,1355,3093,4400,2022,11120
Texas,Justin,3660,207,610,953,567,223,2560
Texas,Krum,4973,262,689,981,865,383,3180
Texas,Sandy Hollow-Escondidas,301,64,33,57,58,0,212
Texas,Lake Dallas,7832,409,1371,2065,986,300,5131
Texas,Ponder,1973,145,416,433,177,134,1305
Texas,Lufkin,35874,4453,6257,7382,3383,1567,23042
Texas,El Campo,11670,1738,2005,2214,716,437,7110
Texas,Blanket,346,37,90,74,23,4,228
Texas,Brownwood,18820,1920,4542,3240,1703,646,12051
Texas,Spring,58756,3313,10532,14719,6392,2692,37648
Texas,Lake Brownwood,1383,96,320,352,119,24,911
Texas,Oak Point,3878,151,521,970,990,257,2889
Texas,La Paloma-Lost Creek,586,50,111,91,10,6,268
Texas,Warren City,362,34,75,102,30,7,248
Texas,Gladewater,6085,864,1161,1333,507,85,3950
Texas,Crowley,15189,707,2597,3901,1542,478,9225
Texas,Joshua,7106,679,1567,1670,375,275,4566
Texas,Robert Lee,1134,137,273,237,96,84,827
Texas,Bay City,17681,2982,2982,3268,1374,427,11033
Texas,Mildred,474,37,69,122,43,10,281
Texas,Detroit,921,70,209,195,30,19,523
Texas,Heath,8410,254,774,1208,2093,1352,5681
Texas,Albany,1840,175,262,439,193,80,1149
Texas,Barstow,522,104,70,44,12,6,236
Texas,Nazareth,300,2,84,55,22,25,188
Texas,Milford,732,88,176,185,22,8,479
Texas,Balmorhea,609,93,138,111,72,8,422
Texas,Texhoma,350,26,141,78,33,5,283
Texas,Trinity,2754,473,772,514,66,18,1843
Texas,Burkburnett,11170,769,2547,2623,1195,410,7544
Texas,Portland,16865,929,2840,4215,2012,947,10943
Texas,Lincoln Park,78,14,16,24,0,4,58
Texas,Doolittle,3531,702,389,349,57,0,1497
Texas,Kenedy,3433,574,537,656,286,30,2083
Texas,Moody,1640,209,392,293,50,18,962
Texas,Wimberley,2923,148,289,1033,554,389,2413
Texas,Madisonville,4631,734,957,662,320,56,2729
Texas,Agua Dulce,3061,671,536,225,100,11,1543
Texas,Rangerville,47,14,0,10,13,10,47
Texas,North Cleveland,235,58,46,46,5,0,155
Texas,Prosper,19103,263,1432,3022,4395,2027,11139
Texas,St. Paul,1017,53,154,191,193,74,665
Texas,Ore City,1109,125,238,243,68,0,674
Texas,Union Grove,457,49,72,105,20,2,248
Texas,Havana,411,130,92,51,0,0,273
Texas,La Villa,2655,673,515,215,78,0,1481
Texas,Mercedes,16648,3054,2866,2514,862,401,9697
Texas,Willow Park,5110,50,527,1185,1152,567,3481
Texas,Weimar,2356,310,551,408,239,103,1611
Texas,Ross,262,30,47,67,29,23,196
Texas,Karnes City,3367,564,789,385,233,88,2059
Texas,Kyle,39857,2719,5770,8443,5121,2806,24859
Texas,La Joya,4268,912,598,490,151,98,2249
Texas,Willis,6408,1104,1182,921,309,17,3533
Texas,Fredericksburg,11157,903,2365,2075,1957,888,8188
Texas,Fairfield,2922,323,648,709,140,92,1912
Texas,Moran,290,24,89,95,4,9,221
Texas,Ingleside,10050,906,2296,2049,590,283,6124
Texas,Hackberry,1805,174,225,302,376,160,1237
Texas,Mount Pleasant,16100,2747,2869,2503,923,447,9489
Texas,Center,5319,787,717,611,423,91,2629
Texas,Claude,1274,139,212,355,108,92,906
Texas,Arp,941,83,251,171,87,44,636
Texas,Val Verde Park,2665,694,361,376,69,0,1500
Texas,Creedmoor,185,37,37,18,22,3,117
Texas,Pflugerville,59757,3470,8336,13391,10432,4194,39823
Texas,K-Bar Ranch,588,14,163,98,0,0,275
Texas,Benjamin,200,36,40,30,20,6,132
Texas,De Leon,2470,275,628,531,242,35,1711
Texas,West University Place,15619,111,292,984,3640,5409,10436
Texas,Humble,15861,1982,3869,3637,798,297,10583
Texas,Hunters Creek Village,4814,19,89,327,1421,1291,3147
Texas,Post,5369,1654,1103,682,327,113,3879
Texas,Hamilton,2957,530,639,599,288,75,2131
Texas,Lindale,5809,513,999,1481,831,362,4186
Texas,Linn,604,119,82,143,73,19,436
Texas,Loma Grande,99,38,31,0,0,0,69
Texas,Villa del Sol,271,37,35,68,19,0,159
Texas,Nolanville,5330,246,771,1467,416,190,3090
Texas,Pine Island,1121,163,259,204,66,34,726
Texas,Killeen,143070,7196,20614,39324,11369,4691,83194
Texas,Little River-Academy,1852,193,371,435,149,41,1189
Texas,Troy,2302,135,511,520,162,38,1366
Texas,Quail,10,3,0,4,0,3,10
Texas,Samnorwood,37,0,0,0,9,6,15
Texas,Roscoe,1378,174,235,231,159,67,866
Texas,Brazos Country,577,11,68,120,152,61,412
Texas,Cashion Community,274,14,78,63,32,31,218
Texas,Hideaway,3097,105,476,1017,625,423,2646
Texas,Jarrell,1299,113,208,261,210,58,850
Texas,Kurten,454,47,78,105,30,16,276
Texas,Petronilla,145,18,11,30,22,20,101
Texas,Salado,2897,39,380,478,569,474,1940
Texas,San Ygnacio,547,174,146,45,18,61,444
Texas,Reid Hope King,1081,268,113,50,125,0,556
Texas,Coleman,4398,721,1080,967,185,98,3051
Texas,Port Isabel,5057,829,1343,816,453,73,3514
Texas,Santa Maria,732,203,116,60,27,0,406
Texas,Loma Linda,274,0,112,33,0,0,145
Texas,Loma Linda East CDP (Jim Wells County),271,71,84,15,0,0,170
Texas,Loma Linda East CDP (Starr County),0,0,0,0,0,0,0
Texas,Loma Linda West,184,80,10,4,0,0,94
Texas,Loma Vista,271,203,32,0,0,0,235
Texas,Longoria,84,63,21,0,0,0,84
Texas,Loop,359,66,24,53,18,37,198
Texas,Los Altos,116,23,0,0,0,0,23
Texas,Los Angeles,0,0,0,0,0,0,0
Texas,Los Arcos,57,34,0,0,0,0,34
Texas,Los Arrieros,0,0,0,0,0,0,0
Texas,Los Barreras,178,0,10,20,0,41,71
Texas,Nesbitt,117,6,60,48,2,0,116
Texas,Los Centenarios,0,0,0,0,0,0,0
Texas,Cisco,3766,538,635,1024,219,150,2566
Texas,Carbon,296,42,91,68,20,7,228
Texas,Gruver,1380,228,158,186,70,37,679
Texas,Palm Valley,1706,110,131,495,330,270,1336
Texas,Mesquite,144250,17228,25793,28325,10753,4937,87036
Texas,Eden,2511,945,479,281,83,41,1829
Texas,Sandia,600,135,134,130,23,0,422
Texas,Allen,99255,2742,8780,17245,21398,12640,62805
Texas,Wheeler,1715,283,302,319,145,60,1109
Texas,Canton,3757,505,946,956,344,109,2860
Texas,Edgewood,1876,173,368,395,113,39,1088
Texas,Bayview,417,11,72,70,91,61,305
Texas,Del Mar Heights,119,24,22,0,0,0,46
Texas,El Camino Angosto,173,10,54,42,53,0,159
Texas,Parker,4534,403,422,616,914,525,2880
Texas,Indian Lake,709,149,150,67,42,13,421
Texas,Socorro,33923,8022,5255,5002,1005,288,19572
Texas,Dayton,7881,791,2190,1498,389,260,5128
Texas,Highland Park,9145,86,118,785,3013,2489,6491
Texas,Sunnyvale,6284,282,763,1127,1168,760,4100
Texas,Poteet,3429,783,1101,380,70,28,2362
Texas,Hughes Springs,1823,195,502,373,128,45,1243
Texas,Mertzon,852,33,170,188,73,24,488
Texas,Laguna Heights,3155,1021,616,127,34,0,1798
Texas,Slaton,5995,723,1273,1241,443,179,3859
Texas,Lubbock,250415,20256,36556,43957,27322,16441,144532
Texas,Idalou,2018,343,461,297,188,66,1355
Texas,Lamar,1121,89,238,392,41,84,844
Texas,La Minita,88,30,10,20,0,0,60
Texas,Lantana,9536,232,646,1296,2361,1303,5838
Texas,La Paloma Addition,298,42,21,93,0,0,156
Texas,La Paloma Ranchettes,228,9,21,42,35,0,107
Texas,Laredo Ranchettes West,0,0,0,0,0,0,0
Texas,Las Haciendas,0,0,0,0,0,0,0
Texas,Las Palmas,48,0,0,48,0,0,48
Texas,Las Palmas II,1480,453,263,153,0,0,869
Texas,Las Pilas,0,0,0,0,0,0,0
Texas,Las Quintas Fronterizas,1914,509,241,290,129,0,1169
Texas,La Tina Ranch,920,157,197,174,0,0,528
Texas,Leming,412,182,76,17,0,0,275
Texas,Ames,1247,126,280,281,40,28,755
Texas,Southmayd,1007,137,242,218,22,14,633
Texas,Whitesboro,3961,249,823,1135,292,130,2629
Texas,Whitewright,1717,167,317,346,181,71,1082
Texas,Lolita,819,107,184,191,77,0,559
Texas,La Loma de Falcon,126,50,28,8,11,0,97
Texas,Aubrey,3313,204,632,832,397,167,2232
Texas,Poynor,302,31,56,83,15,1,186
Texas,Sweeny,3739,258,910,828,219,38,2253
Texas,Wild Peach Village,1924,152,495,477,127,41,1292
Texas,Melvin,170,57,28,26,15,2,128
Texas,Covington,255,26,67,50,10,8,161
Texas,Bonham,10106,1561,2537,2215,457,420,7190
Texas,Dodd City,337,32,103,57,18,14,224
Texas,Honey Grove,2172,246,481,339,219,62,1347
Texas,San Antonio,1486521,170789,247266,286197,157774,88139,950165
Texas,Sachse,25133,1974,3751,5398,3608,1687,16418
Texas,Farmers Branch,35552,3862,4941,6323,6436,2780,24342
Texas,Ferris,2612,466,446,424,113,77,1526
Texas,Castroville,2970,282,528,710,410,180,2110
Texas,Port Lavaca,12303,1663,2785,2382,819,516,8165
Texas,San Perlita,760,167,142,92,44,0,445
Texas,Ralls,1711,316,394,275,63,39,1087
Texas,Bryson,551,61,146,43,24,5,279
Texas,DeSoto,53030,3585,7675,14006,6288,3589,35143
Texas,Bruceville-Eddy,1509,112,403,323,65,28,931
Texas,Rockwall,43157,2141,4774,9408,7662,4235,28220
Texas,Richland,205,22,59,68,12,0,161
Texas,Homestead Meadows North,5665,958,799,818,431,185,3191
Texas,Loraine,447,69,127,73,10,7,286
Texas,Dublin,3589,590,449,724,308,123,2194
Texas,Stephenville,20396,1042,2272,3349,2157,1176,9996
Texas,Brazoria,3094,306,734,766,149,69,2024
Texas,Freeport,12098,1987,2130,1545,433,85,6180
Texas,Aquilla,148,19,60,23,5,2,109
Texas,Tynan,244,56,43,22,18,0,139
Texas,Carthage,6646,600,1333,1393,646,158,4130
Texas,Uvalde,16277,3036,2460,3380,1052,412,10340
Texas,Uvalde Estates,1292,216,198,266,94,0,774
Texas,Azle,12149,729,2925,2995,1180,634,8463
Texas,Baird,1720,150,482,419,186,26,1263
Texas,Cross Plains,1101,74,318,208,87,17,704
Texas,Nome,405,9,71,114,60,26,280
Texas,Bailey,260,37,73,43,8,6,167
Texas,Oak Valley,430,57,105,120,21,10,313
Texas,Burke,800,114,212,167,30,18,541
Texas,Lake Meredith Estates,357,81,121,155,0,0,357
Texas,Mustang,0,0,0,0,0,0,0
Texas,Blooming Grove,704,53,182,170,52,4,461
Texas,Marfa,1788,324,216,242,227,190,1199
Texas,Wichita Falls,104494,9408,19762,20266,10475,5106,65017
Texas,Wink,739,63,145,150,61,14,433
Texas,Carrizo Hill,965,174,213,48,56,0,491
Texas,Ladonia,675,75,163,168,33,8,447
Texas,Fifth Street,2047,441,265,173,0,11,890
Texas,Pecan Grove,16651,507,2120,3987,3725,1828,12167
Texas,Pine Forest,709,89,229,141,46,2,507
Texas,Pleak,1475,220,286,325,112,62,1005
Texas,Oak Ridge North,3136,45,581,910,480,226,2242
Texas,Pinehurst,6157,779,1190,848,520,193,3530
Texas,Stagecoach,653,18,128,166,101,31,444
Texas,Lytle,2886,322,961,534,240,74,2131
Texas,Marietta,93,18,33,16,7,7,81
Texas,Hillcrest,858,25,132,261,148,100,666
Texas,San Juan,36740,8287,4958,4568,2023,800,20636
Texas,Beach City,2620,113,313,819,370,143,1758
Texas,Waxahachie,34285,2770,5896,8092,3649,1189,21596
Texas,Alma,359,61,81,85,23,12,262
Texas,Thorntonville,601,111,100,129,20,10,370
Texas,Wortham,1176,119,247,270,57,24,717
Texas,Lakeview,70,15,27,9,3,0,54
Texas,Magnolia,2207,166,468,501,204,44,1383
Texas,Montgomery,988,28,137,211,132,43,551
Texas,Wells Branch,12227,534,2476,2454,2445,1038,8947
Texas,Martindale,1012,173,284,133,97,78,765
Texas,La Feria North,133,45,64,0,12,0,121
Texas,La Paloma,3504,886,613,257,45,51,1852
Texas,Laureles,4788,1165,640,481,337,149,2772
Texas,Hardin,734,104,218,99,30,28,479
Texas,Pottsboro,2452,49,407,647,325,109,1537
Texas,Fairview,8665,63,555,1634,2852,1389,6493
Texas,Frisco,165700,3559,9500,24773,39961,25460,103253
Texas,Holland,1339,141,341,215,63,29,789
Texas,Brundage,0,0,0,0,0,0,0
Texas,Hart,1172,255,247,124,38,15,679
Texas,Bridge City,8004,332,1867,2084,796,117,5196
Texas,Weslaco,39871,6270,5632,6427,3238,1620,23187
Texas,Burnet,6216,504,1479,1697,624,186,4490
Texas,Oglesby,736,84,147,172,55,6,464
Texas,Canadian,3138,466,529,477,279,85,1836
Texas,Agua Dulce,836,107,215,127,46,20,515
Texas,Bishop,3112,447,665,524,234,71,1941
Texas,Sadler,651,31,159,195,19,4,408
Texas,Daisetta,698,74,248,91,39,18,470
Texas,Dayton Lakes,108,45,29,0,0,0,74
Texas,Devers,434,112,86,103,18,11,330
Texas,Sherman,41149,3965,7559,9336,3535,1616,26011
Texas,Buffalo Springs,488,26,92,172,51,20,361
Texas,Josephine,1243,101,388,264,94,31,878
Texas,Melissa,8492,215,1129,2133,1060,587,5124
Texas,Plano,284579,13006,24714,47392,68901,42768,196781
Texas,Sweetwater,10701,1463,2281,2179,496,187,6606
Texas,Morgan's Point Resort,4401,83,747,1166,844,209,3049
Texas,Rogers,1216,76,395,302,36,8,817
Texas,Keene,6339,629,907,1045,691,199,3471
Texas,Rio Vista,1039,95,201,193,69,15,573
Texas,Quemado,169,169,0,0,0,0,169
Texas,Sulphur Springs,15948,1823,4067,2762,1348,522,10522
Texas,Premont,2603,604,700,413,100,37,1854
Texas,Cumby,712,73,196,134,42,19,464
Texas,Latexo,387,46,107,76,12,10,251
Texas,Morse,121,15,25,13,8,7,68
Texas,Seven Points,1305,227,399,200,60,21,907
Texas,Central Gardens,4197,103,1045,1276,374,287,3085
Texas,Knippa,642,143,142,30,37,21,373
Texas,Tuleta,344,41,89,64,30,0,224
Texas,Utopia,228,29,19,68,4,0,120
Texas,Blue Berry Hill,625,157,118,78,0,0,353
Texas,Hebbronville,4662,737,1106,619,191,36,2689
Texas,Pettus,386,29,80,158,20,0,287
Texas,Reno city (Parker and Tarrant Counties),2811,344,778,582,120,76,1900
Texas,Carmine,177,2,47,48,33,16,146
Texas,Buckholts,435,79,147,64,6,5,301
Texas,Hewitt,14347,817,2387,3584,2148,1130,10066
Texas,Robinson,11569,482,2154,2817,1117,690,7260
Texas,Sierra Blanca,705,119,152,139,57,0,467
Texas,Lipan,402,34,95,96,29,8,262
Texas,Tolar,770,65,136,137,179,14,531
Texas,Big Spring,28367,4079,6441,6160,1489,634,18803
Texas,Childress,6203,678,1705,1204,512,119,4218
Texas,Duncanville,39630,4084,6842,8337,3519,2289,25071
Texas,Garrett,1062,230,148,100,25,2,505
Texas,Schulenburg,2893,483,724,403,294,51,1955
Texas,South Fork Estates,58,17,7,25,0,0,49
Texas,Rockdale,5554,623,1557,1166,135,122,3603
Texas,Bellmead,10431,2073,1949,1709,343,186,6260
Texas,Crawford,732,28,165,184,42,28,447
Texas,Lacy-Lakeview,6629,746,1082,1800,252,102,3982
Texas,Lorena,2026,75,256,532,272,100,1235
Texas,McGregor,5093,617,1196,919,193,207,3132
Texas,Runge,1040,175,300,154,38,29,696
Texas,Mountain City,732,5,71,166,157,101,500
Texas,Granbury,9593,638,2389,2204,1240,608,7079
Texas,Hooks,2747,201,742,619,169,72,1803
Texas,San Patricio,368,33,78,153,31,10,305
Texas,Bullard,3039,158,403,682,390,101,1734
Texas,Aldine,15822,4526,2666,1276,205,104,8777
Texas,Baytown,76581,10401,12235,17096,5034,2174,46940
Texas,Bellaire,18733,302,738,1440,4281,6216,12977
Texas,Thorndale,1252,216,221,280,176,13,906
Texas,Cloverleaf,24953,5112,3580,3474,1187,739,14092
Texas,Panhandle,2728,70,488,541,359,309,1767
Texas,Domino,107,3,33,23,25,0,84
Texas,Early,2923,152,453,755,370,104,1834
Texas,Scottsville,389,30,94,68,23,9,224
Texas,Waskom,1887,295,698,373,99,62,1527
Texas,Mabank,3194,211,913,730,103,196,2153
Texas,Terrell,17378,1761,3915,3755,1233,505,11169
Texas,Corrigan,1794,270,437,320,56,72,1155
Texas,West Livingston,8134,1947,2213,1476,444,145,6225
Texas,Callisburg,391,7,104,102,29,4,246
Texas,Gainesville,16275,2232,3465,3087,837,443,10064
Texas,Cameron,5455,750,1374,1027,390,67,3608
Texas,Gholson,1039,152,303,308,59,18,840
Texas,Conroe,80893,10717,12886,15365,8886,4500,52354
Texas,Panorama Village,3179,127,620,744,551,204,2246
Texas,Splendora,1850,261,396,396,109,13,1175
Texas,Circle D-KC Estates,2674,268,576,701,276,107,1928
Texas,Christine,300,73,86,49,9,6,223
Texas,Bloomburg,562,17,132,80,17,15,261
Texas,McLean,962,115,196,237,48,3,599
Texas,Hedwig Village,2675,40,222,245,631,546,1684
Texas,Highlands,7432,1016,1599,1550,302,212,4679
Texas,Lake Tanglewood,791,11,95,219,241,119,685
Texas,Hawley,628,48,136,142,49,0,375
Texas,Barry,261,53,53,59,11,3,179
Texas,Dawson,900,150,158,201,65,35,609
Texas,Goodlow,140,12,70,27,6,1,116
Texas,Miles,988,108,227,125,77,38,575
Texas,Winters,2866,618,549,296,143,50,1656
Texas,Tenaha,1402,289,336,193,47,4,869
Texas,Timpson,1287,188,228,281,72,33,802
Texas,Grandfalls,359,65,84,43,35,12,239
Texas,Wickett,556,62,198,103,12,2,377
Texas,Holliday,1483,115,371,376,102,45,1009
Texas,Pecan Gap,166,29,40,57,5,15,146
Texas,Cuevitas,0,0,0,0,0,0,0
Texas,Abbott,328,16,47,71,51,30,215
Texas,Arcola,2221,498,325,179,100,27,1129
Texas,Four Corners,12465,1241,1384,2310,1462,858,7255
Texas,Sienna Plantation,16996,285,1108,2309,3627,2304,9633
Texas,Kilgore,14867,1985,2558,3199,1162,490,9394
Texas,Clarksville City,744,49,228,182,51,28,538
Texas,Dell City,216,82,12,35,9,6,144
Texas,Hays,227,17,37,70,42,14,180
Texas,Point Blank,748,88,256,142,67,34,587
Texas,La Grulla,1582,486,276,153,38,0,953
Texas,La Puerta,520,183,36,27,78,0,324
Texas,Santa Cruz,17,17,0,0,0,0,17
Texas,Pearland,117867,4204,12281,24835,21543,13891,76754
Texas,Leary,619,66,137,141,38,17,399
Texas,Redwater,1152,69,323,254,72,27,745
Texas,Pasadena,154193,26254,28493,24410,8996,4090,92243
Texas,Throckmorton,732,123,183,123,75,22,526
Texas,South Houston,17627,4337,3317,1597,505,180,9936
Texas,Buchanan Dam,1466,124,442,430,206,82,1284
Texas,Goree,419,53,86,86,24,2,251
Texas,Oakwood,765,66,201,149,59,0,475
Texas,Mart,1994,162,524,400,93,38,1217
Texas,Valley Mills,1300,142,319,250,84,26,821
Texas,Woodway,8800,343,751,1877,2163,1191,6325
Texas,Buda,14503,320,1904,2574,3209,1176,9183
Texas,Dripping Springs,3277,284,516,499,525,256,2080
Texas,Stafford,18110,1724,3132,3462,3029,1376,12723
Texas,Sugar Land,118182,5002,9950,17106,28323,20549,80930
Texas,Huntington,2320,260,567,643,49,50,1569
Texas,Channelview,41930,7667,7653,6261,1345,521,23447
Texas,Somerville,1594,134,393,242,66,36,871
Texas,Sunray,1976,309,345,330,151,42,1177
Texas,Waller,2845,329,522,527,109,76,1563
Texas,Alice,19146,3064,4280,3063,1372,464,12243
Texas,Sunrise Beach Village,943,42,139,256,229,89,755
Texas,Orange Grove,1712,195,442,193,117,4,951
Texas,Rancho Alegre,1448,347,392,127,31,0,897
Texas,Westdale,15,0,15,0,0,0,15
Texas,Munday,1184,147,288,173,86,59,753
Texas,Gustine,457,53,141,70,21,6,291
Texas,Stonewall,626,162,71,79,167,6,485
Texas,Memphis,2259,416,390,514,98,71,1489
Texas,Turkey,320,55,52,63,23,11,204
Texas,The Woodlands,109843,1904,7348,16530,28970,19066,73818
Texas,Tomball,11644,596,2227,2497,1752,774,7846
Texas,Woodloch,216,8,57,55,11,6,137
Texas,Elgin,9616,1460,1829,1708,520,223,5740
Texas,Snook,576,55,126,151,14,12,358
Texas,Smithville,4256,524,975,933,448,226,3106
Texas,Cactus,3205,1184,220,139,23,0,1566
Texas,Kemah,2831,225,250,830,415,154,1874
Texas,Grand Prairie,191104,23633,32878,34186,19083,8289,118069
Texas,Lewisville,104789,8864,15051,21686,17296,6518,69415
Texas,Falls City,935,67,215,175,175,0,632
Texas,Bear Creek,390,5,31,61,120,74,291
Texas,Grapeland,1725,156,448,392,119,19,1134
Texas,Lovelady,616,37,174,110,31,61,413
Texas,Coahoma,819,86,189,202,69,10,556
Texas,Tira,254,25,64,51,20,4,164
Texas,Anson,2076,238,421,410,146,57,1272
Texas,Stamford,2930,341,903,519,251,101,2115
Texas,Robstown,11494,2377,2184,1565,500,243,6869
Texas,Spofford,240,60,26,34,0,0,120
Texas,Huntsville,41079,3546,8795,6254,3836,1624,24055
Texas,Jasper,7586,741,1993,1028,391,276,4429
Texas,San Leon,5106,900,1098,1100,452,231,3781
Texas,Kirbyville,2558,372,739,452,30,49,1642
Texas,Bayou Vista,1658,58,333,604,409,161,1565
Texas,Santa Fe,13241,736,3295,3785,912,242,8970
Texas,Como,797,121,144,174,3,6,448
Texas,Fowlerton,314,52,178,0,17,0,247
Texas,Brownsville,182679,37104,24312,22900,14539,5092,103947
Texas,Bailey's Prairie,759,41,83,267,82,56,529
Texas,McLendon-Chisholm,2589,42,391,473,484,260,1650
Texas,Industry,273,13,80,67,36,15,211
Texas,Bellville,4234,434,681,1196,595,182,3088
Texas,Bonney,246,5,43,86,34,0,168
Texas,Brookside Village,1814,135,413,481,154,103,1286
Texas,Clute,11524,2016,2288,2146,776,212,7438
Texas,Iowa Colony,1056,101,244,161,84,67,657
Texas,Jones Creek,2192,241,479,512,122,22,1376
Texas,Rice,917,178,169,180,55,14,596
Texas,Oyster Creek,1278,212,329,258,33,17,849
Texas,Quintana,14,0,4,6,1,2,13
Texas,Surfside Beach,593,54,122,194,86,28,484
Texas,Royse City,11746,906,1815,2754,1213,468,7156
Texas,Huxley,459,55,127,113,25,15,335
Texas,Palisades,299,43,53,108,20,9,233
Texas,Nash,3350,111,808,648,156,116,1839
Texas,Hearne,4467,706,1094,684,126,105,2715
Texas,Brady,5371,880,1122,1138,345,147,3632
Texas,Hubbard,1547,154,373,360,93,35,1015
Texas,Blum,373,50,85,51,12,8,206
Texas,University Park,24954,44,498,1195,6353,5568,13658
Texas,Tioga,890,119,170,230,87,13,619
Texas,Van Alstyne,3682,164,967,851,213,113,2308
Texas,Odem,2410,528,416,428,195,39,1606
Texas,Lago,480,145,71,28,30,0,274
Texas,New Deal,776,79,166,181,24,1,451
Texas,Chireno,446,75,118,82,14,17,306
Texas,Brenham,16778,1654,3327,2694,1418,777,9870
Texas,League City,100832,3129,12099,20546,18766,10161,64701
Texas,Citrus City,3275,936,288,154,22,14,1414
Texas,Donna,16576,3705,2547,2149,863,297,9561
Texas,Rocky Mound,81,9,11,7,13,20,60
Texas,Liverpool,541,76,106,159,16,7,364
Texas,New Hope,643,53,161,125,107,38,484
Texas,Eastland,3893,377,868,810,319,228,2602
Texas,Abernathy,3074,395,651,548,269,38,1901
Texas,Fate,11705,327,1395,2263,2040,890,6915
Texas,Selma,9895,500,1280,1941,1503,925,6149
Texas,Buffalo,1949,236,416,443,48,48,1191
Texas,Paris,24842,3016,5689,5658,1783,620,16766
Texas,Thompsons,212,61,56,29,14,22,182
Texas,Winnie,3482,487,1042,516,282,155,2482
Texas,Riviera,648,152,105,114,33,22,426
Texas,Rosharon,1580,230,424,383,12,15,1064
Texas,Rosita,3471,866,393,406,0,0,1665
Texas,Salineño North,62,18,25,6,0,0,49
Texas,Sammy Martinez,44,10,0,0,0,0,10
Texas,Sam Rayburn,764,105,204,242,82,42,675
Texas,San Carlos I,63,23,13,0,0,0,36
Texas,San Carlos II,456,122,14,11,12,0,159
Texas,Sandoval,0,0,0,0,0,0,0
Texas,Sand Springs,846,111,212,181,63,29,596
Texas,San Fernando,39,39,0,0,0,0,39
Texas,San Juan,119,19,0,7,6,0,32
Texas,Santa Anna,9,0,7,2,0,0,9
Texas,Santa Rosa,234,78,27,12,0,15,132
Texas,Santel,10,0,5,0,5,0,10
Texas,Sarita,511,267,78,17,12,0,374
Texas,Savannah,6224,60,730,1158,1344,440,3732
Texas,Rivereno,19,19,0,0,0,0,19
Texas,Kingsbury,49,0,15,5,5,8,33
Texas,Ricardo,544,63,107,131,96,0,397
Texas,Redland,1429,152,276,291,0,19,738
Texas,Placedo,575,174,109,98,4,15,400
Texas,Pleasant Hill,744,166,136,128,34,17,481
Texas,Port O'Connor,971,70,163,262,79,29,603
Texas,Powderly,1021,105,328,233,50,88,804
Texas,Preston,2148,117,637,802,227,51,1834
Texas,Pueblo East,0,0,0,0,0,0,0
Texas,Pueblo Nuevo,679,192,76,18,0,0,286
Texas,Quail Creek,1633,118,392,297,327,55,1189
Texas,Quesada,0,0,0,0,0,0,0
Texas,Rafael Pena,0,0,0,0,0,0,0
Texas,Ramireno,69,0,14,9,0,0,23
Texas,Ramirez-Perez,49,0,23,0,0,0,23
Texas,Ramos,406,124,27,0,7,0,158
Texas,Ranchitos East,513,151,59,15,0,13,238
Texas,Rancho Viejo,148,14,22,27,0,0,63
Texas,Randolph AFB,1178,4,31,148,171,200,554
Texas,Redfield,395,87,60,27,14,0,188
Texas,Regino Ramirez,106,31,8,15,0,0,54
Texas,Plantersville,528,30,169,127,52,20,398
Texas,Roman Forest,1555,77,336,505,149,73,1140
Texas,Spring Branch,36,0,10,0,26,0,36
Texas,Valle Verde,0,0,0,0,0,0,0
Texas,Valle Vista,738,165,127,102,0,0,394
Texas,Valley View,944,131,135,213,77,35,591
Texas,Victoria Vera,112,24,59,0,0,0,83
Texas,Villarreal,168,18,28,67,0,0,113
Texas,Warren,817,0,345,134,84,0,563
Texas,Welch,181,26,29,28,13,10,106
Texas,West Alto Bonito,539,159,94,30,0,0,283
Texas,Western Lake,632,129,198,185,8,0,520
Texas,Westminster,787,44,208,189,70,0,511
Texas,Westwood Shores,1524,138,338,421,194,56,1147
Texas,Wildwood,1630,82,256,581,69,30,1018
Texas,Zarate,20,0,20,0,0,0,20
Texas,César Chávez,1374,88,348,218,89,36,779
Texas,Coyote Flats,342,36,83,77,28,17,241
Texas,Providence Village,7053,139,876,1564,1136,378,4093
Texas,Sandy Point,114,9,34,26,6,6,81
Texas,Valle Hermoso,0,0,0,0,0,0,0
Texas,Travis Ranch,3508,194,388,541,507,431,2061
Texas,Tivoli,640,102,106,122,63,14,407
Texas,Tilden,246,21,51,43,19,24,158
Texas,Seco Mines,459,107,45,38,39,30,259
Texas,Shadybrook,1871,180,306,458,153,233,1330
Texas,Sherwood Shores,1386,71,331,487,141,25,1055
Texas,Siesta Acres,2265,784,441,225,102,0,1552
Texas,South La Paloma,360,115,0,79,0,0,194
Texas,Spring Gardens,643,123,134,97,15,14,383
Texas,Staples,230,26,76,71,13,12,198
Texas,Study Butte,196,65,20,50,0,14,149
Texas,Pine Harbor,908,224,174,149,47,31,625
Texas,Tanquecitos South Acres,113,44,16,0,0,0,60
Texas,Sunset CDP (Starr County),14,0,4,3,0,0,7
Texas,Sunset Acres,0,0,0,0,0,0,0
Texas,Tanquecitos South Acres II,0,0,0,0,0,0,0
Texas,Terlingua,82,0,29,18,30,5,82
Texas,Thompsonville,198,0,0,48,49,40,137
Texas,Thunderbird Bay,546,58,137,203,53,30,481
Texas,Tierra Dorada,0,0,0,0,0,0,0
Texas,Tierra Verde,428,64,114,52,18,0,248
Texas,Sunset CDP (Montague County),485,40,113,143,0,0,296
Texas,Anahuac,2327,418,415,507,50,93,1483
Texas,Perrin,256,10,118,33,12,14,187
Texas,Pena,70,0,21,0,0,0,21
Texas,Newcastle,584,64,178,86,35,3,366
Texas,Harlingen,65449,9574,11423,10878,4424,2364,38663
Texas,Oak Trail Shores,2981,583,553,553,104,27,1820
Texas,Spearman,3250,670,671,577,177,42,2137
Texas,Crandall,3491,229,725,790,351,129,2224
Texas,Bevil Oaks,1283,41,270,472,148,69,1000
Texas,Booker,1401,209,363,256,89,43,960
Texas,Concepcion,46,18,0,0,0,0,18
Texas,Skidmore,1168,207,309,208,71,7,802
Texas,Aledo,3817,82,399,751,697,257,2186
Texas,Cool,180,19,58,37,9,15,138
Texas,Weatherford,29739,2399,5700,6822,3104,1660,19685
Texas,La Grange,4655,788,1114,657,275,94,2928
Texas,West,2809,231,590,742,259,125,1947
Texas,Todd Mission,42,1,15,14,0,3,33
Texas,Boerne,14799,638,2089,3259,2798,1091,9875
Texas,Bynum,284,33,58,61,8,6,166
Texas,Tehuacana,205,15,51,48,29,7,150
Texas,Franklin,1976,119,385,567,115,28,1214
Texas,Los Fresnos,7707,1058,1039,1220,468,95,3880
Texas,Wixon Valley,229,13,57,36,35,13,154
Texas,Rose Hill Acres,455,46,136,112,26,11,331
Texas,Smyer,605,56,116,110,40,11,333
Texas,Mineola,4644,558,1109,923,226,162,2978
Texas,Campbell,738,71,167,139,62,7,446
Texas,Greenville,26900,3043,6136,4916,2245,1228,17568
Texas,Quinlan,1549,277,380,273,106,17,1053
Texas,Wolfe City,1409,161,421,282,57,29,950
Texas,Marion,870,133,274,163,53,16,639
Texas,Garland,237982,35687,35860,44625,23982,10379,150533
Texas,Grapevine,52486,2835,5398,10542,11064,5179,35018
Texas,Richardson,114402,5590,10149,19489,26396,14913,76537
Texas,Lasara,793,201,189,83,14,13,500
Texas,Raymondville,11051,2749,2632,1267,365,115,7128
Texas,Chester,333,44,59,99,27,5,234
Texas,Colmesneil,631,54,157,120,70,11,412
Texas,Floresville,7377,1134,2093,1170,421,144,4962
Texas,Poth,2151,199,482,356,163,75,1275
Texas,Walnut Springs,846,156,209,88,38,19,510
Texas,Windom,174,8,49,27,23,5,112
Texas,Coffee City,264,13,76,73,61,17,240
Texas,Trinidad,954,121,319,126,36,27,629
Texas,Rule,597,165,172,79,19,12,447
Texas,Celeste,873,63,205,231,46,9,554
Texas,Glenn Heights,12581,1653,1989,2358,1138,471,7609
Texas,Rising Star,957,79,269,181,47,16,592
Texas,Lake Kiowa,2440,83,365,871,466,316,2101
Texas,Lexington,1454,186,349,379,100,35,1049
Texas,Stinnett,1214,172,229,327,73,53,854
Texas,Runaway Bay,1784,58,370,584,241,116,1369
Texas,Farwell,1388,267,318,277,93,45,1000
Texas,Charlotte,1605,364,468,143,29,16,1020
Texas,Hawk Cove,522,98,152,78,5,2,335
Texas,McQueeney,2543,316,585,564,322,81,1868
Texas,Seguin,28357,3779,7066,4686,2041,1033,18605
Texas,Palo Pinto,161,10,54,45,3,0,112
Texas,Fresno,24607,2398,3324,4181,2639,1555,14097
Texas,Sandy Oaks,4396,801,897,860,147,0,2705
Texas,Sonterra,2963,121,537,809,244,103,1814
Texas,La Rosita,56,10,9,0,0,0,19
Texas,Falcon Heights,22,0,0,22,0,0,22
Texas,Serenada,1502,35,293,417,258,166,1169
Texas,Winnsboro,3333,340,697,675,167,54,1933
Texas,New Berlin,689,16,178,150,42,80,466
Texas,Indian Hills,2959,984,152,172,9,0,1317
Texas,La Homa,12054,3532,1481,1154,398,65,6630
Texas,Mila Doce,6394,1826,672,467,93,44,3102
Texas,Olivarez,4246,732,517,466,195,50,1960
Texas,Pilot Point,4292,451,781,1082,267,94,2675
Texas,Corpus Christi,324692,35886,60431,68069,29833,16642,210861
Texas,North San Pedro,890,255,169,125,11,0,560
Texas,Perezville,4612,1164,996,486,211,167,3024
Texas,Annetta South,534,6,64,139,117,35,361
Texas,Oilton,271,12,68,95,11,0,186
Texas,Timbercreek Canyon,471,5,73,110,101,50,339
Texas,Nocona,2960,576,838,470,141,40,2065
Texas,La Victoria,131,18,55,39,8,0,120
Texas,Hedley,276,45,48,86,29,3,211
Texas,Rockport,10957,955,2159,2429,1632,868,8043
Texas,Beaumont,118632,10940,22628,23928,11880,6418,75794
Texas,Waco,133964,14257,19620,22696,11111,6647,74331
Texas,East Tawakoni,729,51,215,177,62,27,532
Texas,Blossom,1505,163,382,352,85,25,1007
Texas,Clarksville,3198,371,1058,679,209,26,2343
Utah,Henrieville,242,24,58,54,24,4,164
Utah,Stansbury Park,9173,123,1145,1960,1421,524,5173
Utah,Dugway,459,3,89,113,67,24,296
Utah,West Valley City,135985,16260,28214,24737,8042,2956,80209
Utah,South Salt Lake,24860,2741,4181,5212,2549,1240,15923
Utah,South Jordan,68491,1088,6936,15837,10869,6066,40796
Utah,Riverton,42680,956,4574,10086,5653,2560,23829
Utah,Kingston,156,2,40,40,11,5,98
Utah,Blanding,3685,113,326,887,356,189,1871
Utah,West Haven,12916,247,2040,2868,1660,442,7257
Utah,Scofield,30,0,11,7,6,0,24
Utah,Roy,38238,1722,7965,8847,3271,1097,22902
Utah,Washington Terrace,9138,374,1939,2173,937,347,5770
Utah,Pleasant View,9806,332,1241,2058,1459,618,5708
Utah,Timber Lakes,582,20,134,110,158,64,486
Utah,Pleasant Grove,38066,857,3316,7721,5459,2456,19809
Utah,Highland,18362,159,755,2727,3280,2111,9032
Utah,Helper,2051,132,476,633,170,63,1474
Utah,Brian Head,77,5,7,21,8,9,50
Utah,Neola,452,20,87,90,19,8,224
Utah,Altamont,184,8,45,35,9,8,105
Utah,Brigham City,18924,933,3583,4500,1978,768,11762
Utah,Mantua,604,10,110,182,100,51,453
Utah,Farmington,23208,230,1926,4722,3957,2245,13080
Utah,West Point,10434,324,1443,2585,1054,541,5947
Utah,Enoch,6534,182,1004,1440,611,142,3379
Utah,Beaver,3037,195,548,677,292,94,1806
Utah,Ephraim,6987,247,611,1248,407,270,2783
Utah,Fayette,340,3,22,100,36,15,176
Utah,Glendale,236,2,39,93,27,2,163
Utah,Kanab,4529,230,691,1271,572,529,3293
Utah,Clarkston,661,19,159,148,52,22,400
Utah,Cornish,202,12,48,14,15,13,102
Utah,Fairview,1319,109,288,298,115,37,847
Utah,Moroni,1651,229,216,384,92,32,953
Utah,North Logan,10457,220,736,1733,1650,904,5243
Utah,Deweyville,395,28,91,94,33,22,268
Utah,North Salt Lake,20020,741,2230,3726,4073,1569,12339
Utah,Plain City,6560,197,1006,1627,599,196,3625
Utah,Holden,447,6,28,123,90,10,257
Utah,Riverdale,8727,422,1703,2244,901,307,5577
Utah,Goshen,1108,82,213,245,55,12,607
Utah,Sigurd,523,25,173,106,17,0,321
Utah,Hatch,167,24,43,30,15,3,115
Utah,Holladay,30746,559,2669,6373,7020,4247,20868
Utah,Bluffdale,12114,152,1738,2512,1476,569,6447
Utah,Moab,5259,308,1273,944,623,362,3510
Utah,American Fork,29384,1159,2496,6220,4343,1778,15996
Utah,West Bountiful,5578,117,989,1452,747,308,3613
Utah,Eureka,473,7,150,136,35,15,343
Utah,Kaysville,30961,251,2277,6005,5615,2500,16648
Utah,Centerville,17221,168,1663,3731,3461,1935,10958
Utah,Tremonton,8434,510,1313,1504,538,255,4120
Utah,Elwood,996,22,162,242,130,52,608
Utah,Smithfield,11102,322,1144,2201,1554,526,5747
Utah,Lewiston,2104,94,325,412,281,47,1159
Utah,Avon,231,2,49,59,20,20,150
Utah,Elsinore,750,53,195,253,55,0,556
Utah,Aneth,544,79,110,80,11,0,280
Utah,Manti,3468,153,391,1018,351,130,2043
Utah,Spring City,1062,58,204,306,149,57,774
Utah,New Harmony,180,3,30,57,20,29,139
Utah,Washington,25395,1441,2753,6457,2967,2036,15654
Utah,Hurricane,16403,667,3417,4613,1192,861,10750
Utah,Torrey,265,53,27,63,54,26,223
Utah,Vernal,10653,960,2359,1927,771,233,6250
Utah,Rush Valley,549,30,114,177,30,10,361
Utah,Oakley,1442,78,220,399,177,68,942
Utah,Coalville,1578,117,308,320,152,38,935
Utah,Sterling,246,8,31,82,23,6,150
Utah,Marysvale,706,82,250,114,64,30,540
Utah,Ogden,86126,8988,15591,17857,7023,3666,53125
Utah,Spring Lake,465,6,94,129,34,5,268
Utah,Cedar Fort,255,13,57,96,10,6,182
Utah,Junction,170,10,119,13,0,0,142
Utah,Springdale,388,2,48,149,107,36,342
Utah,Naples,2800,169,579,612,168,79,1607
Utah,Fort Duchesne,560,100,119,50,15,0,284
Utah,Summit Park,8273,265,545,975,2048,1804,5637
Utah,Lindon,10826,267,772,2177,1646,867,5729
Utah,Elmo,338,11,102,97,28,3,241
Utah,Hinckley,595,41,112,144,49,10,356
Utah,Portage,240,8,71,56,9,3,147
Utah,Charleston,629,12,86,212,69,34,413
Utah,Wendover,1118,381,57,60,62,0,560
Utah,Maeser,4392,197,791,1012,299,149,2448
Utah,Randlett,143,6,49,21,0,0,76
Utah,Whiterocks,308,48,54,28,11,0,141
Utah,Hildale,2916,280,272,252,41,13,858
Utah,Leeds,785,39,182,244,135,67,667
Utah,Woodland,181,0,51,44,23,46,164
Utah,St. George,82194,3814,11817,22145,9247,5754,52777
Utah,Paradise,1123,13,161,257,138,61,630
Utah,Peter,650,0,45,159,81,34,319
Utah,Howell,248,5,73,82,14,1,175
Utah,Clearfield,31016,1396,4949,6718,2781,871,16715
Utah,Paragonah,444,18,101,147,30,10,306
Utah,Delta,3497,372,742,612,364,165,2255
Utah,Meadow,265,11,64,64,20,11,170
Utah,Cache,0,0,0,0,0,0,0
Utah,Francis,1187,28,181,296,153,32,690
Utah,Uintah,1525,31,247,368,215,79,940
Utah,Marriott-Slaterville,2142,56,465,594,120,91,1326
Utah,Erda,2666,75,385,534,409,155,1558
Utah,Ballard,991,104,231,196,52,9,592
Utah,Santa Clara,7118,136,767,1805,935,618,4261
Utah,Genola,1255,56,203,324,102,57,742
Utah,Lehi,61508,914,4495,11479,9600,4250,30738
Utah,Orem,95428,3803,7911,18896,13241,6088,49939
Utah,Provo,116146,3664,7057,16815,13780,6584,47900
Utah,Bicknell,194,5,53,74,13,9,154
Utah,Enterprise,1635,20,315,303,183,78,899
Utah,Alpine,10430,78,569,1798,2051,1109,5605
Utah,Elberta,80,0,8,39,6,0,53
Utah,Mapleton,9509,180,747,1777,1577,860,5141
Utah,Springville,32603,1305,3054,6207,3971,1921,16458
Utah,Vineyard,4873,41,117,767,809,336,2070
Utah,Farr West,6836,284,1325,1806,736,239,4390
Utah,Harrisville,6356,99,1446,1559,717,136,3957
Utah,Huntsville,776,16,113,246,97,86,558
Utah,Oak City,715,7,88,239,73,27,434
Utah,Parowan,2965,95,555,921,244,85,1900
Utah,Price,8281,460,1288,2298,500,281,4827
Utah,Garden City,586,0,72,141,42,5,260
Utah,Cottonwood Heights,34170,661,3508,7219,7564,4786,23738
Utah,Fairfield,136,8,47,46,2,0,103
Utah,Apple Valley,799,39,148,209,100,40,536
Utah,Daniel,1092,32,193,261,164,35,685
Utah,Dutch John,133,0,71,24,4,1,100
Utah,Interlaken,109,0,42,46,10,6,104
Utah,Millcreek,60557,2202,7016,12072,13047,7779,42116
Utah,Ivins,8211,271,1471,2258,1006,771,5777
Utah,Cedar Highlands,153,0,0,0,88,15,103
Utah,Beryl Junction,44,30,6,8,0,0,44
Utah,Bluebell,249,19,64,52,24,0,159
Utah,Bonanza,0,0,0,0,0,0,0
Utah,Carbonville,1432,99,320,515,159,9,1102
Utah,Central,679,54,124,320,16,41,555
Utah,Clear Creek,14,0,0,0,0,14,14
Utah,Copperton,1041,62,334,280,82,9,767
Utah,Ophir,20,1,9,5,2,0,17
Utah,Herriman,35640,399,3863,7975,4274,1806,18317
Utah,Independence,213,6,35,37,12,9,99
Utah,Central Valley,654,30,81,210,35,48,404
Utah,Laketown,214,3,17,61,40,22,143
Utah,Redmond,712,35,206,176,35,26,478
Utah,Salina,2526,257,616,539,148,28,1588
Utah,Cove,424,0,51,72,55,88,266
Utah,Hyde Park,4467,95,475,718,673,398,2359
Utah,Richmond,2622,89,505,497,296,98,1485
Utah,Bear River City,720,21,142,214,83,15,475
Utah,Cedar Hills,10252,156,372,1891,1560,887,4866
Utah,Eagle Mountain,29919,472,2534,5981,3652,723,13362
Utah,Elk Ridge,3460,32,294,721,460,226,1733
Utah,Hanksville,248,13,71,72,22,2,180
Utah,Hooper,8458,211,1368,2185,746,437,4947
Utah,Mona,1542,57,291,335,93,45,821
Utah,Saratoga Springs,27347,285,1731,4909,4481,1540,12946
Utah,Woodland Hills,1380,20,75,302,211,160,768
Utah,Bryce Canyon City,201,0,57,30,21,0,108
Utah,Hideout,1123,97,98,108,197,63,563
Utah,Boulder,178,12,31,41,50,17,151
Utah,Castle Dale,1532,51,304,429,74,54,912
Utah,Roosevelt,6955,438,1168,1410,499,224,3739
Utah,Oljato-Monument Valley,931,68,304,161,25,9,567
Utah,Silver Summit,4210,56,270,642,853,779,2600
Utah,Peoa,257,0,47,80,79,46,252
Utah,Pine Valley,245,0,18,46,91,0,155
Utah,Randolph,755,9,188,208,32,13,450
Utah,Snyderville,6352,87,345,858,1990,1109,4389
Utah,Spring Glen,1063,0,237,400,83,43,763
Utah,Summit,260,30,73,74,6,7,190
Utah,Sutherland,23,0,0,0,23,0,23
Utah,Teasdale,150,7,0,28,54,5,94
Utah,Thatcher,712,26,144,157,25,33,385
Utah,Thompson Springs,146,0,30,24,0,0,54
Utah,Veyo,620,0,167,236,74,0,477
Utah,Wanship,606,18,122,130,66,0,336
Utah,West Wood,802,13,67,149,137,94,460
Utah,Wolf Creek,1247,51,202,240,207,252,952
Utah,Toquerville,2031,60,271,529,286,114,1260
Utah,Magna,27454,3065,6425,5326,1127,437,16380
Utah,Sandy,95420,3181,11399,22162,16332,8997,62071
Utah,Grantsville,10566,419,1585,2410,826,578,5818
Utah,Oasis,19,9,10,0,0,0,19
Utah,Newcastle,324,34,32,222,36,0,324
Utah,Mountain Green,3732,53,145,721,683,404,2006
Utah,Marion,657,10,122,144,159,18,453
Utah,West Mountain,1069,21,138,220,134,62,575
Utah,North Ogden,18943,429,3010,4631,2471,1195,11736
Utah,Manila,175,0,32,28,11,6,77
Utah,Mayfield,368,6,61,118,38,17,240
Utah,East Carbon,1341,156,322,332,55,15,880
Utah,Wellington,1491,79,248,476,95,32,930
Utah,Circleville,691,71,146,149,87,20,473
Utah,Murray,49118,2307,7737,12658,7129,3891,33722
Utah,Dammeron Valley,849,22,285,252,104,90,753
Utah,Tooele,33805,1992,6775,7496,2743,881,19887
Utah,Deseret,219,0,46,53,34,10,143
Utah,Eden,757,0,67,192,171,79,509
Utah,Emigration Canyon,1828,5,101,310,317,605,1338
Utah,Enterprise,907,0,54,223,124,38,439
Utah,Flaming Gorge,75,10,14,8,17,7,56
Utah,Fremont,241,16,24,68,49,0,157
Utah,Hoytsville,364,9,91,103,52,12,267
Utah,Jensen,130,0,30,43,0,0,73
Utah,Kenilworth,230,41,64,97,9,19,230
Utah,Liberty,1213,1,317,250,102,138,808
Utah,Echo,71,0,18,17,0,0,35
Utah,South Ogden,17010,896,3011,4342,1820,1073,11142
Utah,Loa,537,47,87,150,33,17,334
Utah,Syracuse,28342,450,3082,5983,3887,1796,15198
Utah,Bluff,142,0,30,26,43,43,142
Utah,Navajo Mountain,345,62,26,55,11,8,162
Utah,White Mesa,120,47,11,20,0,0,78
Utah,Clawson,177,4,61,46,19,0,130
Utah,Ferron,1516,63,353,482,72,32,1002
Utah,Huntington,1926,73,414,542,145,28,1202
Utah,Orangeville,1443,38,267,370,143,18,836
Utah,Alton,160,2,6,50,10,13,81
Utah,Annabella,792,21,113,226,80,42,482
Utah,Aurora,851,21,272,222,31,34,580
Utah,Glenwood,617,23,111,140,53,23,350
Utah,Koosharem,236,6,56,48,11,14,135
Utah,Mendon,1110,16,119,238,180,64,617
Utah,Richfield,7678,431,1253,1702,607,362,4355
Utah,Benson,1385,46,167,355,210,62,840
Utah,Hyrum,8065,346,1041,1554,848,286,4075
Utah,Providence,7300,91,540,1417,1162,860,4070
Utah,Wellsville,3698,105,509,631,477,189,1911
Utah,Antimony,86,24,11,24,13,2,74
Utah,Morgan,4138,62,602,932,437,279,2312
Utah,Tropic,596,18,126,141,61,29,375
Utah,Halchita,430,40,62,54,4,0,160
Utah,Cedar City,31009,1121,3804,5784,3564,2033,16306
Utah,Duchesne,1949,136,390,418,84,34,1062
Utah,Granite,928,59,51,178,226,162,676
Utah,Salt Lake City,195701,14887,21972,33263,32847,26217,129186
Utah,Payson,19699,1126,2509,4387,1783,610,10415
Utah,Heber,15056,511,1883,3021,1822,799,8036
Utah,Centerfield,1372,101,267,365,92,15,840
Utah,Vernon,369,14,63,67,29,7,180
Utah,Midway,4881,45,626,1087,1082,510,3350
Utah,Wallsburg,371,7,58,97,39,5,206
Utah,La Verkin,4268,420,880,960,260,107,2627
Utah,Salem,7808,126,790,1557,1113,413,3999
Utah,Tabiona,137,6,41,36,2,2,87
Utah,Spanish Fork,38673,1182,4385,7710,4213,2051,19541
Utah,Logan,50478,2365,4414,8070,5597,2822,23268
Utah,Spanish Valley,573,0,210,133,18,9,370
Utah,Nephi,5761,249,1203,1335,391,214,3392
Utah,Fielding,494,27,120,118,26,14,305
Utah,Castle Valley,449,25,72,143,97,79,416
Utah,Garden,220,0,41,75,33,34,183
Utah,Riverside,879,11,102,284,139,18,554
Utah,Fountain Green,1133,95,214,272,90,42,713
Utah,Tselakai Dezza,113,16,45,16,3,0,80
Utah,Lake Shore,680,18,108,270,55,18,469
Utah,Santaquin,11154,629,1594,1884,865,352,5324
Utah,Montezuma Creek,412,55,80,59,31,0,225
Utah,Cleveland,595,12,97,151,28,34,322
Utah,Emery,295,22,78,76,32,1,209
Utah,Big Water,590,12,123,193,49,20,397
Utah,Joseph,387,53,93,102,27,19,294
Utah,Monroe,2475,115,517,730,176,128,1666
Utah,Millville,1911,33,367,308,259,95,1062
Utah,Nibley,6655,164,689,1221,802,454,3330
Utah,River Heights,2002,39,169,372,377,239,1196
Utah,Snowville,144,13,58,25,5,0,101
Utah,Fruit Heights,6100,74,520,1397,1208,702,3901
Utah,White City,5527,320,888,1493,711,246,3658
Utah,Layton,75106,2557,9714,16782,9961,4372,43386
Utah,Clinton,21618,645,3770,4946,1994,881,12236
Utah,West Jordan,113089,5664,18975,26370,12226,4112,67347
Utah,Plymouth,302,19,74,80,14,2,189
Utah,Woods Cross,11287,406,1754,2434,1659,490,6743
Utah,Myton,537,85,130,101,10,9,335
Utah,Green River,851,89,208,162,53,8,520
Utah,Woodruff,228,0,46,60,7,10,123
Utah,Escalante,810,22,167,233,121,64,607
Utah,Kanosh,577,40,115,110,57,6,328
Utah,Fillmore,2521,243,458,503,203,112,1519
Utah,Monticello,2546,139,306,517,239,164,1365
Utah,Kanarraville,280,6,59,105,40,16,226
Utah,Cannonville,294,9,99,53,27,11,199
Utah,Panguitch,1773,82,458,312,216,57,1125
Utah,Halls Crossing,0,0,0,0,0,0,0
Utah,La Sal,388,138,49,137,0,4,328
Utah,Mexican Hat,0,0,0,0,0,0,0
Utah,Orderville,615,31,125,168,51,8,383
Utah,Amalga,581,48,93,82,55,23,301
Utah,Leamington,316,2,33,86,55,6,182
Utah,Newton,765,11,127,163,107,42,450
Utah,Corinne,634,25,130,168,75,13,411
Utah,Garland,2487,100,542,585,188,37,1452
Utah,Honeyville,1538,5,291,285,202,69,852
Utah,Perry,4828,53,500,1101,654,316,2624
Utah,South Willard,1908,106,339,468,181,101,1195
Utah,Willard,1805,57,381,461,186,49,1134
Utah,Bountiful,43792,1046,4676,9513,8253,4180,27668
Utah,South Weber,7159,122,699,1493,1124,568,4006
Utah,Sunset,5229,291,1211,1058,476,141,3177
Utah,Trenton,428,16,71,95,51,21,254
Utah,Wales,332,18,30,86,17,23,174
Utah,Lynndyl,95,12,15,21,13,1,62
Utah,Alta,388,0,18,112,60,46,236
Utah,Palmyra,467,41,70,132,63,52,358
Utah,Draper,47402,1422,4093,8817,8543,5852,28727
Utah,Benjamin,1017,0,141,274,160,50,625
Utah,Virgin,530,53,118,143,46,12,372
Utah,Rockville,319,9,17,109,99,20,254
Utah,Park City,8296,379,538,1417,2268,1260,5862
Utah,Kamas,2438,160,462,374,178,103,1277
Utah,Henefer,781,18,130,154,110,25,437
Utah,Lyman,337,21,59,124,26,6,236
Utah,Scipio,312,11,79,95,25,11,221
Utah,Taylorsville,60294,4035,11714,13619,6908,2583,38859
Utah,Midvale,32893,2193,5024,7544,4258,2113,21132
Utah,Kearns,37748,4627,7062,7280,1759,534,21262
Utah,Levan,877,85,224,156,46,8,519
Utah,Rocky Ridge,1054,45,135,101,26,6,313
Utah,Gunnison,3388,377,864,1061,206,85,2593
Utah,Mount Pleasant,3365,244,684,673,213,177,1991
Utah,Minersville,867,44,223,193,82,24,566
Utah,Samak,323,16,70,74,102,0,262
Utah,Milford,1651,109,405,291,106,14,925
Utah,Stockton,722,61,244,162,33,4,504
Vermont,Alburgh,529,56,181,112,35,10,394
Vermont,North Westminster,199,5,62,0,43,0,110
Vermont,Proctorsville,375,35,86,102,42,24,289
Vermont,Chelsea,381,34,93,72,25,20,244
Vermont,Hinesburg,773,2,114,129,254,41,540
Vermont,Cabot,186,13,35,29,10,35,122
Vermont,Worcester,47,0,6,3,18,10,37
Vermont,Windsor,2157,82,528,344,334,109,1397
Vermont,Wilmington,298,32,89,66,44,14,245
Vermont,Williamstown,997,69,297,334,86,21,807
Vermont,Wells,446,14,95,113,54,9,285
Vermont,Websterville,522,9,165,123,61,0,358
Vermont,Waitsfield,150,0,4,37,43,48,132
Vermont,Stowe,282,32,13,142,26,69,282
Vermont,South Royalton,616,0,169,112,87,87,455
Vermont,Rochester,308,3,64,53,65,41,226
Vermont,Richmond,391,0,95,54,122,36,307
Vermont,Readsboro,260,29,74,62,18,0,183
Vermont,Shelburne,505,53,98,58,89,95,393
Vermont,Randolph,2225,88,562,370,282,260,1562
Vermont,Quechee,231,0,30,20,80,0,130
Vermont,Putney,474,28,79,118,40,114,379
Vermont,Plainfield,413,19,63,88,58,75,303
Vermont,Troy,25,0,14,8,3,0,25
Vermont,Pittsford,602,32,222,130,129,28,541
Vermont,Springfield,4181,303,1288,988,270,198,3047
Vermont,Jacksonville,214,2,112,28,13,15,170
Vermont,Wilder,1577,42,279,247,432,138,1138
Vermont,Essex Junction,10395,311,1189,2144,1875,1417,6936
Vermont,Vergennes,2612,118,648,627,388,145,1926
Vermont,Brattleboro,6771,267,1210,1276,1054,1133,4940
Vermont,North Bennington,1709,56,185,212,179,198,830
Vermont,Winooski,7232,936,1254,1039,1069,665,4963
Vermont,South Burlington,18975,673,2246,3555,4998,3055,14527
Vermont,Waterbury,1748,102,273,274,355,190,1194
Vermont,Perkinsville,108,11,33,17,13,12,86
Vermont,Hyde Park,432,7,69,90,76,76,318
Vermont,Swanton,2371,296,778,511,129,62,1776
Vermont,St. Johnsbury,5882,463,1411,1210,692,539,4315
Vermont,Castleton,1327,27,43,39,60,46,215
Vermont,Cavendish,133,0,50,45,18,6,119
Vermont,Chester,798,8,286,139,147,102,682
Vermont,Concord,268,7,119,31,9,0,166
Vermont,Coventry,34,0,13,14,3,0,30
Vermont,Danville,399,10,60,78,75,64,287
Vermont,Dorset,250,0,28,45,91,56,220
Vermont,East Barre,627,0,141,107,61,107,416
Vermont,East Burke,66,0,11,34,8,0,53
Vermont,East Middlebury,439,0,110,51,129,58,348
Vermont,East Montpelier,44,0,0,0,17,14,31
Vermont,Canaan,330,25,120,74,5,0,224
Vermont,Enosburg Falls,1340,138,482,222,69,28,939
Vermont,South Barre,1182,93,264,219,181,81,838
Vermont,Burlington,42513,2056,4207,4768,6672,4956,22659
Vermont,Brandon,1323,102,249,198,264,169,982
Vermont,Island Pond,771,67,329,125,54,14,589
Vermont,Fair Haven,2280,195,703,399,149,137,1583
Vermont,Poultney,1552,103,269,195,112,77,756
Vermont,Arlington,1358,75,257,357,232,123,1044
Vermont,Bennington,8836,570,2447,1532,1241,591,6381
Vermont,Manchester Center,2033,141,415,381,228,251,1416
Vermont,Jericho,1430,25,63,321,358,221,988
Vermont,North Troy,744,111,179,123,26,22,461
Vermont,Morrisville,2183,192,375,593,309,147,1616
Vermont,West Brattleboro,2650,107,601,469,462,204,1843
Vermont,Ludlow,745,44,174,193,115,63,589
Vermont,Middlebury,6855,253,825,720,675,819,3292
Vermont,Barre,8711,875,1978,1945,929,549,6276
Vermont,West Burke,325,46,109,64,34,10,263
Vermont,Saxtons River,494,15,60,82,79,63,299
Vermont,White River Junction,2290,149,482,413,313,270,1627
Vermont,Albany,211,11,55,37,25,5,133
Vermont,Derby Line,758,23,156,185,78,51,493
Vermont,Wallingford,932,22,302,133,144,88,689
Vermont,West Rutland,2151,114,586,477,211,130,1518
Vermont,Orleans,897,68,263,162,70,21,584
Vermont,Barton,529,69,223,94,24,7,417
Vermont,Old Bennington,178,2,3,27,32,74,138
Vermont,Johnson,1532,65,163,234,61,105,628
Vermont,Fairlee,249,0,95,32,26,0,153
Vermont,Glover,320,74,106,38,41,0,259
Vermont,South Shaftsbury,589,38,97,101,87,45,368
Vermont,Greensboro,105,0,11,17,39,33,100
Vermont,Northfield,1945,137,414,327,180,212,1270
Vermont,Ascutney,451,100,112,123,23,0,358
Vermont,Barnet,160,12,58,43,10,9,132
Vermont,Beecher Falls,204,84,68,20,0,11,183
Vermont,Benson,257,13,94,47,7,13,174
Vermont,Bethel,674,39,192,107,68,6,412
Vermont,Cambridge,219,6,33,60,50,25,174
Vermont,Montpelier,7547,229,989,981,1694,1841,5734
Vermont,Newbury,339,16,99,58,54,23,250
Vermont,Lyndonville,1314,46,327,276,101,46,796
Vermont,Jeffersonville,793,26,133,188,131,32,510
Vermont,Westminster,282,12,89,66,44,32,243
Vermont,Manchester,741,56,108,121,241,113,639
Vermont,Graniteville,969,40,358,132,129,33,692
Vermont,Norwich,664,0,8,17,201,264,490
Vermont,Newfane,134,1,20,7,36,34,98
Vermont,Bellows Falls,2985,345,824,564,225,148,2106
Vermont,Wells River,396,66,102,72,37,12,289
Vermont,Marshfield,288,5,33,67,46,27,178
Vermont,Newport,4331,542,1252,850,353,223,3220
Vermont,Rutland,15577,1030,4169,3229,2034,1171,11633
Vermont,Fairfax,928,72,126,168,87,186,639
Vermont,Richford,1620,255,583,232,45,31,1146
Vermont,Woodstock,1517,30,135,243,396,175,979
Vermont,Bristol,1746,66,433,359,275,232,1365
Vermont,Bradford,528,85,115,118,44,17,379
Vermont,Milton,2217,169,641,559,180,44,1593
Vermont,Lowell,150,12,37,39,20,13,121
Vermont,Newport Center,302,75,67,80,20,0,242
Vermont,North Hartland,145,0,63,19,20,22,124
Vermont,North Springfield,548,105,136,195,10,0,446
Vermont,Irasburg,115,13,20,30,23,4,90
Vermont,Hartland,242,57,72,65,8,8,210
Vermont,Greensboro Bend,258,8,56,33,17,20,134
Vermont,Hardwick,1313,162,286,316,73,44,881
Vermont,Derby Center,585,114,165,105,28,4,416
Vermont,St. Albans,6824,255,1568,1320,1014,474,4631
Vermont,Groton,384,30,113,74,21,31,269
Village of Islands village; Florida,Islamorad,6473,281,1430,1586,1353,666,5316
Virginia,Cumberland,234,71,90,24,16,11,212
Virginia,Crosspointe,5879,66,148,830,935,1849,3828
Virginia,County Center,3373,33,406,600,493,346,1878
Virginia,Countryside,10042,528,896,1672,2420,1333,6849
Virginia,Concord,974,248,176,161,116,31,732
Virginia,Cluster Springs,710,84,331,140,8,11,574
Virginia,Clover,280,53,32,123,18,0,226
Virginia,Churchville,191,0,65,33,44,12,154
Virginia,Quantico,519,45,102,96,58,69,370
Virginia,Yorkshire,9582,1524,1604,1491,956,353,5928
Virginia,Boston,891,141,244,121,5,0,511
Virginia,Irvington,349,23,76,79,76,65,319
Virginia,Portsmouth,95311,7923,18923,23158,8784,4734,63522
Virginia,Bensley,6327,1426,1394,1072,195,35,4122
Virginia,Scottsburg,383,11,108,91,10,5,225
Virginia,Belle Haven,6877,348,566,754,1687,1609,4964
Virginia,Burke,42722,1403,3499,5965,9430,8937,29234
Virginia,Dunn Loring,9155,398,387,977,2223,2119,6104
Virginia,Hybla Valley,16325,2522,2514,2153,1995,1343,10527
Virginia,Rural Retreat,1644,186,411,415,121,80,1213
Virginia,Bridgewater,5983,202,917,731,1050,605,3505
Virginia,Sugar Grove,745,131,103,224,8,0,466
Virginia,Pulaski,8794,1108,2072,2233,576,467,6456
Virginia,Elkton,2823,274,901,541,245,116,2077
Virginia,Coeburn,1669,363,373,286,65,34,1121
Virginia,Chester Gap,985,80,182,216,134,43,655
Virginia,Cherry Hill,19731,1089,2279,4308,2477,1628,11781
Virginia,Carrsville,129,46,38,21,8,6,119
Virginia,Charles City,64,17,14,16,3,5,55
Virginia,Bobtown,268,0,28,82,0,72,182
Virginia,Blue Ridge Shores,926,63,273,157,109,79,681
Virginia,Bland,445,43,70,116,36,19,284
Virginia,Blairs,844,94,245,219,43,28,629
Virginia,Big Island,191,39,17,83,19,6,164
Virginia,Bethel Manor,4110,92,223,930,473,101,1819
Virginia,Bracey,1101,54,394,305,206,41,1000
Virginia,Brambleton,20081,429,743,1497,5551,3948,12168
Virginia,Brandermill,14421,432,1569,2621,3628,2277,10527
Virginia,Brightwood,1299,61,403,247,104,46,861
Virginia,Pembroke,1056,141,330,198,127,28,824
Virginia,Broadlands,13704,269,498,1242,3569,2578,8156
Virginia,Chase Crossing,272,56,151,51,0,0,258
Virginia,Buckhall,17238,864,2147,3017,2958,2384,11370
Virginia,Bull Run Mountain Estates,1287,12,234,323,198,89,856
Virginia,Burke Centre,18236,462,1543,2525,3929,3696,12155
Virginia,Callaghan,258,36,129,59,4,5,233
Virginia,Calverton,113,0,36,38,14,0,88
Virginia,Camptown,861,137,227,141,58,0,563
Virginia,Captains Cove,1266,78,336,244,204,47,909
Virginia,Carrollton,6131,145,917,1552,760,760,4134
Virginia,Boswell's Corner,1106,50,308,131,151,53,693
Virginia,Cascades,11670,324,633,1596,3279,2221,8053
Virginia,Catlett,260,13,163,34,9,0,219
Virginia,Cats Bridge,166,54,71,36,5,0,166
Virginia,Central Garage,1472,98,405,246,122,181,1052
Virginia,Buckingham Courthouse,94,0,0,9,32,28,69
Virginia,Port Royal,194,17,37,38,29,3,124
Virginia,Lowes Island,11111,259,617,1065,2952,2412,7305
Virginia,Stanardsville,307,29,97,67,15,18,226
Virginia,McKenney,493,77,131,101,21,10,340
Virginia,Dublin,2655,344,875,679,142,51,2091
Virginia,Shenandoah,2888,306,839,543,148,37,1873
Virginia,Lake Monticello,10210,253,1047,2551,1781,1742,7374
Virginia,Castlewood,2058,237,557,585,61,35,1475
Virginia,Dryden,1282,122,257,308,56,61,804
Virginia,Hillsville,2671,532,579,578,355,21,2065
Virginia,Collinsville,7031,984,1522,1845,557,309,5217
Virginia,Highland Springs,15855,1315,3871,3308,1454,347,10295
Virginia,Union Hall,1091,53,208,284,271,185,1001
Virginia,Ferrum,2233,137,340,177,84,56,794
Virginia,Eastville,206,9,37,47,20,23,136
Virginia,South Hill,4411,537,863,751,445,232,2828
Virginia,Chase City,2401,392,529,401,157,38,1517
Virginia,Ewing,127,67,23,23,14,0,127
Virginia,Exmore,1521,293,518,221,57,36,1125
Virginia,La Crosse,638,94,145,183,27,6,455
Virginia,Williamsburg,14788,317,1404,1435,1953,2174,7283
Virginia,Selma,397,58,123,80,21,45,327
Virginia,Dumbarton,9036,1097,1718,1534,1034,654,6037
Virginia,Dillwyn,541,87,146,78,23,16,350
Virginia,Warsaw,1704,274,407,372,210,81,1344
Virginia,Claremont,323,57,113,72,15,18,275
Virginia,Rocky Mount,4747,561,1234,948,303,347,3393
Virginia,Sherando,612,25,100,290,31,15,461
Virginia,Dooms,1074,138,330,242,69,70,849
Virginia,Capron,139,8,26,52,9,12,107
Virginia,Merrimac,2127,290,422,518,216,189,1635
Virginia,Christiansburg,22049,1032,3600,5044,3494,2946,16116
Virginia,Montross,430,39,81,121,59,36,336
Virginia,Waynesboro,21926,2031,4973,4377,2145,1641,15167
Virginia,Groveton,16843,2253,1804,2432,2758,1995,11242
Virginia,Franconia,19725,977,1762,3013,4656,3884,14292
Virginia,Kilmarnock,1478,174,442,333,187,60,1196
Virginia,Rose Hill CDP (Fairfax County),22011,1483,2360,3298,3813,4009,14963
Virginia,Waverly,2051,274,546,325,127,50,1322
Virginia,Laurel,17470,1513,2972,3871,2397,1316,12069
Virginia,Cheriton,508,121,139,87,40,18,405
Virginia,Mineral,507,94,173,88,15,10,380
Virginia,Windsor,2700,350,573,694,200,70,1887
Virginia,West Springfield,23202,795,1910,3142,5160,4962,15969
Virginia,Bailey's Crossroads,24570,3626,2976,2919,4125,3091,16737
Virginia,Clintwood,1434,230,358,379,99,70,1136
Virginia,Aquia Harbour,6805,141,846,1472,1287,1127,4873
Virginia,Pearisburg,2669,130,539,672,274,146,1761
Virginia,Fort Belvoir,8091,50,391,1520,841,665,3467
Virginia,Ettrick,5159,224,619,822,307,155,2127
Virginia,Sudley,17612,2600,2784,2998,1744,760,10886
Virginia,Brodnax,283,31,79,45,22,22,199
Virginia,Cape Charles,1145,84,195,242,202,182,905
Virginia,Mantua,7520,300,516,723,1392,2154,5085
Virginia,Lebanon,3249,488,838,827,263,123,2539
Virginia,East Highland Park,15592,1644,3157,3855,1754,574,10984
Virginia,Cedar Bluff,1081,112,231,312,66,39,760
Virginia,Weyers Cave,2171,153,472,364,297,142,1428
Virginia,Tappahannock,1925,215,455,324,200,104,1298
Virginia,Manassas Park,16423,2145,2564,2945,2044,1118,10816
Virginia,Hollins,14257,869,2987,3495,2117,829,10297
Virginia,Monterey,125,8,35,44,19,12,118
Virginia,Goshen,333,58,122,56,1,7,244
Virginia,Duffield,79,12,12,34,3,2,63
Virginia,Greenville,1675,128,626,299,38,0,1091
Virginia,Pimmit Hills,6506,579,691,641,1247,1457,4615
Virginia,Newington,13080,396,1083,2346,2689,2242,8756
Virginia,Lorton,20691,1085,2883,3697,3495,2544,13704
Virginia,Herndon,24520,2561,3084,2621,4347,3560,16173
Virginia,Virgilina,104,15,33,24,7,5,84
Virginia,Wyndham,10151,133,362,1024,2393,2476,6388
Virginia,Chesapeake,237820,12452,39841,55168,32013,19611,159085
Virginia,Front Royal,15240,1781,3656,2700,1290,569,9996
Virginia,Parksley,679,110,173,171,30,29,513
Virginia,Sandy Level,571,104,288,117,0,0,509
Virginia,Horse Pasture,2136,261,573,516,75,44,1469
Virginia,Brookneal,871,177,292,103,61,14,647
Virginia,Haysi,571,127,197,74,18,4,420
Virginia,Clinchco,303,62,87,52,9,13,223
Virginia,Yorktown,215,0,57,23,41,80,201
Virginia,Chilhowie,1855,225,462,338,238,86,1349
Virginia,Roanoke,99621,10143,22873,20294,10586,6109,70005
Virginia,Bull Run,15683,2039,2475,2497,2238,994,10243
Virginia,Matoaca,2517,212,632,457,133,156,1590
Virginia,Twin Lakes,1494,82,272,400,173,67,994
Virginia,Belspring,120,29,15,50,0,0,94
Virginia,Clifton Forge,3603,441,965,804,223,129,2562
Virginia,Winchester,27789,3106,4607,4448,3492,2749,18402
Virginia,Vinton,8074,628,2162,1615,967,214,5586
Virginia,Saltville,2621,296,624,529,110,48,1607
Virginia,Laymantown,2012,85,449,568,219,236,1557
Virginia,Verona,3964,809,948,627,291,164,2839
Virginia,Forest,10298,238,1579,2174,1763,1399,7153
Virginia,Woodbridge,4400,146,434,869,867,883,3199
Virginia,Danville,41512,5164,8561,9762,3303,1976,28766
Virginia,Colonial Beach,3555,265,903,785,396,262,2611
Virginia,Wolf Trap,16911,216,421,1236,3863,5798,11534
Virginia,Vienna,16488,592,1191,1778,3315,4035,10911
Virginia,Salem,25519,1770,4901,5445,3046,1920,17082
Virginia,Fort Hunt,16858,151,614,1450,4159,4943,11317
Virginia,South Boston,7828,1043,1789,1381,691,352,5256
Virginia,Woodlawn CDP (Fairfax County),23406,3196,3921,3632,2295,1308,14352
Virginia,Columbia,78,7,28,6,15,0,56
Virginia,Tysons,23749,318,1243,2280,5823,7368,17032
Virginia,Mount Hermon,4137,183,943,1120,491,346,3083
Virginia,Palmyra,123,0,20,20,30,0,70
Virginia,Opal,719,43,101,170,88,55,457
Virginia,Oak Hall,108,0,108,0,0,0,108
Virginia,Oak Grove,2468,289,327,422,429,278,1745
Virginia,Nottoway Court House,166,38,89,22,0,17,166
Virginia,New River,396,50,103,79,50,29,311
Virginia,New Kent,385,0,76,111,22,14,223
Virginia,Bon Air,17764,606,2127,3398,3383,2576,12090
Virginia,Newington Forest,12476,479,1003,1965,2453,2322,8222
Virginia,New Church,203,43,16,39,25,15,138
Virginia,New Baltimore,9831,272,1216,2017,1751,1181,6437
Virginia,Nelsonia,581,133,170,93,37,13,446
Virginia,Nellysford,1447,84,175,326,238,467,1290
Virginia,Neabsco,16947,510,1883,3338,2980,2602,11313
Virginia,Nathalie,57,26,0,31,0,0,57
Virginia,Mount Sidney,501,9,161,33,103,57,363
Virginia,New Hope,757,49,192,102,86,67,496
Virginia,Parrott,420,125,85,0,31,15,256
Virginia,Pennington Gap,1974,563,575,273,115,39,1565
Virginia,Weber City,1534,256,427,400,122,61,1266
Virginia,Stanley,1730,319,609,246,85,27,1286
Virginia,Woodstock,5192,391,1105,1199,512,181,3388
Virginia,Alexandria,156505,8872,14216,21840,34226,39400,118554
Virginia,Wytheville,8000,513,2128,1784,863,626,5914
Virginia,Great Falls,15394,217,698,1186,3527,4981,10609
Virginia,Centreville,75452,3148,8147,10124,16983,11853,50255
Virginia,Annandale,43729,4816,5508,6561,7759,5445,30089
Virginia,Culpeper,18113,1908,2911,3428,1616,997,10860
Virginia,Chatham,1210,126,231,208,203,134,902
Virginia,Blacksburg,44245,721,1622,2311,4890,6438,15982
Virginia,New Castle,187,24,44,28,43,0,139
Virginia,Grundy,911,95,184,132,89,114,614
Virginia,Blue Ridge,3237,131,818,764,549,236,2498
Virginia,Fort Chiswell,888,32,262,159,88,64,605
Virginia,Stuarts Draft,9716,512,2642,2172,1054,346,6726
Virginia,Patrick Springs,1808,130,553,524,150,82,1439
Virginia,Stuart,1499,299,327,355,105,77,1163
Virginia,Lawrenceville,1380,133,196,189,62,70,650
Virginia,Rustburg,1477,214,325,397,76,46,1058
Virginia,Gate City,2406,302,481,516,224,94,1617
Virginia,Pamplin City,79,8,25,15,6,8,62
Virginia,Westlake Corner,1002,105,152,221,193,184,855
Virginia,Crimora,1999,105,987,221,93,28,1434
Virginia,Craigsville,816,171,260,155,20,20,626
Virginia,Raven,1666,425,491,237,76,9,1238
Virginia,Branchville,112,16,25,21,5,8,75
Virginia,Clifton,275,0,12,40,92,60,204
Virginia,Louisa,1724,260,403,296,118,82,1159
Virginia,Hamilton,537,28,61,118,105,68,380
Virginia,Hopewell,22408,2736,5396,4694,1377,617,14820
Virginia,Crozet,6526,246,586,796,1373,1503,4504
Virginia,Crewe,2448,294,592,468,210,66,1630
Virginia,Blackstone,3438,569,745,576,174,123,2187
Virginia,Stanleytown,1297,177,187,435,95,62,956
Virginia,Chatmoss,1405,106,249,320,304,169,1148
Virginia,Hampton,135583,7972,25485,32739,14641,9568,90405
Virginia,Benns Church,528,78,181,137,10,8,414
Virginia,Passapatanzy,1449,130,250,357,144,16,897
Virginia,Piney Mountain,1390,79,264,361,84,76,864
Virginia,Whitesville,123,35,38,0,0,0,73
Virginia,Wattsville,855,114,158,199,96,77,644
Virginia,Warm Springs,31,0,0,17,14,0,31
Virginia,Warfield,81,35,35,5,6,0,81
Virginia,Wakefield,11782,290,818,1424,2458,3039,8029
Virginia,University of Virginia,8487,148,187,163,729,810,2037
Virginia,University Center,4060,276,498,784,855,494,2907
Virginia,Union Level,195,50,70,24,11,0,155
Virginia,Spotsylvania Courthouse,4679,314,935,980,473,338,3040
Virginia,Thynedale,158,23,68,20,0,6,117
Virginia,Templeton,205,12,45,82,24,32,195
Virginia,Temperanceville,259,24,67,44,52,0,187
Virginia,Tasley,531,66,84,40,7,0,197
Virginia,Sussex,264,15,31,44,69,2,161
Virginia,Sugarland Run,12576,1086,1875,1936,2168,1103,8168
Virginia,Wintergreen,502,74,59,0,157,212,502
Virginia,Woodburn,8462,425,795,1208,1916,1579,5923
Virginia,Woodlake,7299,44,581,918,1778,1138,4459
Virginia,Woodlawn CDP (Carroll County),2110,162,738,411,152,63,1526
Virginia,Belmont Estates,2012,121,384,177,248,272,1202
Virginia,Belmont,6629,95,324,492,1630,1350,3891
Virginia,Belview,973,22,378,137,109,84,730
Virginia,Bealeton,4646,262,1014,972,522,258,3028
Virginia,Bayside,273,22,8,116,0,0,146
Virginia,Basye,920,14,176,281,160,105,736
Virginia,Baskerville,72,1,32,13,0,0,46
Virginia,Stone Ridge,12990,272,703,1515,3382,1968,7840
Virginia,Augusta Springs,209,75,52,27,0,0,154
Virginia,Ashburn,50290,1084,3218,7634,12105,8777,32818
Virginia,Arrington,710,173,154,30,78,21,456
Virginia,Arcola,963,0,169,100,192,162,623
Virginia,Apple Mountain Lake,1334,101,231,434,109,50,925
Virginia,Amelia Court House,889,72,280,128,127,0,607
Virginia,Allisonia,114,0,25,52,10,7,94
Virginia,Yogaville,124,9,44,38,8,24,123
Virginia,Atlantic,950,176,356,101,161,18,812
Virginia,Pastoria,979,170,240,69,30,0,509
Virginia,Sterling,30403,4033,3990,4476,4510,2680,19689
Virginia,Springville,1326,128,393,261,144,73,999
Virginia,Saluda,691,69,214,150,31,25,489
Virginia,Ruckersville,1321,112,185,366,136,121,920
Virginia,Rockwood,7712,272,1530,1749,1318,1001,5870
Virginia,Riverview,775,226,197,115,0,0,538
Virginia,Riverdale,737,140,194,178,54,14,580
Virginia,Rivanna,1707,54,134,227,573,402,1390
Virginia,Riner,1149,11,153,253,165,189,771
Virginia,Ravensworth,2245,191,243,432,485,387,1738
Virginia,Quinby,226,0,102,49,36,8,195
Virginia,Quantico Base,5213,45,150,682,665,188,1730
Virginia,Pungoteague,245,35,65,115,7,0,222
Virginia,Prince George,2129,222,618,329,123,90,1382
Virginia,Prices Fork,1198,62,295,177,144,208,886
Virginia,Potomac Mills,6468,789,956,969,940,596,4250
Virginia,Plum Creek,1339,139,535,313,63,14,1064
Virginia,Savageville,50,0,0,0,50,0,50
Virginia,Sandston,7056,865,1932,1407,347,111,4662
Virginia,Sanford,91,0,43,33,0,0,76
Virginia,Savage Town,21,21,0,0,0,0,21
Virginia,Sperryville,244,7,48,40,41,39,175
Virginia,Southside Chesconessex,106,0,106,0,0,0,106
Virginia,South Run,6308,49,316,470,1466,2074,4375
Virginia,South Riding,31071,633,1697,3254,7409,6368,19361
Virginia,Southern Gateway,3724,187,447,806,471,166,2077
Virginia,Snowville,51,0,30,0,0,8,38
Virginia,Skyland Estates,1055,43,237,252,172,25,729
Virginia,Stafford Courthouse,3786,576,614,794,269,313,2566
Virginia,Shipman,285,73,52,53,0,13,191
Virginia,Shenandoah Retreat,660,64,197,179,36,36,512
Virginia,Shenandoah Farms,3807,456,901,763,439,74,2633
Virginia,Shawneeland,1633,110,605,385,90,16,1206
Virginia,Seven Mile Ford,595,83,165,79,31,34,392
Virginia,Sedley,400,40,99,124,8,24,295
Virginia,Scotland,110,8,26,29,15,13,91
Virginia,Schuyler,98,26,25,11,0,0,62
Virginia,Shenandoah Shores,939,57,211,154,83,39,544
Virginia,Wise,3047,374,535,708,295,281,2193
Virginia,Tazewell,4327,457,886,930,471,280,3024
Virginia,Gloucester Courthouse,2361,213,520,666,362,98,1859
Virginia,Deltaville,1050,49,255,266,101,98,769
Virginia,Deerfield,127,34,44,38,0,0,116
Virginia,Deep Creek,42,0,0,0,0,13,13
Virginia,Dahlgren Center,649,8,63,121,61,49,302
Virginia,Smithfield,8324,734,1427,1857,1070,764,5852
Virginia,Courtland,1958,195,391,455,159,92,1292
Virginia,Dranesville,11802,173,635,1383,3014,2653,7858
Virginia,Ridgeway,1047,135,160,255,72,33,655
Virginia,Bassett,959,183,203,279,79,10,754
Virginia,Lexington,7110,277,721,672,657,434,2761
Virginia,Virginia Beach,450135,20860,65338,111724,68906,38528,305356
Virginia,Fairfax,23865,1146,2158,3443,4979,4599,16325
Virginia,Charlotte Court House,583,89,139,130,33,37,428
Virginia,Staunton,24452,1874,5209,4514,3338,2641,17576
Virginia,Oak Level,658,89,153,151,60,31,484
Virginia,Draper,388,0,65,49,96,35,245
Virginia,Dulles Town Center,5023,293,743,661,929,666,3292
Virginia,East Lexington,916,171,178,123,157,76,705
Virginia,Gasburg,618,12,114,117,137,80,460
Virginia,Gargatha,162,37,21,56,0,13,127
Virginia,Free Union,249,0,0,113,28,63,204
Virginia,Franklin Farm,18727,253,1029,1783,4594,4742,12401
Virginia,Floris,8305,57,306,671,1924,2547,5505
Virginia,Flint Hill,398,31,134,101,22,9,297
Virginia,Fairview,156,75,69,8,4,0,156
Virginia,Fair Oaks,33700,595,2391,4735,8454,7182,23357
Virginia,Fair Lakes,8314,249,521,1196,2087,1872,5925
Virginia,Fairfax Station,11934,245,812,1414,2908,3087,8466
Virginia,Esmont,857,89,171,147,45,31,483
Virginia,Enon,4310,180,954,834,543,214,2725
Virginia,Emory,1306,65,71,88,111,91,426
Virginia,Elliston,886,223,163,67,0,0,453
Virginia,Ebony,202,0,76,14,0,0,90
Virginia,Timberville,2613,248,710,472,230,56,1716
Virginia,George Mason,9711,266,323,504,1279,979,3351
Virginia,Stephens City,1989,150,426,339,208,154,1277
Virginia,Drakes Branch,896,70,208,115,20,26,439
Virginia,Troutdale,167,26,78,18,8,4,134
Virginia,Independence,1139,173,281,292,79,18,843
Virginia,Glen Lyn,91,28,14,22,0,0,64
Virginia,Phenix,228,13,86,38,14,5,156
Virginia,Lovettsville,2544,74,308,469,399,222,1472
Virginia,Radford,17630,788,1859,2164,1647,1445,7903
Virginia,Middleburg,620,40,88,123,128,97,476
Virginia,Lynchburg,80131,4924,11290,12794,8963,6501,44472
Virginia,Alberta,350,45,74,80,31,30,260
Virginia,Burkeville,520,109,159,102,30,2,402
Virginia,Scottsville,535,50,131,89,75,25,370
Virginia,Poquoson,12039,336,2187,2290,1836,1772,8421
Virginia,New Market,2341,448,601,276,311,179,1815
Virginia,Edinburg,1261,138,331,225,115,58,867
Virginia,Dungannon,321,80,72,33,7,0,192
Virginia,Falls Church,14067,116,517,1396,3335,4087,9451
Virginia,Hillsboro,175,1,14,32,35,27,109
Virginia,Purcellville,9709,365,894,1415,1881,1345,5900
Virginia,Dayton,1567,72,313,251,302,141,1079
Virginia,Appalachia,1469,206,276,332,67,38,919
Virginia,Surry,311,50,67,55,39,10,221
Virginia,The Plains,194,39,24,32,46,9,150
Virginia,Middletown,1516,136,294,284,143,62,919
Virginia,Abingdon,8020,599,1447,1992,1187,955,6180
Virginia,Floyd,658,82,119,113,79,54,447
Virginia,Bristol,16843,1967,3676,3535,1802,1113,12093
Virginia,Fieldale,1116,120,382,246,0,0,748
Virginia,Manassas,41457,4543,7026,7053,4928,2948,26498
Virginia,Haymarket,1629,43,163,317,257,235,1015
Virginia,Boydton,377,16,84,74,75,41,290
Virginia,Fancy Gap,103,0,31,66,0,0,97
Virginia,Toms Brook,407,37,99,85,19,5,245
Virginia,Orange,4935,686,960,841,450,257,3194
Virginia,Fincastle,411,40,75,102,53,50,320
Virginia,Newport News,180145,11493,33256,41869,18774,10866,116258
Virginia,Glenvar,1066,213,383,181,91,0,868
Virginia,Gratton,1088,142,278,180,161,0,761
Virginia,Meadow View,1307,155,287,313,115,63,933
Virginia,Metompkin,515,151,103,3,34,0,291
Virginia,Middlebrook,87,19,17,0,0,0,36
Virginia,Midland,56,1,18,9,8,7,43
Virginia,Modest Town,171,121,14,14,14,0,163
Virginia,Montvale,536,112,153,153,22,0,440
Virginia,Meadowbrook,19532,1825,4445,4105,2099,754,13228
Virginia,Moorefield Station,1369,19,75,180,351,189,814
Virginia,Mountain Road,762,316,158,77,24,42,617
Virginia,West Falls Church,29154,3577,3563,4115,5325,4235,20815
Virginia,Lancaster,56,9,11,0,31,0,51
Virginia,Pantops,3569,178,532,535,1020,754,3019
Virginia,Powhatan,342,0,100,151,67,0,318
Virginia,Bedford,6527,752,1571,1277,567,149,4316
Virginia,Motley,896,133,262,262,51,0,708
Virginia,Maurertown,995,41,297,274,32,66,710
Virginia,Mathews,589,42,283,79,102,39,545
Virginia,Massanetta Springs,5517,187,416,1116,874,1470,4063
Virginia,Lovingston,574,79,159,121,29,9,397
Virginia,Loudoun Valley Estates,7528,146,266,589,1734,1965,4700
Virginia,Long Branch,8225,302,970,812,1625,1961,5670
Virginia,Lee Mont,27,0,0,17,0,0,17
Virginia,Laurel Hill,8194,356,803,1084,1815,1313,5371
Virginia,Lansdowne,12696,323,706,1886,2810,2918,8643
Virginia,McMullin,436,42,97,136,55,14,344
Virginia,McNair,20771,707,1820,1942,4992,4375,13836
Virginia,Makemie Park,309,13,108,18,0,0,139
Virginia,Manchester,10807,904,2071,2289,1711,751,7726
Virginia,Mappsburg,69,0,7,26,24,0,57
Virginia,Mappsville,367,0,210,119,0,0,329
Virginia,Marshall,2088,78,441,362,175,157,1213
Virginia,Marumsco,40741,6102,6737,6106,4575,2184,25704
Virginia,Mason Neck,1969,71,164,422,323,414,1394
Virginia,Southampton Meadows,399,162,62,123,0,0,347
Virginia,Goochland,779,21,128,158,191,48,546
Virginia,Buchanan,1179,144,364,195,69,90,862
Virginia,Onancock,1227,159,270,269,182,133,1013
Virginia,Hollymead,8393,696,794,1228,1699,1388,5805
Virginia,Hiwassee,350,26,93,146,0,24,289
Virginia,Henry Fork,1511,135,373,287,14,69,878
Virginia,Horntown,494,145,87,25,56,0,313
Virginia,Heathsville,112,37,24,12,19,20,112
Virginia,Hayfield,4335,97,345,533,988,926,2889
Virginia,Hot Springs,567,33,89,225,31,29,407
Virginia,Harriston,1255,156,473,208,20,0,857
Virginia,Hanover,164,18,60,25,54,7,164
Virginia,Hampden-Sydney,1716,14,14,12,17,233,290
Virginia,Gwynn,391,0,134,108,58,12,312
Virginia,Greenbush,199,31,46,7,39,7,130
Virginia,Greenbriar,8575,250,962,1334,1746,1312,5604
Virginia,Greenbackville,0,0,0,0,0,0,0
Virginia,Harborton,258,0,18,113,16,0,147
Virginia,Independent Hill,9499,325,892,1398,1886,1457,5958
Virginia,Innsbrook,8549,330,616,1252,1828,1522,5548
Virginia,Ivanhoe,437,151,93,45,48,14,351
Virginia,Onley,809,46,199,114,111,66,536
Virginia,Daleville,3261,67,606,860,516,437,2486
Virginia,Lake Wilderness,2708,63,394,674,296,193,1620
Virginia,Lake of the Woods,7649,258,1247,2024,1305,1113,5947
Virginia,Lake Land'Or,4193,81,876,1163,652,141,2913
Virginia,Lake Holiday,1788,21,133,472,468,227,1321
Virginia,Lake Caroline,1850,78,561,353,371,29,1392
Virginia,Lafayette,906,100,150,135,12,145,542
Virginia,King William,325,28,56,68,23,19,194
Virginia,Kingstowne,17172,610,1920,2380,3879,3939,12728
Virginia,Kings Park West,14077,398,860,1729,3360,2903,9250
Virginia,Kings Park,5064,205,506,521,812,1097,3141
Virginia,King George,5028,170,744,1265,538,492,3209
Virginia,King and Queen Court House,162,0,59,50,27,0,136
Virginia,Ivy,511,0,57,53,56,142,308
Virginia,Cloverdale,3501,265,516,644,570,395,2390
Virginia,Jarratt,845,60,229,198,53,9,549
Virginia,Atkins,817,128,261,196,25,22,632
Virginia,Adwolf,1673,98,367,490,242,76,1273
Virginia,Painter,272,32,49,57,34,4,176
Virginia,Chincoteague,2899,383,727,656,286,416,2468
Virginia,Bloxom,447,86,120,66,21,13,306
Virginia,Berryville,4293,482,765,789,442,425,2903
Virginia,Lunenburg,187,11,44,96,7,0,158
Virginia,Richlands,5439,981,1493,907,238,276,3895
Virginia,Petersburg,31827,4192,7562,6303,2363,1605,22025
Virginia,West Point,3301,134,833,670,484,141,2262
Virginia,Jolivue,890,132,254,148,61,33,628
Virginia,Madison Heights,11483,1389,2961,2407,1032,420,8209
Virginia,Pocahontas,301,25,93,100,15,10,243
Virginia,Gretna,1310,198,309,332,103,59,1001
Virginia,Glade Spring,1429,162,319,357,144,80,1062
Virginia,Damascus,709,61,151,178,63,24,477
Virginia,Reston,60335,1838,4413,7496,15672,14214,43633
Virginia,Linton Hall,41088,1031,3541,6184,7942,5156,23854
Virginia,Loch Lomond,4601,1048,851,722,191,102,2914
Virginia,Mount Jackson,2451,352,565,359,164,88,1528
Virginia,Fishersville,8252,534,1508,1547,1153,917,5659
Virginia,Newsoms,283,32,58,94,21,26,231
Virginia,Kenbridge,1015,136,247,145,117,52,697
Virginia,Troutville,455,37,111,123,56,12,339
Virginia,Saxis,216,56,57,39,15,7,174
Virginia,Mount Crawford,400,36,83,76,68,29,292
Virginia,Grottoes,2756,280,825,637,213,25,1980
Virginia,Gloucester Point,9294,630,2327,2135,764,718,6574
Virginia,Urbanna,474,31,76,136,62,49,354
Virginia,Victoria,2043,336,485,439,97,43,1400
Virginia,Hallwood,258,37,71,53,3,5,169
Virginia,Bluefield,4984,496,1496,915,483,206,3596
Virginia,Hurt,1478,114,365,351,123,78,1031
Virginia,Washington,95,6,21,14,32,20,93
Virginia,Richmond,223787,23142,34510,37325,35183,24259,154419
Virginia,Wakefield,1022,133,212,189,65,32,631
Virginia,Tangier,524,123,211,68,10,0,412
Virginia,Gordonsville,1708,242,401,354,121,66,1184
Virginia,Strasburg,6585,321,1391,1625,688,261,4286
Virginia,Iron Gate,262,33,78,50,25,8,194
Virginia,Merrifield,17789,866,787,1737,5141,4499,13030
Virginia,Fort Lee,5409,67,357,1295,620,144,2483
Virginia,Charlottesville,47042,2728,5622,5928,7638,8209,30125
Virginia,Big Stone Gap,5326,1103,1010,1039,614,321,4087
Virginia,Dendron,340,18,106,73,32,26,255
Virginia,Idylwood,18431,1263,1606,1947,4078,4176,13070
Virginia,Villa Heights,633,62,154,337,37,14,604
Virginia,Emporia,5381,814,1303,1027,373,114,3631
Virginia,Suffolk,89160,6736,16916,19623,9960,6966,60201
Virginia,Massanutten,2472,39,296,429,458,421,1643
Virginia,Glasgow,1487,167,484,220,94,40,1005
Virginia,Fredericksburg,28469,1751,3964,4172,4064,3117,17068
Virginia,Fries,479,35,105,150,52,7,349
Virginia,Remington,767,88,125,155,75,48,491
Virginia,Oakton,37185,1556,1979,3916,8225,9957,25633
Virginia,Springfield,31117,3185,4120,5007,5642,3840,21794
Virginia,Rushmere,980,172,152,272,91,49,736
Virginia,Martinsville,13101,1550,2806,2718,1266,647,8987
Virginia,Honaker,1330,249,328,298,91,38,1004
Virginia,Cleveland,138,39,39,22,2,0,102
Virginia,Nassawadox,545,103,183,70,72,28,456
Virginia,Dahlgren,3202,81,570,668,301,256,1876
Virginia,Tuckahoe,48282,1768,5781,7891,10679,7320,33439
Virginia,Penhook,878,59,130,207,180,167,743
Virginia,Melfa,386,35,130,95,16,18,294
Virginia,Keller,176,11,70,44,2,8,135
Virginia,Chamberlayne,6186,191,1269,1273,1402,793,4928
Virginia,Accomac,451,40,119,97,58,35,349
Virginia,Lyndhurst,1803,141,429,381,203,85,1239
Virginia,Boykins,854,114,167,189,91,42,603
Virginia,Shawsville,1836,186,517,339,145,69,1256
Virginia,Madison,196,35,64,23,21,2,145
Virginia,Fairlawn,2538,69,376,702,379,278,1804
Virginia,Wachapreague,195,12,89,17,31,23,172
Virginia,Max Meadows,299,79,108,17,21,0,225
Virginia,Vansant,433,49,112,98,102,0,361
Virginia,Buena Vista,6399,714,1594,1131,332,319,4090
Virginia,Luray,4818,572,1419,877,372,234,3474
Virginia,Occoquan,1155,13,166,247,282,209,917
Virginia,Jonesville,1248,147,208,357,113,47,872
Virginia,Belle Haven,594,41,141,150,60,23,415
Virginia,Boyce,756,82,121,143,94,76,516
Virginia,Boones Mill,152,21,25,53,20,10,129
Virginia,Amherst,2569,326,654,408,398,137,1923
Virginia,Ivor,495,63,110,127,24,5,329
Virginia,Seven Corners,8576,1498,1201,785,1320,1255,6059
Virginia,Mount Vernon,12919,510,1182,1729,2611,2875,8907
Virginia,McLean,47075,609,1482,3148,9657,17149,32045
Virginia,Lincolnia,24808,2614,3072,3532,4060,3773,17051
Virginia,Chantilly,24559,1218,2641,3411,5150,4063,16483
Virginia,Claypool Hill,1307,247,223,449,37,47,1003
Virginia,Ashland,7655,598,1461,1058,697,582,4396
Virginia,Mechanicsville,37501,1910,6950,8355,6464,2708,26387
Virginia,Falmouth,4928,130,818,825,806,435,3014
Virginia,Rich Creek,734,79,240,163,35,27,544
Virginia,Harrisonburg,53391,4266,7083,5835,5489,4158,26831
Virginia,Arlington,231803,10258,14027,19594,60173,68437,172489
Virginia,Lakeside,12180,1081,2347,2670,1754,1180,9032
Virginia,Glen Allen,16454,766,2510,3489,2908,1565,11238
Virginia,North Shore,3263,145,657,798,590,365,2555
Virginia,Galax,6638,1410,1640,1271,365,244,4930
Virginia,Nickelsville,342,40,88,58,40,12,238
Virginia,Farmville,8076,490,1074,693,643,648,3548
Virginia,Fairview Beach,450,82,110,34,82,33,341
Virginia,North Springfield,7644,1150,685,1210,1305,860,5210
Virginia,Lake Barcroft,9823,586,781,1086,2077,2367,6897
Virginia,Huntington,13135,653,1309,1711,3061,3416,10150
Virginia,Franklin,8211,972,1728,1758,751,444,5653
Virginia,White Stone,317,44,104,69,16,36,269
Virginia,Halifax,1314,138,390,247,164,127,1066
Virginia,Chester,22144,1506,3777,5038,2756,1732,14809
Virginia,Bellwood,6157,1057,1514,870,260,155,3856
Virginia,Norfolk,245592,18818,39004,51966,25898,16811,152497
Virginia,Bowling Green,1266,86,316,280,175,71,928
Virginia,Norton,3990,544,690,1114,320,158,2826
Virginia,Round Hill,693,29,64,163,168,79,503
Virginia,Leesburg,52125,2948,5534,7162,10793,6582,33019
Virginia,Pound,928,125,253,161,71,42,652
Virginia,Timberlake,12973,724,2489,3193,1667,967,9040
Virginia,Cave Spring,25793,891,3537,5617,5283,3230,18558
Virginia,Marion,5787,777,1720,1221,429,275,4422
Virginia,Laurel Park,542,102,134,167,63,6,472
Virginia,Narrows,2087,187,558,451,117,46,1359
Virginia,Keysville,1007,127,215,168,47,17,574
Virginia,Covington,5582,552,1746,1122,414,202,4036
Virginia,Stony Creek,144,7,41,33,12,12,105
Virginia,Short Pump,27526,343,1609,2789,8087,5516,18344
Virginia,Montrose,7810,933,1672,1871,352,193,5021
Virginia,St. Paul,914,110,214,262,98,56,740
Virginia,Low Moor,240,123,83,30,0,0,236
Virginia,Altavista,3442,478,869,627,314,182,2470
Virginia,Warrenton,9873,544,1325,1940,1565,1107,6481
Virginia,Triangle,9116,632,1462,1616,1314,725,5749
Virginia,Colonial Heights,17593,1117,3934,4323,1996,839,12209
Virginia,Montclair,20494,497,1999,3819,4271,3393,13979
Virginia,Lake Ridge,44430,2117,4806,9006,7624,5948,29501
Virginia,Dumfries,5224,693,755,831,334,151,2764
Virginia,Dale City,73545,7716,13305,13480,7767,4788,47056
Virginia,Cana,1926,284,499,437,33,18,1271
Virginia,Clinchport,54,7,28,6,0,0,41
Virginia,St. Charles,89,23,10,18,0,0,51
Virginia,Nokesville,1641,92,378,253,205,158,1086
Virginia,Gainesville,15928,350,1356,2594,3507,2192,9999
Virginia,Clarksville,1332,65,200,374,179,136,954
Virginia,Rose Hill CDP (Lee County),654,153,195,164,22,9,543
Virginia,Keokee,375,81,138,98,0,0,317
Virginia,Broadway,3855,381,712,712,447,228,2480
Virginia,Appomattox,1851,188,539,257,171,85,1240
Virginia,Dante,608,93,250,94,16,0,453
Washington,Hatton,189,27,43,23,1,0,94
Washington,Suquamish,4310,147,771,1170,655,391,3134
Washington,Lake Ketchum,916,52,111,290,85,68,606
Washington,Lochsloy,2664,90,826,855,182,130,2083
Washington,Centerville,90,11,29,29,5,0,74
Washington,Waller,7894,543,1733,2080,1055,539,5950
Washington,Prosser,6076,720,1004,1244,775,328,4071
Washington,Port Angeles,19615,1353,3485,5577,1716,1350,13481
Washington,Inchelium,328,48,72,98,6,6,230
Washington,Lyle,455,74,89,97,56,16,332
Washington,Centralia,16932,1849,3500,4549,1029,680,11607
Washington,Toledo,602,36,164,149,46,22,417
Washington,Cathcart,2665,93,476,1001,508,127,2205
Washington,Lake Roesiger,609,17,172,168,61,43,461
Washington,Warm Beach,2699,33,451,846,430,179,1939
Washington,Kelso,11983,1377,2846,2884,429,305,7841
Washington,Roosevelt,161,36,17,19,22,0,94
Washington,Longview Heights,3619,244,576,994,358,240,2412
Washington,Tukwila,20198,2798,3557,4230,2312,1005,13902
Washington,Lakeland North,12820,842,2270,3500,1787,435,8834
Washington,Mirrormont,3717,0,432,749,951,535,2667
Washington,Newcastle,11559,212,851,1493,3210,2385,8151
Washington,Pacific,7177,784,1198,1735,615,305,4637
Washington,Redmond,63197,1393,3628,8309,17041,14916,45287
Washington,Riverbend,2302,36,349,665,524,50,1624
Washington,North Bonneville,1155,34,217,383,128,84,846
Washington,Normandy Park,6678,257,835,1321,1838,841,5092
Washington,Kettle Falls,1616,165,345,437,192,38,1177
Washington,Beaux Arts Village,394,0,7,24,100,115,246
Washington,Black Diamond,4434,179,754,1117,722,415,3187
Washington,Kirkland,88079,2218,7160,15961,24671,14355,64365
Washington,Medina,3260,53,129,303,981,777,2243
Washington,Vashon,10036,281,1123,2070,2286,2126,7886
Washington,White Center,15852,2025,2989,3455,1705,667,10841
Washington,Ames Lake,1597,48,242,377,368,241,1276
Washington,Baring,202,21,74,89,4,0,188
Washington,Woods Creek,5907,405,1054,1584,701,257,4001
Washington,College Place,9136,646,682,2397,1214,753,5692
Washington,Mansfield,337,23,89,110,45,21,288
Washington,Coulee Dam,1230,87,224,367,102,63,843
Washington,Springdale,395,50,75,97,12,0,234
Washington,Bryn Mawr-Skyway,18347,1925,3175,3926,2450,1261,12737
Washington,Tenino,1695,71,401,525,126,63,1186
Washington,Sedro-Woolley,11579,634,2906,2624,796,364,7324
Washington,Shelton,9996,1178,1922,2517,533,183,6333
Washington,Banks Lake South,256,7,50,56,27,0,140
Washington,Grand Coulee,1046,90,293,274,45,18,720
Washington,Moses Lake,22663,2292,3901,4515,2035,865,13608
Washington,Moses Lake North,4124,384,728,951,50,58,2171
Washington,Easton,368,18,171,95,38,14,336
Washington,Snoqualmie Pass,316,10,20,109,90,35,264
Washington,Vantage,23,23,0,0,0,0,23
Washington,Desert Aire,2964,520,328,395,243,96,1582
Washington,Woodway,1189,19,82,193,271,260,825
Washington,Okanogan,2570,343,534,514,149,145,1685
Washington,Pomeroy,1289,42,283,422,143,57,947
Washington,Waitsburg,1188,82,170,351,92,58,753
Washington,Ferndale,13622,894,2217,3512,1769,798,9190
Washington,Lynden,13862,700,2391,3713,1904,648,9356
Washington,Castle Rock,2968,199,661,801,238,81,1980
Washington,Grayland,609,0,196,205,33,60,494
Washington,Humptulips,153,12,51,60,0,8,131
Washington,Cashmere,3139,354,526,657,251,223,2011
Washington,East Wenatchee,13817,1621,2300,2826,1204,491,8442
Washington,Peaceful Valley,4032,398,988,962,172,27,2547
Washington,Custer,140,22,35,40,15,0,112
Washington,Maple Falls,159,15,33,80,15,0,143
Washington,Nooksack,1678,160,295,377,134,37,1003
Washington,Deer Park,4026,199,929,1111,194,139,2572
Washington,Aberdeen,16359,1534,3032,4333,1161,650,10710
Washington,Brewster,2591,641,199,232,163,57,1292
Washington,DuPont,9379,63,637,1915,1860,1224,5699
Washington,Northport,318,51,102,65,10,12,240
Washington,Lake Morton-Berrydale,11295,687,1740,2916,1837,657,7837
Washington,Minnehaha,12092,613,2032,3787,1216,788,8436
Washington,Vancouver,178413,11116,30155,46664,22669,11660,122264
Washington,Anacortes,16725,658,2527,4302,3195,1933,12615
Washington,Hamilton,298,29,55,99,48,29,260
Washington,Manchester,5471,207,1183,1367,716,356,3829
Washington,Ephrata,8050,729,1195,1881,675,364,4844
Washington,Coulee City,572,25,134,154,53,29,395
Washington,Artondale,13172,302,1670,3228,2501,1710,9411
Washington,Ahtanum,3416,320,622,911,205,127,2185
Washington,Fox Island,3692,107,336,917,833,541,2734
Washington,Ravensdale,1873,142,417,405,245,110,1319
Washington,Shoreline,56020,3089,6004,12732,12997,7186,42008
Washington,Snoqualmie,13317,207,772,1858,3625,1910,8372
Washington,Kenmore,22546,796,1943,4198,5611,3682,16230
Washington,Carbonado,727,59,199,162,57,7,484
Washington,Kent,128057,11883,21946,28837,15209,5617,83492
Washington,Rockport,49,9,17,23,0,0,49
Washington,Concrete,703,97,158,193,41,18,507
Washington,Hockinson,5001,193,847,1204,821,428,3493
Washington,Forks,3782,437,949,721,176,91,2374
Washington,Brush Prairie,2820,131,423,772,335,152,1813
Washington,La Center,3172,101,538,952,319,153,2063
Washington,Meadow Glade,2906,41,432,683,392,306,1854
Washington,Orchards,23020,1356,4118,5991,2146,736,14347
Washington,Edison,123,12,0,12,99,0,123
Washington,Ridgefield,7178,161,1055,2064,1000,505,4785
Washington,Woodland,5912,450,986,1546,373,152,3507
Washington,Grand Mound,3189,311,693,705,153,52,1914
Washington,Yelm,8772,233,1259,2269,938,316,5015
Washington,Rosalia,568,17,155,141,45,17,375
Washington,Lake McMurray,143,19,42,46,3,19,129
Washington,Big Lake,1641,79,349,495,237,117,1277
Washington,Venersborg,4349,131,708,1146,625,380,2990
Washington,Colville,4777,318,1077,1131,434,297,3257
Washington,Lakeland South,13849,623,2372,3793,1886,725,9399
Washington,Skykomish,114,14,42,29,10,7,102
Washington,Summitview,1047,30,205,284,174,75,768
Washington,Toppenish,8906,2405,1104,1007,234,91,4841
Washington,Goldendale,3446,239,654,836,626,183,2538
Washington,Bellevue,142242,4780,9473,19344,38277,31645,103519
Washington,North Omak,618,90,130,137,38,0,395
Washington,Twisp,1153,60,236,309,168,66,839
Washington,Harrah,643,147,102,100,22,14,385
Washington,Algona,3191,337,704,706,202,28,1977
Washington,Bridgeport,2526,676,260,340,26,0,1302
Washington,Union Hill-Novelty Hill,22034,230,1140,3183,5922,4790,15265
Washington,Woodinville,12026,329,1159,2517,3051,1497,8553
Washington,Elmer City,345,17,72,84,38,25,236
Washington,Riverside,309,46,58,81,11,24,220
Washington,Winthrop,407,50,76,71,56,50,303
Washington,Burien,51326,6546,8884,10529,6519,2896,35374
Washington,Renton,101054,6486,15744,23024,18192,7375,70821
Washington,Parkland,37185,2690,7970,8671,2687,845,22863
Washington,Port Orchard,13788,909,2333,3566,1653,834,9295
Washington,Covington,20447,928,3730,5222,3147,964,13991
Washington,Duvall,7811,26,473,1666,1825,955,4945
Washington,Fall City,2313,149,273,577,397,194,1590
Washington,Federal Way,96110,6867,16102,23556,12160,5028,63713
Washington,Maple Heights-Lake Desire,3682,176,486,877,744,380,2663
Washington,Maple Valley,25953,427,2753,5975,4719,2303,16177
Washington,Edgewood,10599,359,2086,2698,1761,688,7592
Washington,Mercer Island,25492,353,1003,2435,7131,7165,18087
Washington,Camas,22615,732,2088,4325,4293,3363,14801
Washington,Washougal,15484,578,2413,4192,2291,967,10441
Washington,Yacolt,1575,87,367,329,44,26,853
Washington,Lamont,64,2,19,20,7,0,48
Washington,St. John,567,36,105,205,68,26,440
Washington,Lake Cavanaugh,180,0,11,61,53,55,180
Washington,Starbuck,111,13,38,60,0,0,111
Washington,Fife,9968,767,1764,2217,1171,377,6296
Washington,Frederickson,22935,1055,4142,6512,1873,783,14365
Washington,Dayton,2682,210,531,820,310,168,2039
Washington,Alder,150,0,0,14,22,55,91
Washington,Alderton,3280,311,547,890,358,138,2244
Washington,Allyn,2497,135,418,760,361,307,1981
Washington,Altoona,62,0,0,25,37,0,62
Washington,Amanda Park,127,16,30,27,2,3,78
Washington,Anderson Island,1187,32,230,456,179,160,1057
Washington,Addy,109,0,43,36,0,0,79
Washington,Bangor Base,6336,7,442,1421,288,78,2236
Washington,Barstow,137,10,6,29,14,13,72
Washington,Belfair,4435,563,1039,1079,73,53,2807
Washington,Bethel,3787,114,840,1170,334,216,2674
Washington,Bothell East,10682,284,860,1777,2271,1677,6869
Washington,Bothell West,20307,824,2012,4634,4185,2414,14069
Washington,Boulevard Park,3723,667,830,789,451,216,2953
Washington,Barney's Junction,178,33,60,54,0,0,147
Washington,Boyds,73,32,17,0,0,0,49
Washington,Granger,3687,804,519,353,19,59,1754
Washington,North Fort Lewis,5701,68,409,1176,410,80,2143
Washington,Friday Harbor,2554,135,518,568,349,243,1813
Washington,Conconully,203,10,76,66,20,6,178
Washington,Bothell,44994,1533,5327,8755,10192,5520,31327
Washington,Cottage Lake,23955,390,1759,3990,6228,3972,16339
Washington,Lake Forest Park,13378,257,1185,2760,3184,2597,9983
Washington,North Bend,6830,225,900,1654,1337,627,4743
Washington,Spokane Valley,96070,4962,18333,28063,11290,4786,67434
Washington,Carson,2703,138,664,600,218,66,1686
Washington,Colfax,2878,155,549,779,429,226,2138
Washington,Liberty Lake,9382,204,1046,2311,1946,903,6410
Washington,Electric City,983,45,220,378,76,10,729
Washington,LaCrosse,371,24,104,130,47,10,315
Washington,Prescott,308,42,50,88,10,0,190
Washington,Rainier,2346,181,503,568,230,56,1538
Washington,North Yelm,3201,399,681,898,186,43,2207
Washington,Chelan,4070,552,887,808,302,286,2835
Washington,Bryant,2003,29,533,522,311,14,1409
Washington,Bunk Foss,3872,160,662,874,603,265,2564
Washington,Danville,56,0,0,32,0,0,32
Washington,Dash Point,1019,10,149,242,198,187,786
Washington,Deep River,159,8,55,73,6,6,148
Washington,Disautel,16,9,0,7,0,0,16
Washington,Donald,0,0,0,0,0,0,0
Washington,Duluth,1563,77,297,376,243,22,1015
Washington,Curlew Lake,436,26,170,94,42,22,354
Washington,Eastmont,21686,967,3303,4982,3991,1752,14995
Washington,Fife Heights,2333,85,431,568,278,202,1564
Washington,Fairwood CDP (King County),19428,735,2373,4631,3903,1936,13578
Washington,Fairwood CDP (Spokane County),8554,141,789,2424,1231,942,5527
Washington,Fern Prairie,2140,142,333,688,233,62,1458
Washington,Fobes Hill,3052,90,603,735,448,302,2178
Washington,Four Lakes,482,19,149,165,69,24,426
Washington,Enetai,2110,79,326,655,287,182,1529
Washington,Buena,1206,436,59,90,7,0,592
Washington,Curlew,112,18,19,50,3,0,90
Washington,Cowiche,867,74,123,121,28,0,346
Washington,Burley,2119,201,238,614,201,140,1394
Washington,Canterwood,3018,17,242,837,721,488,2305
Washington,Canyon Creek,3520,166,847,1166,142,38,2359
Washington,Cavalero,5320,84,995,1318,787,250,3434
Washington,Chain Lake,4942,161,946,1209,642,361,3319
Washington,Chelan Falls,30,0,15,15,0,0,30
Washington,Crocker,1180,88,191,328,101,81,789
Washington,Chico,2840,67,413,869,425,243,2017
Washington,Clayton,423,30,94,143,0,0,267
Washington,Clear Lake CDP (Pierce County),940,22,241,255,129,59,706
Washington,Clear Lake CDP (Skagit County),906,56,249,287,73,21,686
Washington,Clearview,3932,259,654,956,635,226,2730
Washington,Cliffdell,121,29,42,34,15,0,120
Washington,Clover Creek,6902,472,1560,1821,619,232,4704
Washington,Clallam Bay,341,0,80,171,40,22,313
Washington,Clarkston,7360,641,1436,2191,518,184,4970
Washington,Markham,118,0,33,50,0,0,83
Washington,Rock Island,1195,255,235,160,13,10,673
Washington,Spanaway,32150,2243,7018,8831,1896,928,20916
Washington,Summit,8435,579,1897,2371,922,367,6136
Washington,Tacoma,210103,17167,37061,49209,26249,14824,144510
Washington,Geneva,2655,129,239,579,690,428,2065
Washington,Sumas,1757,147,301,451,138,27,1064
Washington,Cheney,11962,183,614,1885,1129,824,4635
Washington,Roy,692,47,133,248,36,18,482
Washington,Ocean Park,1695,182,448,559,182,148,1519
Washington,Benton City,3315,365,576,930,298,65,2234
Washington,Kennewick,80204,6205,13406,18416,7394,4308,49729
Washington,Burbank,3333,226,992,678,260,164,2320
Washington,Garrett,1449,245,185,319,141,77,967
Washington,Kendall,0,0,0,0,0,0,0
Washington,Republic,1340,174,271,296,108,80,929
Washington,Darrington,1178,127,320,298,62,45,852
Washington,Clinton,922,44,164,240,102,140,690
Washington,Gleed,2634,209,640,682,178,129,1838
Washington,Eatonville,2945,174,538,852,323,107,1994
Washington,Cle Elum,2834,211,580,715,354,79,1939
Washington,Cathlamet,747,57,136,197,38,28,456
Washington,Lacey,47852,1668,6459,13279,7380,3199,31985
Washington,Carlsborg,725,19,192,350,69,95,725
Washington,River Road,894,19,209,319,77,21,645
Washington,Bingen,606,131,94,57,52,74,408
Washington,McChord AFB,3265,38,262,610,248,128,1286
Washington,Dallesport,1602,230,382,542,9,14,1177
Washington,Chinook,289,0,72,155,0,0,227
Washington,Quincy,7531,1756,862,868,317,78,3881
Washington,Wilson Creek,215,25,74,59,14,15,187
Washington,Cusick,78,23,11,30,4,2,70
Washington,Metaline,135,6,46,35,15,4,106
Washington,Metaline Falls,187,31,45,51,16,17,160
Washington,Maryhill,40,24,6,0,0,0,30
Washington,Almira,276,17,51,84,18,19,189
Washington,Walla Walla East,1929,42,352,388,376,209,1367
Washington,Birch Bay,9037,540,1990,2691,1029,809,7059
Washington,Terrace Heights,8273,564,1657,2144,1015,374,5754
Washington,Zillah,3118,505,678,526,158,197,2064
Washington,Nile,116,0,49,49,0,0,98
Washington,Long Beach,1431,140,318,446,88,92,1084
Washington,Chehalis,7404,454,1319,2184,580,329,4866
Washington,Napavine,1720,137,418,488,85,7,1135
Washington,Bainbridge Island,24060,273,936,3879,6468,5689,17245
Washington,Alderwood Manor,9257,446,1483,2582,1365,590,6466
Washington,May Creek,600,84,137,232,59,62,574
Washington,Mukilteo,21264,530,2611,3970,4551,3415,15077
Washington,Stanwood,6973,321,1254,1887,609,262,4333
Washington,West Richland,14187,353,1858,3135,2034,1329,8709
Washington,Reardan,584,34,89,168,42,29,362
Washington,West Pasco,1478,83,299,295,114,186,977
Washington,Esperance,4213,127,792,1138,965,326,3348
Washington,Westport,2091,130,378,660,238,38,1444
Washington,McCleary,2075,177,451,571,140,50,1389
Washington,Longview,37092,3320,8021,10405,2458,1572,25776
Washington,Fairfield,554,22,139,194,41,16,412
Washington,Pasco,71858,10419,10394,12387,4936,2489,40625
Washington,South Bend,1592,241,211,457,128,55,1092
Washington,Gold Bar,1911,117,475,623,163,32,1410
Washington,Lake Bosworth,1007,68,228,367,70,50,783
Washington,Maltby,12350,322,1901,2869,2593,1141,8826
Washington,Tokeland,291,33,90,106,32,0,261
Washington,Granite Falls,3575,142,804,879,317,141,2283
Washington,Lake Stevens,31778,1270,5090,8096,4145,1762,20363
Washington,Lynnwood,37671,2911,5368,10103,5731,2134,26247
Washington,Machias,910,66,209,288,41,61,665
Washington,North Marysville,176,14,120,20,22,0,176
Washington,Snohomish,9875,623,1836,2693,1052,527,6731
Washington,Startup,663,86,209,125,124,0,544
Washington,Kalama,2557,157,619,827,223,92,1918
Washington,Nisqually Indian Community,666,84,124,155,50,16,429
Washington,Farmington,115,7,26,33,14,2,82
Washington,Endicott,308,10,63,78,22,6,179
Washington,Mount Vista,8703,175,951,2452,1355,1158,6091
Washington,Wollochet,6390,132,737,1543,936,1351,4699
Washington,Browns Point,1088,27,189,291,260,119,886
Washington,Dollars Corner,724,61,202,218,80,56,617
Washington,Kayak Point,1726,82,272,550,196,93,1193
Washington,Port Gamble Tribal Community,931,53,157,203,169,61,643
Washington,Mattawa,4567,1601,360,133,61,16,2171
Washington,Willapa,182,5,45,55,22,5,132
Washington,Millwood,1686,75,348,514,234,61,1232
Washington,Glenwood,226,9,52,44,19,2,126
Washington,Quilcene,480,13,235,49,36,61,394
Washington,Olympia,50836,2390,5839,12104,9593,6773,36699
Washington,Colton,446,8,65,113,71,41,298
Washington,Tekoa,742,48,178,192,93,30,541
Washington,Bucoda,689,77,203,166,38,6,490
Washington,Tieton,1541,382,222,168,25,3,800
Washington,Alger,147,29,16,67,11,0,123
Washington,Wilderness Rim,1457,45,276,413,336,135,1205
Washington,Wauna,4323,89,1010,1075,715,382,3271
Washington,Southworth,2073,155,492,614,171,170,1602
Washington,Stansberry Lake,2768,83,451,868,127,94,1623
Washington,Steptoe,177,12,64,71,5,6,158
Washington,Summit View,7621,354,1582,1851,1014,251,5052
Washington,Sunday Lake,655,19,110,221,126,35,511
Washington,Torboy,48,0,21,16,0,0,37
Washington,Whidbey Island Station,1930,0,119,270,61,38,488
Washington,Swede Heaven,952,62,295,276,120,17,770
Washington,Tanglewilde,6581,537,1012,1750,609,435,4343
Washington,Twin Lakes,71,7,26,28,0,6,67
Washington,Union,412,0,84,201,72,28,385
Washington,Upper Elochoman,100,0,36,37,0,0,73
Washington,Valley,164,27,5,72,0,0,104
Washington,Vaughn,552,31,82,229,77,19,438
Washington,Tampico,250,25,79,70,0,0,174
Washington,South Creek,2716,233,688,926,227,34,2108
Washington,Marblemount,0,0,0,0,0,0,0
Washington,Bremerton,40220,1881,6928,12160,4087,1982,27038
Washington,Newport,2142,179,443,633,149,128,1532
Washington,Lake Shore,7909,403,1098,2015,1431,627,5574
Washington,Oakesdale,447,19,61,131,49,27,287
Washington,Fircrest,6711,129,909,1911,1146,546,4641
Washington,Skokomish,655,67,130,126,27,4,354
Washington,Clyde Hill,3295,27,66,403,865,831,2192
Washington,George,706,238,92,40,2,2,374
Washington,Arlington,19154,1097,4285,5060,1422,795,12659
Washington,Town and Country,4728,96,855,1400,648,270,3269
Washington,Sprague,452,24,121,144,27,25,341
Washington,Thorp,246,20,49,68,14,16,167
Washington,Elbe,54,0,54,0,0,0,54
Washington,Barberton,6941,260,952,1563,1362,522,4659
Washington,Othello,7980,1717,1063,948,282,122,4132
Washington,Buckley,4680,371,1076,1275,441,263,3426
Washington,Mount Vernon,34504,3861,5439,7797,3379,1505,21981
Washington,Kittitas,1548,160,320,310,124,33,947
Washington,Royal City,1517,519,153,79,10,3,764
Washington,Kingston,2307,78,467,693,356,181,1775
Washington,Ellensburg,19799,715,1658,3044,2326,1381,9124
Washington,South Cle Elum,582,9,144,203,39,25,420
Washington,Ione,406,29,101,110,40,20,300
Washington,Graham,28194,1191,5890,7188,2206,997,17472
Washington,Prairie Ridge,12550,662,2886,3500,972,312,8332
Washington,Soap Lake,1445,218,333,398,94,50,1093
Washington,Puyallup,40305,2308,8295,10034,4934,2504,28075
Washington,Wilkeson,440,21,120,146,26,9,322
Washington,Cherry Grove,725,73,68,142,38,10,331
Washington,Conway,0,0,0,0,0,0,0
Washington,Tumwater,22500,831,2823,6101,3539,2496,15790
Washington,Bay View,659,18,108,165,143,104,538
Washington,Hartline,172,14,20,55,14,2,105
Washington,University Place,32907,857,4258,8347,5616,3170,22248
Washington,Skamokawa Valley,304,23,30,138,34,68,293
Washington,Sisco Heights,2518,105,621,700,305,77,1808
Washington,Silver Firs,22052,513,2038,4784,4870,1770,13975
Washington,Oak Harbor,22820,767,3462,6825,2185,970,14209
Washington,Neah Bay,1032,86,199,241,39,28,593
Washington,Naselle,412,13,111,135,27,6,292
Washington,Basin City,1045,364,151,31,0,0,546
Washington,Country Homes,6054,140,588,1101,608,313,2750
Washington,Camano,16427,508,2961,4941,2822,1668,12900
Washington,Langley,1186,10,152,299,281,165,907
Washington,Brinnon,751,73,139,285,117,57,671
Washington,Odessa,946,123,198,268,78,35,702
Washington,Fords Prairie,2352,141,480,652,169,105,1547
Washington,Mossyrock,697,157,147,161,11,7,483
Washington,Pe Ell,531,48,116,183,18,22,387
Washington,Everett,108941,9342,19641,28772,11818,5036,74609
Washington,West Side Highway,5877,356,1058,1724,349,297,3784
Washington,Sudden Valley,7999,149,1020,2117,1744,834,5864
Washington,Brady,885,54,164,174,53,16,461
Washington,Mesa,485,118,49,58,4,7,236
Washington,Otis Orchards-East Farms,6514,258,1187,2034,656,368,4503
Washington,Lind,597,46,162,152,24,5,389
Washington,South Wenatchee,2011,480,277,192,10,34,993
Washington,Orting,7732,475,1942,1827,729,155,5128
Washington,Bell Hill,737,0,79,194,266,198,737
Washington,Blyn,22,0,10,10,0,2,22
Washington,Bickleton,83,2,17,21,9,4,53
Washington,Spokane,214804,10330,34044,57200,27210,17103,145887
Washington,Mabton,2156,634,298,139,26,0,1097
Washington,Poulsbo,10301,307,1591,2582,1811,915,7206
Washington,East Cathlamet,563,49,137,190,42,33,451
Washington,Harrington,413,21,114,71,49,24,279
Washington,Wilbur,807,15,239,231,71,45,601
Washington,Deming,227,16,19,31,61,3,130
Washington,Marietta-Alderwood,3708,208,657,1088,471,143,2567
Washington,Naches,705,63,172,194,57,33,519
Washington,Cohassett Beach,772,83,263,249,0,14,609
Washington,Taholah,665,70,137,162,21,16,406
Washington,Moxee,3958,433,655,548,244,122,2002
Washington,Prairie Heights,4256,362,780,1006,372,111,2631
Washington,Puget Island,836,44,235,260,67,33,639
Washington,Purdy,1682,78,318,459,291,157,1303
Washington,Queets,238,23,63,38,0,1,125
Washington,Qui-nai-elt Village,59,2,8,26,3,1,40
Washington,Raft Island,430,0,21,88,108,134,351
Washington,Porter,229,10,40,55,29,32,166
Washington,Rocky Point,1579,172,176,620,278,54,1300
Washington,Rosedale,4512,420,662,1241,662,485,3470
Washington,Ryderwood,454,28,165,211,31,19,454
Washington,Santiago,30,0,4,7,3,0,14
Washington,Seabeck,1060,97,166,187,179,180,809
Washington,Sekiu,62,0,0,0,0,41,41
Washington,Shadow Lake,2286,46,373,745,347,187,1698
Washington,Rosburg,323,25,31,119,27,33,235
Washington,Point Roberts,1191,70,190,339,229,166,994
Washington,Pine Grove,122,0,23,39,29,0,91
Washington,Picnic Point,8976,319,1377,2326,1762,674,6458
Washington,Union Gap,6142,1379,1201,762,201,40,3583
Washington,Wapato,5041,1352,767,376,58,52,2605
Washington,Yakima,93416,14122,15656,17518,6167,4594,58057
Washington,Connell,5482,896,1051,1630,90,75,3742
Washington,Port Hadlock-Irondale,3574,238,908,1014,323,164,2647
Washington,North Lynnwood,21608,1433,3058,5313,3450,1352,14606
Washington,North Puyallup,1722,132,468,656,158,25,1439
Washington,Northwest Stanwood,135,16,39,54,0,0,109
Washington,Onalaska,807,80,100,333,0,60,573
Washington,Orient,135,18,61,29,5,0,113
Washington,Outlook,363,133,0,0,13,0,146
Washington,Oyehut,0,0,0,0,0,0,0
Washington,Pacific Beach,472,0,137,90,51,0,278
Washington,Packwood,315,29,97,126,29,0,281
Washington,Parker,88,61,19,0,8,0,88
Washington,Leavenworth,2260,162,327,485,484,236,1694
Washington,Gorst,222,13,94,85,30,0,222
Washington,Sunnyslope,3815,112,485,777,645,603,2622
Washington,Stevenson,1503,171,334,327,109,114,1055
Washington,Port Angeles East,3328,108,844,1267,268,152,2639
Washington,La Conner,819,17,181,260,125,82,665
Washington,Parkwood,6700,345,1214,1854,538,346,4297
Washington,Midland,9208,1369,2559,1593,433,146,6100
Washington,Battle Ground,19932,885,3455,5114,1856,612,11922
Washington,Finley,5984,818,1161,1582,245,158,3964
Washington,Warden,2744,647,429,334,88,52,1550
Washington,Marrowstone,926,13,111,180,305,137,746
Washington,White Salmon,2485,225,336,379,518,246,1704
Washington,Ocean City,224,37,27,58,0,54,176
Washington,Krupp,51,0,12,14,12,0,38
Washington,White Swan,996,117,126,162,16,0,421
Washington,Salmon Creek,21299,945,2939,5477,3262,1958,14581
Washington,Albion,716,41,110,123,167,40,481
Washington,Everson,2641,318,495,589,117,92,1611
Washington,Winlock,1725,157,272,437,108,51,1025
Washington,Palouse,955,3,191,234,229,94,751
Washington,Grandview,11124,2528,1762,1339,313,99,6041
Washington,Des Moines,31518,3098,5874,7823,3900,1833,22528
Washington,Marysville,67567,4225,13222,18258,6439,2498,44642
Washington,Junction City,0,0,0,0,0,0,0
Washington,Felida,8311,18,653,1686,2090,1277,5724
Washington,Klickitat,430,14,136,148,10,2,310
Washington,Bay Center,212,6,48,116,5,14,189
Washington,Silverdale,21071,705,2878,5688,3195,1522,13988
Washington,Lebam,120,10,49,33,22,0,114
Washington,Sequim,7100,329,1494,2169,874,664,5530
Washington,Lyman,479,16,135,164,30,2,347
Washington,Roslyn,644,35,188,138,68,44,473
Washington,Arlington Heights,2573,88,757,527,397,67,1836
Washington,Walla Walla,32731,2802,4662,8288,3356,2146,21254
Washington,Greenwater,27,0,0,27,0,0,27
Washington,Amboy,2022,111,342,405,83,51,992
Washington,Auburn,79110,6138,14830,17882,8776,3717,51343
Washington,Three Lakes,3560,136,614,1040,568,242,2600
Washington,Freeland,1994,93,484,550,289,209,1625
Washington,Lakewood,59606,4451,11845,15772,5784,3090,40942
Washington,Steilacoom,6270,224,722,1578,1200,788,4512
Washington,Erlands Point-Kitsap Lake,3338,77,670,1004,503,114,2368
Washington,Indianola,3536,90,597,942,629,292,2550
Washington,Tracyton,5933,208,949,1932,788,157,4034
Washington,Sumner,9898,380,2382,2305,1337,315,6719
Washington,Bonney Lake,20313,752,3954,5225,2235,937,13103
Washington,Morton,1120,129,190,335,33,59,746
Washington,Brier,6819,241,840,1815,1355,788,5039
Washington,Richland,55043,1534,7280,12410,9539,6496,37259
Washington,Davenport,1717,93,388,411,238,126,1256
Washington,Kahlotus,183,22,30,66,15,5,138
Washington,Edmonds,41770,1095,5206,9924,9808,5293,31326
Washington,Malden,265,36,57,57,17,4,171
Washington,Vader,923,77,132,219,25,9,462
Washington,Hunts Point,432,11,19,71,138,77,316
Washington,Ronald,164,0,65,18,0,67,150
Washington,Ashford,98,0,98,0,0,0,98
Washington,Mill Creek,20164,326,2162,4379,4927,2339,14133
Washington,Montesano,3927,136,692,1255,300,127,2510
Washington,Washtucna,241,32,68,43,19,13,175
Washington,Nespelem Community,244,22,63,50,0,4,139
Washington,Copalis Beach,546,156,71,212,6,0,445
Washington,SeaTac,28925,3042,5378,7097,3276,1019,19812
Washington,Lakeview,909,136,174,236,114,23,683
Washington,Five Corners,18559,1086,3813,4568,1762,686,11915
Washington,Rochester,3232,183,622,922,328,12,2067
Washington,Garfield,551,32,87,201,54,40,414
Washington,Pullman,33050,383,941,3065,3526,4668,12583
Washington,Uniontown,382,4,56,118,78,8,264
Washington,Burlington,8743,622,1878,2109,851,320,5780
Washington,Cascade Valley,1894,245,422,449,129,135,1380
Washington,Lewisville,1671,86,354,469,154,113,1176
Washington,Tonasket,1057,104,321,247,41,40,753
Washington,Omak,4794,410,1229,1157,194,121,3111
Washington,Nespelem,193,16,38,72,1,2,129
Washington,Wallula,361,82,32,22,0,8,144
Washington,Blaine,5172,280,990,1120,889,498,3777
Washington,Glacier,105,0,36,51,18,0,105
Washington,Airway Heights,8285,742,2122,2708,470,143,6185
Washington,Oroville,1968,352,487,371,64,9,1283
Washington,Pateros,601,138,76,59,29,9,311
Washington,Touchet,509,19,65,217,35,7,343
Washington,North Sultan,232,0,83,45,46,7,181
Washington,Sultan,5040,226,1304,1393,379,64,3366
Washington,Verlot,475,82,57,123,16,0,278
Washington,Creston,262,18,62,92,21,1,194
Washington,Trout Lake,632,10,85,148,183,35,461
Washington,Wishram,499,74,114,128,18,4,338
Washington,Ilwaco,940,58,218,266,57,75,674
Washington,Oso,277,17,40,91,18,34,200
Washington,Raymond,2882,300,689,713,192,60,1954
Washington,Ocean Shores,5814,478,1371,2221,677,260,5007
Washington,Neilton,309,45,102,66,0,4,217
Washington,Chewelah,2620,197,700,732,165,90,1884
Washington,Marcus,142,19,53,45,9,6,132
Washington,East Renton Highlands,11745,392,2214,2660,2086,1057,8409
Washington,Enumclaw,11768,703,2764,3038,1202,415,8122
Washington,Hobart,7182,198,1396,1533,1341,485,4953
Washington,Lake Marcel-Stillwater,1335,22,75,473,269,274,1113
Washington,Oakville,738,45,201,189,56,11,502
Washington,Milton,7543,460,2033,1887,766,400,5546
Washington,Tanner,885,23,12,137,235,161,568
Washington,Yarrow Point,1168,5,53,100,359,337,854
Washington,Aberdeen Gardens,299,33,75,74,13,19,214
Washington,Cosmopolis,1493,109,452,461,91,39,1152
Washington,Elma,3245,307,798,734,282,70,2191
Washington,Hoquiam,8454,694,1767,2633,523,508,6125
Washington,Seattle,708823,28550,51284,115747,190311,139926,525818
Washington,Index,192,29,27,54,32,9,151
Washington,Lake Goodwin,3842,109,995,1171,445,198,2918
Washington,Martha Lake,19954,895,2370,4962,3535,1461,13223
Washington,Issaquah,36938,1072,2508,5881,9868,6859,26188
Washington,Coupeville,1766,104,234,519,275,382,1514
Washington,Port Townsend,9428,270,1294,1726,2280,1999,7569
Washington,Central Park,3072,142,883,834,271,192,2322
Washington,Sammamish,64049,960,2643,6834,17054,14047,41538
Washington,Medical Lake,4937,219,776,1109,545,470,3119
Washington,Carnation,1767,140,217,430,306,151,1244
Washington,Moclips,0,0,0,0,0,0,0
Washington,Asotin,1105,50,256,404,113,56,879
Washington,Clarkston Heights-Vineland,6403,308,1293,1784,941,454,4780
Washington,West Clarkston-Highland,6081,480,1236,1798,591,246,4351
Washington,Entiat,1260,100,316,325,81,35,857
Washington,Wenatchee,34094,4039,6144,6981,3152,2281,22597
Washington,Waterville,1415,111,369,353,155,53,1041
Washington,Satsop,624,45,140,265,33,14,497
Washington,Navy Yard City,3166,158,602,1048,135,88,2031
Washington,East Port Orchard,5331,391,872,1546,471,169,3449
Washington,Sunnyside,16442,4098,1828,1804,314,267,8311
Washington,Monroe,18503,1426,3412,4663,2016,769,12286
Washington,Mountlake Terrace,21106,1024,3215,5696,3679,1617,15231
Washington,Silvana,13,0,0,13,0,0,13
Washington,Port Ludlow,2771,0,352,1035,657,468,2512
Washington,Dixie,211,14,50,77,9,5,155
Washington,Acme,180,49,0,0,0,0,49
Washington,Bellingham,87071,3233,9728,16175,14518,8462,52116
Washington,Elk Plain,14065,966,3453,3825,917,418,9579
Washington,Fort Lewis,12933,73,1106,2546,757,249,4731
Washington,South Hill,58164,2409,9559,14845,6845,3378,37036
Washington,Gig Harbor,9382,167,921,2394,1983,1273,6738
Washington,Eschbach,385,7,45,149,53,46,300
Washington,Ruston,1233,37,169,247,224,183,860
Washington,South Prairie,280,29,101,67,21,2,220
Washington,Selah,7766,558,1198,1678,823,392,4649
Washington,Ritzville,1628,118,433,426,168,105,1250
Washington,Grapeview,906,35,259,222,83,61,660
Washington,Spangle,189,15,43,51,21,8,138
Washington,Home,1164,47,258,426,194,39,964
Washington,Lofall,2025,91,301,617,426,194,1629
Washington,Laurier,0,0,0,0,0,0,0
Washington,Larch Way,4257,287,283,983,1176,266,2995
Washington,Lake Tapps,12771,287,2239,3105,2213,773,8617
Washington,Lake Stickney,10584,834,1347,2658,1426,746,7011
Washington,Lake Holm,3254,87,547,784,716,384,2518
Washington,Lake Cassidy,3511,176,689,941,480,255,2541
Washington,La Grande,130,13,30,43,44,0,130
Washington,Keyport,422,0,61,125,44,50,280
Washington,Key Center,3823,157,522,1406,470,171,2726
Washington,Ketron Island,0,0,0,0,0,0,0
Washington,Kapowsin,274,7,102,84,0,0,193
Washington,Longbranch,3798,235,603,1177,466,157,2638
Washington,Hoodsport,242,36,77,108,0,0,221
Washington,Hogans Corner,56,0,39,17,0,0,56
Washington,High Bridge,3076,33,423,816,715,298,2285
Washington,Herron Island,41,0,17,17,0,7,41
Washington,Hazel Dell,21066,1603,3212,6082,2577,948,14422
Washington,Hat Island,56,0,0,7,28,21,56
Washington,Hansville,3402,0,522,1139,620,392,2673
Washington,Green Bluff,445,0,43,171,90,57,361
Washington,Grays River,417,15,149,81,40,25,310
Washington,Rockford,437,21,89,151,31,13,305
Washington,Latah,126,17,35,31,5,4,92
Washington,Fairchild AFB,3118,27,117,707,284,123,1258
Washington,Waverly,94,4,11,27,7,1,50
Washington,Keller,199,11,44,47,9,5,116
Washington,Loomis,125,18,31,45,0,0,94
Washington,Jamestown,281,18,43,120,15,57,253
Washington,Lower Elochoman,363,42,33,157,0,18,250
Washington,Loon Lake,732,79,163,238,25,63,568
Washington,Monroe North,1744,71,159,390,417,90,1127
Washington,Mineral,219,69,89,32,10,19,219
Washington,Methow,81,3,36,20,6,6,71
Washington,Meadowdale,3152,137,510,916,486,197,2246
Washington,Mead,6870,373,1231,1904,1052,509,5069
Washington,Mill Creek East,21523,555,1912,4050,4714,2568,13799
Washington,Manson,1374,299,315,157,81,103,955
Washington,Malott,808,162,158,98,22,10,450
Washington,Malone,430,43,63,110,64,0,280
Washington,Malo,61,18,0,0,0,0,18
Washington,McMillin,1745,45,436,495,224,99,1299
Washington,McKenna,929,26,349,105,39,0,519
Washington,Maplewood,5163,215,886,1277,812,784,3974
West Virginia,Brookhaven,5900,363,1258,877,981,484,3963
West Virginia,Red Jacket,385,108,128,45,26,14,321
West Virginia,Belmont,1040,53,382,183,71,55,744
West Virginia,MacArthur,1590,160,458,339,101,9,1067
West Virginia,Morgantown,30539,828,2928,3374,3885,3940,14955
West Virginia,Newell,1349,180,491,245,69,0,985
West Virginia,Montrose,170,18,76,14,19,5,132
West Virginia,Granville,2567,260,818,604,42,33,1757
West Virginia,Burnsville,618,52,204,85,11,21,373
West Virginia,Matoaka,188,34,69,31,1,0,135
West Virginia,Oakvale,127,10,60,4,15,0,89
West Virginia,Barrackville,1330,94,381,279,128,80,962
West Virginia,Pleasant Valley,3172,91,934,456,510,266,2257
West Virginia,Follansbee,2806,187,762,701,244,142,2036
West Virginia,Chattaroy,627,78,220,137,0,0,435
West Virginia,Bancroft,482,35,274,55,18,10,392
West Virginia,Franklin,673,62,273,88,60,55,538
West Virginia,Nutter Fort,1431,84,317,387,149,95,1032
West Virginia,Spencer,1997,401,622,286,109,93,1511
West Virginia,Lost Creek,551,43,166,74,41,20,344
West Virginia,McMechen,1915,124,601,424,95,85,1329
West Virginia,Oak Hill,8458,1137,2318,1453,675,336,5919
West Virginia,Shinnston,2601,145,659,581,215,128,1728
West Virginia,Weston,3993,440,1407,546,208,190,2791
West Virginia,Jane Lew,391,13,122,73,31,13,252
West Virginia,Rupert,894,123,307,161,39,46,676
West Virginia,Beckley,16697,1790,4021,3723,2000,906,12440
West Virginia,Matewan,467,133,163,53,19,6,374
West Virginia,West Milford,613,35,174,144,72,32,457
West Virginia,Ansted,1437,202,454,213,135,10,1014
West Virginia,Smithfield,166,45,49,17,8,0,119
West Virginia,Camden-on-Gauley,190,36,66,16,2,18,138
West Virginia,Hinton,2768,352,901,521,147,115,2036
West Virginia,Middlebourne,684,74,174,96,38,61,443
West Virginia,Quinwood,144,25,53,34,0,0,112
West Virginia,Brandonville,130,3,46,9,42,5,105
West Virginia,Craigsville,2213,330,888,364,106,26,1714
West Virginia,Albright,311,49,115,17,5,4,190
West Virginia,Northfork,291,50,88,37,9,3,187
West Virginia,Mason,920,119,275,176,68,5,643
West Virginia,Huntington,47420,3611,9020,8950,4460,3532,29573
West Virginia,Thurmond,4,0,0,0,2,2,4
West Virginia,Tunnelton,244,43,84,42,3,11,183
West Virginia,Elkins,7115,493,1806,1045,695,600,4639
West Virginia,Keystone,115,20,39,12,4,3,78
West Virginia,Smithers,1058,40,326,225,72,60,723
West Virginia,Fort Gay,924,218,272,82,14,3,589
West Virginia,Mullens,1564,111,397,318,159,57,1042
West Virginia,Shepherdstown,1605,47,97,142,91,56,433
West Virginia,Flatwoods,257,35,74,30,15,0,154
West Virginia,Sutton,1358,162,402,230,89,50,933
West Virginia,New Cumberland,1252,147,381,255,51,48,882
West Virginia,Hillsboro,183,24,60,46,5,3,138
West Virginia,Dunbar,7462,532,2124,1896,809,570,5931
West Virginia,Union,440,29,138,101,19,73,360
West Virginia,Triadelphia,779,44,365,137,37,3,586
West Virginia,Valley Grove,383,21,113,100,46,5,285
West Virginia,Leon,221,23,87,9,3,2,124
West Virginia,Parsons,1523,148,538,207,36,89,1018
West Virginia,Thomas,609,87,280,87,41,7,502
West Virginia,Wardensville,285,43,91,31,34,15,214
West Virginia,Cedar Grove,625,85,171,117,32,12,417
West Virginia,Sistersville,1311,162,402,183,126,82,955
West Virginia,Bethlehem,2522,31,487,596,592,238,1944
West Virginia,Danville,771,124,271,93,32,37,557
West Virginia,Reedy,114,9,56,20,1,0,86
West Virginia,Teays Valley,13816,351,2476,3133,2277,1578,9815
West Virginia,Cross Lanes,9619,521,2289,1851,1476,754,6891
West Virginia,Point Pleasant,4194,382,1237,833,215,124,2791
West Virginia,Rivesville,1113,71,291,180,75,75,692
West Virginia,Worthington,186,40,51,51,7,0,149
West Virginia,Montgomery,1738,223,256,227,102,74,882
West Virginia,Tornado,1211,94,338,303,84,92,911
West Virginia,Blacksville,118,7,50,7,1,1,66
West Virginia,Star City,2196,139,418,299,362,249,1467
West Virginia,Buckhannon,5566,416,1223,833,428,483,3383
West Virginia,Ceredo,1245,78,354,303,78,104,917
West Virginia,Wayne,1492,255,435,284,70,28,1072
West Virginia,Philippi,3409,373,696,486,221,244,2020
West Virginia,Cheat Lake,9337,403,1313,1327,1809,1715,6567
West Virginia,Grant Town,582,49,224,91,19,18,401
West Virginia,Davis,631,104,226,103,34,46,513
West Virginia,Athens,1043,21,81,95,100,88,385
West Virginia,Windsor Heights,331,24,136,52,25,0,237
West Virginia,Grantsville,538,52,167,81,32,19,351
West Virginia,Capon Bridge,453,38,132,71,13,7,261
West Virginia,Bayard,217,38,104,20,9,0,171
West Virginia,Petersburg,2520,356,711,509,207,152,1935
West Virginia,Bradley,1888,49,618,257,99,79,1102
West Virginia,Lester,541,47,193,61,27,4,332
West Virginia,Salt Rock,340,106,199,14,0,21,340
West Virginia,Rossmore,393,94,85,105,0,0,284
West Virginia,Roderfield,24,12,12,0,0,0,24
West Virginia,Sarah Ann,88,0,22,43,0,0,65
West Virginia,Robinette,557,79,252,51,0,0,382
West Virginia,Reader,335,80,77,76,50,21,304
West Virginia,Raysal,598,161,119,28,0,0,308
West Virginia,Rand,1618,162,399,395,188,17,1161
West Virginia,Scarbro,721,75,227,133,0,31,466
West Virginia,Racine,229,33,129,29,0,11,202
West Virginia,Prince,93,7,22,0,0,0,29
West Virginia,Switzer,557,45,113,204,38,0,400
West Virginia,Alum Creek,1744,122,228,659,249,0,1258
West Virginia,West Hamlin,713,83,280,113,15,16,507
West Virginia,Hendricks,286,15,112,49,12,5,193
West Virginia,Anawalt,100,25,30,8,7,4,74
West Virginia,Whitesville,501,109,198,45,14,0,366
West Virginia,Chester,2314,193,915,577,46,0,1731
West Virginia,Rachel,219,15,31,14,46,12,118
West Virginia,Shannondale,3404,239,735,848,311,174,2307
West Virginia,Shenandoah Junction,413,52,168,42,65,0,327
West Virginia,Shrewsbury,823,82,277,92,93,39,583
West Virginia,Prichard,282,84,42,81,0,0,207
West Virginia,Wallace,412,48,153,28,15,6,250
West Virginia,St. George,161,6,73,9,6,0,94
West Virginia,Parcoal,115,5,54,12,14,0,85
West Virginia,Arbovale,131,28,71,7,10,15,131
West Virginia,Summersville,3408,288,990,671,334,402,2685
West Virginia,Wolf Summit,157,14,97,30,16,0,157
West Virginia,Whitmer,12,0,12,0,0,0,12
West Virginia,Waverly,402,33,91,135,70,15,344
West Virginia,Vivian,54,16,14,0,0,0,30
West Virginia,Verdunville,590,40,231,195,35,0,501
West Virginia,Valley Head,248,21,148,27,25,27,248
West Virginia,Van,206,6,33,54,0,14,107
West Virginia,Valley Bend,449,51,149,91,40,0,331
West Virginia,Twilight,36,13,23,0,0,0,36
West Virginia,Tioga,101,19,40,0,0,0,59
West Virginia,Stollings,347,13,127,106,16,0,262
West Virginia,Springfield,272,21,110,69,10,32,242
West Virginia,Spelter,370,22,149,63,0,0,234
West Virginia,Bluefield,10022,828,2562,1930,1318,547,7185
West Virginia,Harman,88,27,33,5,3,4,72
West Virginia,Elkview,1609,202,821,166,46,32,1267
West Virginia,Monongah,1089,94,313,261,97,14,779
West Virginia,Pullman,151,37,60,13,3,0,113
West Virginia,Glenville,1692,103,215,180,160,108,766
West Virginia,War,825,196,327,37,12,43,615
West Virginia,Ravenswood,3740,315,994,581,348,281,2519
West Virginia,Richwood,2031,213,680,333,142,55,1423
West Virginia,Terra Alta,1781,179,596,330,35,19,1159
West Virginia,Pinch,2554,382,390,490,397,392,2051
West Virginia,St. Albans,10442,512,2896,2290,1303,656,7657
West Virginia,Paden City,3132,293,1064,709,157,16,2239
West Virginia,Blennerhassett,3319,260,587,847,327,193,2214
West Virginia,Boaz,1585,95,370,377,202,113,1157
West Virginia,Lubeck,1258,74,397,250,149,97,967
West Virginia,Fayetteville,2838,182,485,502,599,208,1976
West Virginia,Mallory,1049,83,369,158,77,0,687
West Virginia,Mount Hope,1185,131,316,282,92,18,839
West Virginia,Pax,168,28,54,42,0,0,124
West Virginia,Harts,551,67,198,91,18,10,384
West Virginia,Gilbert Creek,1030,294,323,114,37,57,825
West Virginia,Crab Orchard,1904,75,586,496,51,100,1308
West Virginia,Cairo,295,72,109,38,4,2,225
West Virginia,Harrisville,2256,285,746,376,115,116,1638
West Virginia,Parkersburg,30328,2658,8323,6737,2202,1343,21263
West Virginia,Keyser,5119,292,1503,911,332,213,3251
West Virginia,Hamlin,1533,148,597,265,67,40,1117
West Virginia,Wiley Ford,896,35,347,187,26,27,622
West Virginia,Stanaford,1060,72,325,231,84,85,797
West Virginia,Vienna,10446,423,1884,2584,1556,965,7412
West Virginia,Mount Gay-Shamrock,1178,328,358,258,20,24,988
West Virginia,Clendenin,1064,152,354,155,81,41,783
West Virginia,Fairview,409,36,144,56,16,10,262
West Virginia,Addison (Webster Springs),869,122,238,219,60,34,673
West Virginia,Sophia,1220,191,370,173,35,19,788
West Virginia,Benwood,1440,102,465,390,68,32,1057
West Virginia,Bridgeport,8466,245,1336,1517,1886,1306,6290
West Virginia,Ellenboro,351,38,130,66,7,12,253
West Virginia,Milton,2612,266,640,612,215,108,1841
West Virginia,New Martinsville,5190,368,1548,1092,424,225,3657
West Virginia,Winfield,2636,89,564,535,323,264,1775
West Virginia,Moundsville,8651,739,3306,1886,461,337,6729
West Virginia,Hambleton,207,44,105,23,0,0,172
West Virginia,Kermit,257,42,70,66,16,13,207
West Virginia,Man,1009,121,243,233,73,35,705
West Virginia,St. Marys,1994,128,680,404,174,72,1458
West Virginia,Meadow Bridge,347,42,119,42,11,17,231
West Virginia,Pickens,19,9,10,0,0,0,19
West Virginia,Despard,966,108,389,151,29,0,677
West Virginia,Big Chimney,454,64,149,66,29,77,385
West Virginia,Big Creek,116,27,49,0,0,0,76
West Virginia,Big Sandy,148,13,81,54,0,0,148
West Virginia,Birch River,118,14,55,0,0,0,69
West Virginia,Bluewell,2277,324,889,294,175,23,1705
West Virginia,Bolt,893,152,255,168,0,0,575
West Virginia,Boomer,644,0,70,190,63,9,332
West Virginia,Bowden,0,0,0,0,0,0,0
West Virginia,Brandywine,123,22,50,18,0,0,90
West Virginia,Brenton,207,80,27,65,35,0,207
West Virginia,Bruno,1126,158,172,204,0,0,534
West Virginia,Berwind,422,68,102,57,0,0,227
West Virginia,Brush Fork,1499,215,429,174,139,17,974
West Virginia,Burlington,115,0,42,9,0,16,67
West Virginia,Carolina,569,75,282,70,54,0,481
West Virginia,Cass,38,8,30,0,0,0,38
West Virginia,Century,97,6,25,17,0,9,57
West Virginia,Charlton Heights,309,0,192,31,17,0,240
West Virginia,Chauncey,501,0,128,124,18,27,297
West Virginia,Chelyan,1001,303,303,60,0,0,666
West Virginia,Comfort,227,21,29,24,34,22,130
West Virginia,Corinne,289,0,181,41,0,0,222
West Virginia,Covel,25,0,25,0,0,0,25
West Virginia,Crum,102,19,22,46,0,15,102
West Virginia,Bud,417,62,242,16,19,0,339
West Virginia,Crumpler,162,34,57,18,9,0,118
West Virginia,Bergoo,57,3,33,5,5,0,46
West Virginia,Beards Fork,137,0,75,40,8,0,123
West Virginia,South Charleston,12686,591,2651,2744,1694,1395,9075
West Virginia,Oceana,1192,189,438,192,44,14,877
West Virginia,Princeton,5907,705,1473,1262,458,297,4195
West Virginia,Charles Town,5885,478,1143,1036,807,428,3892
West Virginia,Harpers Ferry,283,6,35,34,91,35,201
West Virginia,Durbin,210,13,77,23,10,6,129
West Virginia,Marlinton,1152,133,303,217,90,24,767
West Virginia,Bolivar,1270,42,290,286,182,94,894
West Virginia,Weirton,18894,1040,4894,4677,2098,1165,13874
West Virginia,Romney,2176,178,601,413,133,132,1457
West Virginia,Huttonsville,181,29,49,30,3,11,122
West Virginia,Belva,66,6,43,17,0,0,66
West Virginia,Mill Creek,737,115,291,47,33,7,493
West Virginia,Gassaway,1019,137,272,162,89,45,705
West Virginia,Beverly,687,69,202,107,49,10,437
West Virginia,Womelsdorf (Coalton),315,33,153,34,9,12,241
West Virginia,White Hall,767,32,167,159,115,60,533
West Virginia,Ranson corpor,5058,323,1556,868,489,260,3496
West Virginia,Accoville,938,123,246,182,22,0,573
West Virginia,Amherstdale,503,92,224,31,0,29,376
West Virginia,Apple Grove,51,21,21,0,9,0,51
West Virginia,Aurora,185,7,51,46,13,0,117
West Virginia,Bartley,54,0,22,32,0,0,54
West Virginia,Bartow,78,0,45,0,0,0,45
West Virginia,Beech Bottom,645,59,193,118,22,17,409
West Virginia,Cucumber,65,32,8,7,6,0,53
West Virginia,Dailey,28,16,0,12,0,0,28
West Virginia,Deep Water,306,40,133,35,15,0,223
West Virginia,Jefferson,820,119,250,95,30,0,494
West Virginia,Justice,589,81,185,110,13,0,389
West Virginia,Kimberly,148,0,100,11,13,0,124
West Virginia,Kincaid,68,9,34,25,0,0,68
West Virginia,Kistler,244,79,51,105,0,0,235
West Virginia,Kopperston,486,100,213,60,27,0,400
West Virginia,Lashmeet,408,47,78,63,48,45,281
West Virginia,Lavalette,1347,165,270,60,211,85,791
West Virginia,Lesage,1022,181,332,251,40,48,852
West Virginia,Littleton,131,0,41,0,44,0,85
West Virginia,Clarksburg,15830,1382,4114,3300,1409,802,11007
West Virginia,Jacksonburg,41,16,25,0,0,0,41
West Virginia,Pentress,210,0,14,10,0,22,46
West Virginia,Page,79,28,25,16,0,0,69
West Virginia,Omar,468,0,164,127,32,0,323
West Virginia,New Richmond,374,111,174,27,0,0,312
West Virginia,Nettie,609,0,295,201,0,0,496
West Virginia,Neibert,89,0,13,12,0,64,89
West Virginia,Mount Carbon,381,0,82,94,89,0,265
West Virginia,Monaville,251,51,99,55,0,0,205
West Virginia,Middleway,431,75,134,57,21,0,287
West Virginia,Maybeury,93,5,33,14,10,0,62
West Virginia,Matheny,355,100,81,87,0,12,280
West Virginia,McConnell,585,82,162,219,10,10,483
West Virginia,Pageton,141,20,45,14,0,0,79
West Virginia,Itmann,286,15,168,15,0,0,198
West Virginia,Idamay,544,39,167,145,0,80,431
West Virginia,Hometown,576,51,255,47,42,0,395
West Virginia,Dixie,224,31,117,24,18,0,190
West Virginia,East Dailey,789,21,239,86,20,0,366
West Virginia,Eccles,68,0,0,48,0,20,68
West Virginia,Falling Waters,1485,118,364,398,146,47,1073
West Virginia,Falls View,178,0,30,30,81,0,141
West Virginia,Fenwick,162,7,92,5,5,0,109
West Virginia,Ghent,525,22,130,88,112,38,390
West Virginia,Frank,67,6,19,21,0,0,46
West Virginia,Gallipolis Ferry,852,97,388,143,4,6,638
West Virginia,Galloway,81,33,25,0,0,0,58
West Virginia,Glen Ferris,195,18,0,69,64,0,151
West Virginia,Glen Fork,406,53,95,58,0,0,206
West Virginia,Glen Jean,160,17,92,20,15,0,144
West Virginia,Glen White,302,38,64,96,0,0,198
West Virginia,Great Cacapon,307,75,91,57,0,0,223
West Virginia,Green Bank,257,0,56,6,54,26,142
West Virginia,Green Spring,163,25,64,28,0,12,129
West Virginia,Greenview,461,35,142,134,8,0,319
West Virginia,Gypsy,222,74,47,0,29,24,174
West Virginia,Helen,13,0,13,0,0,0,13
West Virginia,Helvetia,80,0,36,20,7,0,63
West Virginia,Henlawson,90,23,67,0,0,0,90
West Virginia,Hepzibah,572,38,260,112,21,17,448
West Virginia,Hico,253,38,46,45,29,10,168
West Virginia,Hilltop,426,99,262,47,0,0,408
West Virginia,Sissonville,4951,559,1671,733,424,124,3511
West Virginia,Marmet,1440,192,457,258,126,36,1069
West Virginia,Huntersville,117,0,66,23,10,0,99
West Virginia,Masontown,618,74,195,102,43,16,430
West Virginia,North Hills,999,8,46,151,270,171,646
West Virginia,Williamstown,2927,146,681,682,449,317,2275
West Virginia,Culloden,3457,114,824,789,356,250,2333
West Virginia,Hurricane,6477,262,1530,1410,714,438,4354
West Virginia,Nitro,6201,453,1611,1391,538,382,4375
West Virginia,Iaeger,229,70,56,31,0,3,160
West Virginia,Kimball,130,12,60,7,23,11,113
West Virginia,Hartford City,722,56,281,145,22,10,514
West Virginia,Kingwood,2943,229,835,476,321,151,2012
West Virginia,Gary,733,115,281,110,34,7,547
West Virginia,Welch,3287,473,1384,640,93,156,2746
West Virginia,Mineralwells,1866,141,397,478,156,136,1308
West Virginia,New Haven,1520,136,500,339,104,18,1097
West Virginia,Kenova,3095,384,1072,704,115,70,2345
West Virginia,Madison,2860,167,789,736,136,197,2025
West Virginia,Sylvester,208,29,64,31,10,21,155
West Virginia,East Bank,845,117,310,151,65,7,650
West Virginia,Glasgow,755,80,266,160,54,34,594
West Virginia,Westover,4205,205,1027,792,641,500,3165
West Virginia,Bath (Berkeley Springs),674,37,135,136,62,64,434
West Virginia,Fairmont,18507,1120,4022,3136,2047,1317,11642
West Virginia,Farmington,433,10,132,86,3,14,245
West Virginia,Bramwell,320,30,103,58,42,18,251
West Virginia,Junior,388,86,104,49,10,1,250
West Virginia,Clay,556,119,162,68,18,21,388
West Virginia,Inwood,3364,171,1051,658,303,55,2238
West Virginia,Cowen,636,81,235,129,8,23,476
West Virginia,Prosperity,1597,188,546,460,181,0,1375
West Virginia,West Liberty,1728,28,129,91,52,56,356
West Virginia,Eleanor,1521,65,430,441,143,13,1092
West Virginia,Friendly,125,17,32,26,0,0,75
West Virginia,Shady Spring,3485,119,841,618,402,457,2437
West Virginia,Daniels,1929,179,624,499,144,28,1474
West Virginia,Coal City,1810,248,835,253,69,0,1405
West Virginia,Delbarton,520,105,115,96,8,7,331
West Virginia,Fort Ashby,1461,61,593,407,126,40,1227
West Virginia,Mitchell Heights,458,10,82,115,43,77,327
West Virginia,Logan,1790,215,426,365,156,25,1187
West Virginia,Chapmanville,1171,164,360,179,72,60,835
West Virginia,Grafton,5091,501,1905,953,478,77,3914
West Virginia,Stonewood,1777,128,689,432,122,49,1420
West Virginia,Moorefield,3201,508,1169,484,117,143,2421
West Virginia,Flemington,397,28,116,87,34,25,290
West Virginia,Carpendale,723,10,292,174,50,28,554
West Virginia,Elk Garden,214,23,80,27,0,0,130
West Virginia,Holden,649,92,209,114,29,52,496
West Virginia,Williamson,2883,393,641,557,209,141,1941
West Virginia,West Logan,491,48,112,125,35,20,340
West Virginia,Piedmont,719,71,312,106,20,0,509
West Virginia,Gilbert,408,49,116,78,39,25,307
West Virginia,Beaver,1384,26,639,363,101,0,1129
West Virginia,Mabscott,1466,133,399,273,117,75,997
West Virginia,Enterprise,953,151,357,193,61,10,772
West Virginia,Hooverson Heights,2561,134,836,632,193,77,1872
West Virginia,Lumberport,801,100,230,165,50,10,555
West Virginia,West Union,819,93,253,149,30,24,549
West Virginia,Pine Grove,456,60,212,47,14,11,344
West Virginia,Washington,856,9,237,267,90,47,650
West Virginia,Buffalo,1261,75,476,175,65,38,829
West Virginia,Peterstown,654,41,204,108,50,19,422
West Virginia,Fairlea,1664,299,492,329,66,63,1249
West Virginia,Falling Spring,184,7,58,53,20,11,149
West Virginia,Ronceverte,1970,202,572,400,174,90,1438
West Virginia,Glen Dale,1505,71,419,344,203,126,1163
West Virginia,Lewisburg,3904,265,601,666,793,563,2888
West Virginia,Alderson,1178,106,279,334,110,60,889
West Virginia,Wellsburg,2624,221,774,454,199,216,1864
West Virginia,Newburg,400,28,164,54,13,7,266
West Virginia,Reedsville,407,22,178,46,33,29,308
West Virginia,Gauley Bridge,669,110,179,86,58,5,438
West Virginia,Powellton,684,130,237,71,36,41,515
West Virginia,Anmoore,645,70,177,157,15,9,428
West Virginia,Salem,1664,158,304,247,101,92,902
West Virginia,Cameron,609,73,246,53,36,20,428
West Virginia,Rainelle,1245,176,436,235,72,36,955
West Virginia,White Sulphur Springs,2745,395,642,537,187,77,1838
West Virginia,Ripley,3198,181,894,700,361,173,2309
West Virginia,Clearview,595,24,113,126,63,55,381
West Virginia,Wheeling,27190,1650,6777,5242,3490,2428,19587
West Virginia,Belle,1230,64,403,215,118,73,873
West Virginia,Bruceton Mills,48,8,21,4,4,3,40
West Virginia,Poca,1045,91,280,214,102,60,747
West Virginia,Sand Fork,223,24,37,42,7,10,120
West Virginia,Barboursville,4185,454,900,901,447,441,3143
West Virginia,Pennsboro,1073,128,346,159,65,27,725
West Virginia,Pratt,436,11,111,120,50,36,328
West Virginia,Hedgesville,299,20,60,77,26,10,193
West Virginia,Martinsburg,17497,1757,3944,3511,1460,690,11362
West Virginia,Chesapeake,1899,178,696,341,47,46,1308
West Virginia,Handley,194,11,70,56,5,1,143
West Virginia,Bradshaw,230,67,60,28,4,3,162
West Virginia,Davy,248,61,59,20,5,0,145
West Virginia,Coal Fork,1335,184,468,166,65,94,977
West Virginia,Ridgeley,654,34,207,116,57,17,431
West Virginia,Rhodell,111,27,34,9,2,2,74
West Virginia,Rowlesburg,461,59,149,80,21,9,318
West Virginia,Charleston,48734,2804,9589,8925,6757,6477,34552
West Virginia,Pineville,736,66,209,156,48,27,506
West Virginia,Bethany,1039,0,58,49,44,77,228
West Virginia,Montcalm,475,113,134,45,8,0,300
West Virginia,Auburn,117,16,43,13,0,0,72
West Virginia,Hundred,302,75,109,53,4,15,256
West Virginia,Cassville,1378,16,560,260,107,13,956
West Virginia,Elizabeth,809,106,167,176,32,16,497
West Virginia,Piney View,1267,110,446,194,75,70,895
West Virginia,Paw Paw,535,94,153,81,8,19,355
West Virginia,Mannington,1623,189,583,288,79,68,1207
West Virginia,Pea Ridge,6215,140,1158,1468,875,898,4539
West Virginia,Henderson,342,92,63,22,23,2,202
West Virginia,Belington,1925,225,592,292,85,72,1266
Wisconsin,Rewey,306,17,64,90,19,10,200
Wisconsin,Oostburg,2988,97,684,709,314,173,1977
Wisconsin,Darien,1795,140,457,381,97,82,1157
Wisconsin,Montreal,748,23,162,222,91,41,539
Wisconsin,Milwaukee,596886,61249,109902,107932,57124,31811,368018
Wisconsin,Alma Center,444,42,111,95,40,10,298
Wisconsin,Balsam Lake,777,72,262,201,56,18,609
Wisconsin,Princeton,1233,92,385,265,98,21,861
Wisconsin,Sussex,10791,185,1707,2213,2229,782,7116
Wisconsin,Mount Calvary,507,21,137,134,33,31,356
Wisconsin,Howards Grove,3254,38,665,857,561,147,2268
Wisconsin,Hanover,167,10,62,8,16,4,100
Wisconsin,Hager City,274,10,81,75,27,7,200
Wisconsin,Green Valley,138,5,60,22,0,0,87
Wisconsin,Greenleaf,825,119,174,169,41,5,508
Wisconsin,Greenbush,142,3,28,37,16,2,86
Wisconsin,Grand View,83,5,31,23,5,3,67
Wisconsin,Kewaunee,2859,120,889,669,283,122,2083
Wisconsin,Evansville,5260,127,1021,1458,654,166,3426
Wisconsin,Luxemburg,2547,57,545,620,327,55,1604
Wisconsin,Rockland,645,20,151,166,54,4,395
Wisconsin,Hustler,214,11,44,60,19,13,147
Wisconsin,New Post,274,21,67,74,14,40,216
Wisconsin,Amery,2825,212,752,680,278,104,2026
Wisconsin,Oconomowoc,16579,365,2408,3213,3528,1690,11204
Wisconsin,Greendale,14245,382,2541,3168,2834,1564,10489
Wisconsin,Roberts,1845,91,314,474,207,75,1161
Wisconsin,Centuria,904,35,241,213,34,12,535
Wisconsin,Alma,735,29,216,221,62,40,568
Wisconsin,Racine,77576,8008,15559,17061,5593,2541,48762
Wisconsin,Edgar,1572,72,435,332,104,41,984
Wisconsin,Delavan Lake,2609,200,511,606,328,271,1916
Wisconsin,Ironton,243,26,57,65,4,1,153
Wisconsin,Melrose,509,20,138,120,44,15,337
Wisconsin,Catawba,124,20,40,25,10,0,95
Wisconsin,Nekoosa,2494,87,795,569,137,64,1652
Wisconsin,Plover,12686,422,2509,2437,2215,855,8438
Wisconsin,Whiting,1637,124,476,336,256,82,1274
Wisconsin,Menasha,18075,1065,4453,3946,1795,768,12027
Wisconsin,Odanah,0,0,0,0,0,0,0
Wisconsin,Germantown,19997,528,3314,4128,4099,1860,13929
Wisconsin,Hartford,14761,615,3509,3360,1718,516,9718
Wisconsin,Viroqua,4371,279,1388,806,442,304,3219
Wisconsin,Seymour,1497,43,310,457,172,112,1094
Wisconsin,Casco,556,32,152,97,56,23,360
Wisconsin,West Bend,31649,1204,7408,7468,4360,1635,22075
Wisconsin,Cadott,1423,69,420,320,72,34,915
Wisconsin,Augusta,1566,134,464,355,58,52,1063
Wisconsin,Stockbridge,672,19,224,121,98,31,493
Wisconsin,Durand,1787,139,540,397,153,74,1303
Wisconsin,Endeavor,586,39,174,114,20,5,352
Wisconsin,Como,2477,138,540,630,281,179,1768
Wisconsin,Hatfield,199,3,74,39,12,19,147
Wisconsin,Arpin,333,31,94,74,9,5,213
Wisconsin,Reeseville,712,81,174,157,26,18,456
Wisconsin,Clyman,375,19,147,96,27,2,291
Wisconsin,Withee,405,46,120,95,18,2,281
Wisconsin,Oxford,567,31,162,166,28,5,392
Wisconsin,Westfield,1327,79,364,274,54,40,811
Wisconsin,Melvina,52,3,23,6,4,2,38
Wisconsin,Delavan,8338,1211,1809,1740,534,299,5593
Wisconsin,Lime Ridge,176,41,55,28,18,0,142
Wisconsin,Plain,735,37,220,177,74,19,527
Wisconsin,Waukau,289,14,123,71,5,17,230
Wisconsin,Waumandee,85,6,43,9,6,1,65
Wisconsin,Westboro,159,14,49,35,16,11,125
Wisconsin,Elkhorn,9907,652,1869,2140,1147,609,6417
Wisconsin,Dellwood,614,85,216,154,17,18,490
Wisconsin,Summit,4846,137,670,1016,1026,560,3409
Wisconsin,Bloomfield,4704,322,1162,968,332,70,2854
Wisconsin,Whittlesey,110,4,31,39,4,2,80
Wisconsin,Harrison,11761,242,2034,2477,2105,739,7597
Wisconsin,Winchester,644,12,152,170,93,50,477
Wisconsin,Woodford,39,5,22,3,0,0,30
Wisconsin,Woodruff,764,34,166,256,89,28,573
Wisconsin,North Bay,207,9,23,24,51,44,151
Wisconsin,Lancaster,3745,143,909,891,285,195,2423
Wisconsin,St. Joseph,506,33,120,77,80,45,355
Wisconsin,Lily Lake,477,1,161,90,31,14,297
Wisconsin,Post Lake,267,20,117,51,20,29,237
Wisconsin,Hingham,901,29,165,226,151,31,602
Wisconsin,Van Dyne,201,6,81,64,19,5,175
Wisconsin,Tustin,119,3,53,34,11,0,101
Wisconsin,Turtle Lake,286,3,49,88,45,38,223
Wisconsin,Tunnel City,121,7,60,23,8,0,98
Wisconsin,Trego,174,11,53,54,12,7,137
Wisconsin,Townsend,73,3,16,26,3,3,51
Wisconsin,Tilleda,100,6,42,3,0,0,51
Wisconsin,Tichigan,5208,156,884,1122,990,420,3572
Wisconsin,Three Lakes,521,43,145,102,97,67,454
Wisconsin,Thornton,68,2,24,14,0,4,44
Wisconsin,Taycheedah,782,0,249,146,137,30,562
Wisconsin,Summit Lake,154,24,55,37,5,5,126
Wisconsin,Stone Lake,178,7,38,50,22,8,125
Wisconsin,Springfield,97,7,30,40,0,0,77
Wisconsin,Sobieski,364,0,70,62,60,31,223
Wisconsin,Sextonville,407,22,121,92,8,3,246
Wisconsin,Sayner,204,6,29,87,5,21,148
Wisconsin,Saxon,54,5,23,18,3,0,49
Wisconsin,Sandy Hook,305,5,105,50,53,5,218
Wisconsin,Wabeno,370,62,89,82,22,0,255
Wisconsin,St. Peter,1447,43,242,369,192,114,960
Wisconsin,Waubeka,760,25,157,235,99,14,530
Wisconsin,Spencer,1808,114,496,403,132,48,1193
Wisconsin,Downing,245,11,103,26,14,2,156
Wisconsin,Oakdale,281,17,85,78,22,7,209
Wisconsin,Lodi,3053,65,441,759,383,347,1995
Wisconsin,St. Francis,9509,595,2181,2307,1718,753,7554
Wisconsin,Hortonville,2743,86,615,745,300,124,1870
Wisconsin,Rosendale,1013,45,279,186,137,30,677
Wisconsin,Cameron,1903,97,481,532,118,59,1287
Wisconsin,Spring Valley,1565,56,409,318,163,68,1014
Wisconsin,Maiden Rock,95,0,24,19,11,12,66
Wisconsin,Mishicot,1384,57,433,338,101,46,975
Wisconsin,Kiel,3750,167,1097,793,323,138,2518
Wisconsin,Merrill,9178,649,2575,2176,758,374,6532
Wisconsin,Niagara,1536,92,433,371,110,13,1019
Wisconsin,Sherwood,2917,18,490,514,715,312,2049
Wisconsin,Middle Village,193,15,56,44,7,0,122
Wisconsin,Scandinavia,418,18,129,86,31,13,277
Wisconsin,Bowler,405,25,135,46,16,4,226
Wisconsin,Baraboo,12093,977,2710,2748,1377,607,8419
Wisconsin,Suring,474,52,174,88,32,11,357
Wisconsin,Dorchester,910,45,283,156,57,16,557
Wisconsin,Pulcifer,112,12,43,16,12,7,90
Wisconsin,Poy Sippi,285,39,94,47,21,7,208
Wisconsin,Port Wing,197,7,43,67,20,21,158
Wisconsin,Lake Tomahawk,201,9,65,92,25,3,194
Wisconsin,Lauderdale Lakes,1103,53,187,204,248,142,834
Wisconsin,Lake Sherwood,379,8,132,77,76,44,337
Wisconsin,Lake Lorraine,237,31,96,39,21,15,202
Wisconsin,Lake Ivanhoe,449,4,138,96,34,17,289
Wisconsin,Lake Camelot,637,9,263,208,68,17,565
Wisconsin,Lake Arrowhead,910,34,215,321,182,107,859
Wisconsin,Krakow,370,23,140,56,48,11,278
Wisconsin,Knowlton,148,3,64,24,17,0,108
Wisconsin,King,1804,158,679,400,156,130,1523
Wisconsin,Kieler,553,10,140,180,73,15,418
Wisconsin,Jump River,24,2,12,5,1,0,20
Wisconsin,Juda,256,24,90,53,13,3,183
Wisconsin,Jim Falls,243,24,97,48,22,12,203
Wisconsin,Iron River,661,52,176,190,51,24,493
Wisconsin,Iron Belt,187,1,64,55,15,2,137
Wisconsin,Humbird,270,17,85,53,0,3,158
Wisconsin,Houlton,212,15,52,97,22,0,186
Wisconsin,Holcombe,198,25,58,39,23,0,145
Wisconsin,Lakewood,296,24,88,47,57,21,237
Wisconsin,Laona,356,12,132,58,14,12,228
Wisconsin,Lebanon,238,8,51,74,4,6,143
Wisconsin,Leopolis,117,5,38,14,9,3,69
Wisconsin,Polonia,557,21,172,133,38,18,382
Wisconsin,Pine River,153,7,54,49,6,0,116
Wisconsin,Pence,141,0,60,30,12,5,107
Wisconsin,Pembine,110,8,40,12,5,0,65
Wisconsin,Pella,154,10,62,38,15,7,132
Wisconsin,Packwaukee,164,16,64,51,6,0,137
Wisconsin,Ogema,140,5,62,35,13,0,115
Wisconsin,Northport,533,40,178,110,44,14,386
Wisconsin,New Odanah,442,39,129,105,22,0,295
Wisconsin,Herbster,81,0,8,21,24,21,74
Wisconsin,Newald,168,19,44,30,2,0,95
Wisconsin,Mountain,263,34,110,64,15,4,227
Wisconsin,Mole Lake,464,58,110,118,5,0,291
Wisconsin,Minocqua,340,38,125,58,52,8,281
Wisconsin,Millston,116,12,41,40,5,0,98
Wisconsin,Mercer,522,3,110,177,46,24,360
Wisconsin,Marengo,115,3,30,14,7,0,54
Wisconsin,Long Lake,55,10,28,9,0,0,47
Wisconsin,Little Sturgeon,224,7,83,56,31,16,193
Wisconsin,Lewis,154,15,57,29,18,4,123
Wisconsin,Navarino,156,2,70,31,19,3,125
Wisconsin,Athens,1025,85,340,190,85,43,743
Wisconsin,Hayward,2533,161,526,510,232,155,1584
Wisconsin,Hatley,488,20,123,147,42,19,351
Wisconsin,Caledonia,24875,1052,5364,6072,3376,1952,17816
Wisconsin,Lake Hallie,6633,93,1461,1989,785,189,4517
Wisconsin,Mount Pleasant,26738,1097,5414,6402,4010,2404,19327
Wisconsin,Suamico,12470,200,2494,2910,2154,949,8707
Wisconsin,Gilmanton,132,25,45,14,2,2,88
Wisconsin,Springbrook,95,2,26,33,0,6,67
Wisconsin,Wiota,117,15,36,26,6,2,85
Wisconsin,Maine,2306,70,499,533,340,169,1611
Wisconsin,Somers,8334,449,1225,1903,1104,779,5460
Wisconsin,Windsor,6899,167,870,1536,1649,597,4819
Wisconsin,Fox Crossing,18788,762,4246,4278,3006,928,13220
Wisconsin,Salem Lakes,14692,999,3073,3072,1748,755,9647
Wisconsin,Abrams,462,37,134,111,42,3,327
Wisconsin,Allenton,925,0,171,349,123,20,663
Wisconsin,Amberg,200,22,52,46,8,11,139
Wisconsin,Angelica,93,10,41,21,0,3,75
Wisconsin,Argonne,154,6,53,24,2,4,89
Wisconsin,Arkansaw,196,11,74,42,5,0,132
Wisconsin,Arkdale,119,9,58,22,7,3,99
Wisconsin,Kronenwetter,7665,152,1571,1898,1113,540,5274
Wisconsin,Ashippun,1040,36,297,273,73,46,725
Wisconsin,Hobart,8606,251,1656,1861,1179,1221,6168
Wisconsin,Richfield,11623,298,2104,2590,2280,1151,8423
Wisconsin,Cashton,986,82,274,194,74,49,673
Wisconsin,Kendall,518,42,163,96,41,15,357
Wisconsin,Warrens,499,28,134,101,46,20,329
Wisconsin,Fenwood,157,8,71,25,5,4,113
Wisconsin,Marathon City,1378,64,419,318,143,49,993
Wisconsin,Schofield,2209,116,719,468,159,70,1532
Wisconsin,North Freedom,637,66,137,163,37,15,418
Wisconsin,Dresser,1019,47,280,244,62,26,659
Wisconsin,Nelson,353,19,114,65,32,12,242
Wisconsin,Ellsworth,3257,191,914,786,285,101,2277
Wisconsin,Elmwood,710,41,234,148,77,21,521
Wisconsin,Star Prairie,716,18,203,167,70,26,484
Wisconsin,Hudson,13650,316,2054,3072,2583,1354,9379
Wisconsin,Mondovi,2626,238,775,576,127,132,1848
Wisconsin,Rock Springs,342,20,99,78,16,6,219
Wisconsin,Zoar,126,4,41,35,0,0,80
Wisconsin,Arcadia,3013,372,686,370,264,47,1739
Wisconsin,Whitehall,1608,131,428,361,114,56,1090
Wisconsin,Brookfield,38151,797,3877,5764,9449,7343,27230
Wisconsin,Bellevue,15515,764,3545,3593,2556,666,11124
Wisconsin,Babcock,68,14,30,15,0,0,59
Wisconsin,Baileys Harbor,207,0,35,67,56,23,181
Wisconsin,Bancroft,548,70,130,62,42,11,315
Wisconsin,Drummond,128,19,16,32,15,4,86
Wisconsin,Dunbar,81,4,26,23,9,0,62
Wisconsin,Dyckesville,549,27,119,91,132,56,425
Wisconsin,Edmund,165,14,44,37,12,0,107
Wisconsin,Elcho,278,5,64,105,0,39,213
Wisconsin,Ellison Bay,161,5,48,41,29,0,123
Wisconsin,Emerald,110,13,40,20,12,2,87
Wisconsin,Eureka,594,163,129,104,8,0,404
Wisconsin,Florence,501,57,172,122,54,0,405
Wisconsin,Forest Junction,735,45,131,224,78,0,478
Wisconsin,Franks Field,163,40,7,70,2,0,119
Wisconsin,Gibbsville,509,12,208,66,55,12,353
Wisconsin,Glen Haven,48,3,23,6,5,3,40
Wisconsin,Glidden,323,27,162,60,7,0,256
Wisconsin,Goodman,232,22,85,56,20,2,185
Wisconsin,Gordon,175,26,42,66,8,0,142
Wisconsin,Gotham,186,3,67,56,10,3,139
Wisconsin,Grand Marsh,168,30,36,30,3,0,99
Wisconsin,Rochester,3784,142,865,867,470,225,2569
Wisconsin,Downsville,113,2,18,41,26,2,89
Wisconsin,Dodge,117,7,44,37,2,0,90
Wisconsin,Diaperville,37,0,19,13,0,0,32
Wisconsin,Diamond Bluff,175,16,67,40,7,8,138
Wisconsin,Barronett,148,19,32,42,0,0,93
Wisconsin,Birch Hill,370,63,51,46,8,9,177
Wisconsin,Bluffview,555,54,116,117,9,7,303
Wisconsin,Boulder Junction,100,6,18,45,11,2,82
Wisconsin,Bristol,4993,196,1323,1294,579,340,3732
Wisconsin,Brule,227,5,44,54,32,12,147
Wisconsin,Burnett,230,13,57,77,12,5,164
Wisconsin,Butte des Morts,799,19,150,255,129,61,614
Wisconsin,Cable,216,23,40,52,17,16,148
Wisconsin,Montello,1434,147,432,367,106,59,1111
Wisconsin,Caroline,217,23,68,46,9,8,154
Wisconsin,Chain O' Lakes,848,17,181,182,278,107,765
Wisconsin,Chelsea,104,14,24,24,0,0,62
Wisconsin,Chili,180,16,30,40,7,2,95
Wisconsin,Clam Lake,29,0,12,12,3,2,29
Wisconsin,Collins,140,4,41,41,2,2,90
Wisconsin,Cornucopia,92,6,4,38,19,13,80
Wisconsin,Dale,586,10,165,151,53,21,400
Wisconsin,Dalton,230,11,76,46,10,0,143
Wisconsin,Danbury,156,7,56,44,10,0,117
Wisconsin,Cataract,169,33,35,39,11,8,126
Wisconsin,Marquette,172,13,57,60,8,0,138
Wisconsin,Kingston,327,22,102,91,20,5,240
Wisconsin,Whitewater,14766,437,1229,1478,883,702,4729
Wisconsin,Oconomowoc Lake,585,5,47,92,169,102,415
Wisconsin,Wales,2564,52,294,574,432,347,1699
Wisconsin,Waukesha,72382,3371,11577,14965,12196,5834,47943
Wisconsin,Mequon,23984,399,1932,3244,5688,5220,16483
Wisconsin,Little Round Lake,1190,98,252,233,34,0,617
Wisconsin,Genoa City,3009,106,732,665,250,116,1869
Wisconsin,Lake Geneva,7815,496,1555,1404,1130,712,5297
Wisconsin,Sharon,1748,231,444,302,66,32,1075
Wisconsin,Reserve,341,38,98,82,13,5,236
Wisconsin,Forestville,482,31,140,109,32,12,324
Wisconsin,Superior,781,38,174,213,97,33,555
Wisconsin,Camp Douglas,635,32,166,164,33,7,402
Wisconsin,New Auburn,482,23,151,96,40,5,315
Wisconsin,Howard,19396,697,4395,4344,2698,1221,13355
Wisconsin,Nichols,272,42,100,25,1,4,172
Wisconsin,Clinton,2160,131,551,442,168,112,1404
Wisconsin,Peshtigo,3383,142,1019,841,323,106,2431
Wisconsin,Burlington,10758,377,2803,2407,1260,464,7311
Wisconsin,Radisson,294,7,85,35,6,6,139
Wisconsin,New Berlin,39774,1025,7229,8983,7989,4392,29618
Wisconsin,Lannon,1177,24,329,362,107,45,867
Wisconsin,Dousman,2411,140,542,540,281,156,1659
Wisconsin,Strum,1098,40,285,293,94,25,737
Wisconsin,Allouez,13891,803,2705,3312,2341,1142,10303
Wisconsin,Arena,874,37,246,204,64,25,576
Wisconsin,Muscoda,1443,99,422,299,111,52,983
Wisconsin,Kohler,2193,15,232,329,556,405,1537
Wisconsin,Green Bay,104818,8410,21010,20877,11854,4718,66869
Wisconsin,Hazel Green,1002,28,292,228,116,34,698
Wisconsin,Pleasant Prairie,20722,1045,3863,4961,3283,1657,14809
Wisconsin,Maribel,369,24,147,52,31,5,259
Wisconsin,St. Nazianz,803,51,258,185,70,12,576
Wisconsin,Winter,311,43,99,53,22,11,228
Wisconsin,Plum City,552,61,170,114,27,16,388
Wisconsin,Deer Park,283,21,112,62,13,0,208
Wisconsin,Brandon,906,53,253,206,89,33,634
Wisconsin,Eden,758,66,205,201,58,14,544
Wisconsin,Fond du Lac,42858,2639,10322,9309,5078,1956,29304
Wisconsin,North Fond du Lac,5066,368,1217,1319,380,91,3375
Wisconsin,Waupun,11296,894,3322,2774,975,309,8274
Wisconsin,Trempealeau,1742,61,381,453,226,98,1219
Wisconsin,Kimberly,6744,211,1578,1614,981,240,4624
Wisconsin,Bayside,4529,102,338,502,1276,1125,3343
Wisconsin,Prescott,4235,75,1097,1213,342,194,2921
Wisconsin,Colby,1989,281,539,337,68,40,1265
Wisconsin,Union Center,195,23,59,57,0,10,149
Wisconsin,Wilson,220,5,73,57,13,4,152
Wisconsin,Cleveland,1642,143,302,394,184,98,1121
Wisconsin,Baldwin,4000,174,910,1105,359,135,2683
Wisconsin,Fountain City,859,43,237,211,75,53,619
Wisconsin,Linden,512,35,99,134,38,9,315
Wisconsin,Argyle,875,38,271,221,35,35,600
Wisconsin,Random Lake,1643,50,415,391,205,76,1137
Wisconsin,Hancock,385,55,94,84,33,3,269
Wisconsin,Denmark,2143,96,506,376,245,107,1330
Wisconsin,Twin Lakes,6070,286,1433,1654,506,307,4186
Wisconsin,Eagle Lake,1084,8,287,254,217,90,856
Wisconsin,Union Grove,4925,329,1099,1276,498,176,3378
Wisconsin,Waterford,5437,223,1318,1186,824,160,3711
Wisconsin,Two Rivers,11219,808,3097,2863,1072,387,8227
Wisconsin,Whitelaw,666,28,195,162,73,20,478
Wisconsin,Glenwood City,1295,60,363,298,96,25,842
Wisconsin,Unity,350,32,122,76,10,0,240
Wisconsin,Oconto Falls,2826,211,830,727,140,103,2011
Wisconsin,Cazenovia,360,38,117,75,16,8,254
Wisconsin,Merrimac,597,20,152,141,71,40,424
Wisconsin,Wauwatosa,47882,974,5384,7701,12190,8456,34705
Wisconsin,South Milwaukee,21089,1488,5387,5075,2183,991,15124
Wisconsin,North Hudson,3803,44,520,822,753,448,2587
Wisconsin,Tomahawk,3201,222,643,881,415,95,2256
Wisconsin,Cecil,548,33,194,152,39,23,441
Wisconsin,Gresham,504,8,158,119,18,11,314
Wisconsin,Mattoon,443,64,121,84,10,1,280
Wisconsin,Wittenberg,1074,105,404,143,82,43,777
Wisconsin,Gilman,379,28,136,87,30,17,298
Wisconsin,Granton,326,22,103,66,18,4,213
Wisconsin,Gays Mills,488,15,130,137,37,24,343
Wisconsin,Lynxville,235,20,40,52,27,1,140
Wisconsin,Mayville,4921,369,1357,1113,402,127,3368
Wisconsin,Walworth,2822,213,555,569,317,150,1804
Wisconsin,Kaukauna,15998,599,4391,3301,1898,678,10867
Wisconsin,Coleman,776,57,194,198,55,28,532
Wisconsin,Pound,435,32,144,91,24,4,295
Wisconsin,New Glarus,1951,98,321,488,318,172,1397
Wisconsin,Columbus,5022,170,1053,1135,797,289,3444
Wisconsin,Iron Ridge,971,46,338,246,49,15,694
Wisconsin,Ripon,7777,580,1812,1480,754,494,5120
Wisconsin,Fox Point,6688,101,346,690,1875,1837,4849
Wisconsin,Hales Corners,7666,276,1268,1753,1422,707,5426
Wisconsin,Crandon,1994,157,515,515,119,73,1379
Wisconsin,Antigo,7799,543,2171,1690,516,372,5292
Wisconsin,Sister Bay,755,12,164,143,215,68,602
Wisconsin,Brodhead,3275,251,875,762,287,95,2270
Wisconsin,Superior,26346,1269,5404,7363,2802,1410,18248
Wisconsin,Milton,5577,289,1361,1216,566,261,3693
Wisconsin,Paddock Lake,2988,181,697,837,355,138,2208
Wisconsin,Shullsburg,1289,96,407,260,118,29,910
Wisconsin,Blanchardville,819,46,217,191,81,35,570
Wisconsin,Benton,970,68,227,282,56,61,694
Wisconsin,Wrightstown,3389,101,572,703,492,192,2060
Wisconsin,Bohners Lake,2520,220,698,536,232,170,1856
Wisconsin,Rhinelander,7528,500,1945,1603,866,390,5304
Wisconsin,Belmont,981,34,297,236,99,26,692
Wisconsin,Lohrville,340,54,140,64,12,2,272
Wisconsin,Cedar Grove,2111,60,551,494,157,109,1371
Wisconsin,Adell,564,26,176,132,39,18,391
Wisconsin,Montfort,806,37,177,203,51,26,494
Wisconsin,Mineral Point,2560,51,546,688,270,243,1798
Wisconsin,Cobb,490,6,120,126,59,17,328
Wisconsin,Avoca,725,50,182,187,32,3,454
Wisconsin,Wisconsin Rapids,17842,1132,4927,4298,1349,642,12348
Wisconsin,Rosholt,511,21,211,70,37,10,349
Wisconsin,Amherst Junction,400,6,117,69,59,20,271
Wisconsin,Wauzeka,782,13,190,213,35,22,473
Wisconsin,Washburn,2014,53,376,504,353,222,1508
Wisconsin,Fennimore,2575,88,432,729,272,122,1643
Wisconsin,Bloomington,764,24,220,217,38,18,517
Wisconsin,Park Falls,2367,217,582,700,208,90,1797
Wisconsin,Bloomer,3503,237,994,873,365,131,2600
Wisconsin,Chaseburg,320,8,77,95,43,8,231
Wisconsin,Viola,742,31,272,111,36,13,463
Wisconsin,Westby,2461,182,564,505,264,128,1643
Wisconsin,Cornell,1733,143,411,367,92,42,1055
Wisconsin,West Baraboo,1665,116,333,326,183,88,1046
Wisconsin,Neenah,25886,1047,5889,5242,3749,1748,17675
Wisconsin,Jefferson,7964,595,2015,1913,746,385,5654
Wisconsin,Fort Atkinson,12429,1097,2727,2805,1378,560,8567
Wisconsin,Ontario,505,51,126,120,24,6,327
Wisconsin,Platteville,12301,154,1591,1537,961,897,5140
Wisconsin,Hollandale,261,5,92,68,21,4,190
Wisconsin,Weyerhaeuser,268,29,87,72,14,3,205
Wisconsin,Fredonia,2395,91,617,518,228,123,1577
Wisconsin,Independence,1579,169,488,227,96,20,1000
Wisconsin,Monroe,10636,654,2905,2533,959,488,7539
Wisconsin,Eastman,419,30,122,70,33,4,259
Wisconsin,Bagley,333,26,106,103,12,11,258
Wisconsin,Greenfield,37083,2083,8693,8937,6208,2279,28200
Wisconsin,Waupaca,5950,297,1959,1268,558,289,4371
Wisconsin,Coon Valley,825,36,224,181,81,49,571
Wisconsin,Hewitt,942,33,174,244,120,76,647
Wisconsin,Combined Locks,3570,197,827,743,507,94,2368
Wisconsin,Milladore,316,17,85,63,30,0,195
Wisconsin,Rome,738,19,226,202,57,33,537
Wisconsin,Cross Plains,4106,49,845,919,783,268,2864
Wisconsin,Arlington,796,11,187,191,97,26,512
Wisconsin,Madison,252086,7288,21885,36637,50850,39514,156174
Wisconsin,Buffalo City,893,30,295,242,104,53,724
Wisconsin,Hawkins,381,24,153,84,16,3,280
Wisconsin,Chippewa Falls,14017,755,3350,3444,1367,528,9444
Wisconsin,Aniwa,251,28,61,69,12,8,178
Wisconsin,Oliver,388,36,84,96,38,14,268
Wisconsin,Readstown,447,45,159,60,32,19,315
Wisconsin,Boyd,599,36,167,165,24,18,410
Wisconsin,Genoa,235,13,59,69,14,8,163
Wisconsin,Janesville,64128,3296,15385,14841,7179,3399,44100
Wisconsin,Slinger,5330,245,961,1181,824,340,3551
Wisconsin,Bayfield,504,6,91,111,137,54,399
Wisconsin,Woodman,81,10,12,29,2,2,55
Wisconsin,Patch Grove,160,8,50,35,18,2,113
Wisconsin,Hillsboro,1318,86,401,259,105,61,912
Wisconsin,Mount Hope,203,5,47,43,9,5,109
Wisconsin,Ogdensburg,188,10,86,41,11,2,150
Wisconsin,Whitefish Bay,14039,231,602,1435,3505,3443,9216
Wisconsin,Shorewood,13344,128,888,1647,3337,3331,9331
Wisconsin,Weyauwega,1805,147,559,350,135,43,1234
Wisconsin,Newburg,1118,54,274,367,87,31,813
Wisconsin,Jackson,7020,354,1424,1786,1102,324,4990
Wisconsin,Vesper,615,49,186,130,39,23,427
Wisconsin,Beloit,36813,3771,8564,6856,2328,1539,23058
Wisconsin,St. Cloud,497,16,175,133,43,18,385
Wisconsin,Campbellsport,1911,95,609,363,148,97,1312
Wisconsin,Hustisford,991,20,245,273,78,26,642
Wisconsin,Horicon,3623,218,994,702,279,113,2306
Wisconsin,Fox Lake,1647,166,514,330,101,40,1151
Wisconsin,Rib Lake,923,65,260,153,77,32,587
Wisconsin,Medford,4312,332,1205,899,383,129,2948
Wisconsin,Lublin,101,8,55,13,7,1,84
Wisconsin,Brillion,3133,116,803,609,337,34,1899
Wisconsin,Stoddard,904,43,196,263,90,27,619
Wisconsin,Stratford,1640,51,418,410,117,63,1059
Wisconsin,Manitowoc,32798,2355,8894,7188,3526,1301,23264
Wisconsin,De Soto,331,14,71,114,23,10,232
Wisconsin,Orfordville,1280,59,393,289,119,51,911
Wisconsin,Bell Center,120,23,38,19,10,10,100
Wisconsin,Neillsville,2373,169,809,572,170,90,1810
Wisconsin,Cassville,875,59,309,199,74,18,659
Wisconsin,Grantsburg,1343,69,311,370,80,69,899
Wisconsin,New London,6772,362,1930,1312,607,134,4345
Wisconsin,Iola,1179,53,333,287,131,64,868
Wisconsin,Potter,279,13,74,57,19,4,167
Wisconsin,Hilbert,1004,74,319,201,89,15,698
Wisconsin,Eau Claire,68086,2483,9600,14857,8980,4685,40605
Wisconsin,Pepin,828,43,274,206,81,30,634
Wisconsin,Prairie du Sac,4288,173,938,870,581,334,2896
Wisconsin,Hixton,455,23,141,125,25,11,325
Wisconsin,Lake Nebagamon,1005,20,143,232,218,132,745
Wisconsin,Darlington,2330,244,553,508,132,122,1559
Wisconsin,Lake Wissota,2929,81,712,799,412,242,2246
Wisconsin,Cumberland,2458,242,673,423,279,123,1740
Wisconsin,Butler,1835,67,523,494,232,66,1382
Wisconsin,Weston,15093,922,3121,3381,1846,825,10095
Wisconsin,New Holstein,3142,312,625,922,385,25,2269
Wisconsin,Milltown,1115,94,296,261,65,31,747
Wisconsin,North Prairie,2303,57,400,537,410,159,1563
Wisconsin,Merrillan,617,68,158,135,17,13,391
Wisconsin,Woodville,1329,74,367,274,98,31,844
Wisconsin,Gillett,1104,108,402,253,46,39,848
Wisconsin,Tigerton,602,59,212,125,53,13,462
Wisconsin,Oak Creek,35843,1256,7625,8104,5651,2759,25395
Wisconsin,Ingram,70,7,24,15,7,1,54
Wisconsin,Plymouth,8540,429,1941,1973,1299,469,6111
Wisconsin,Berlin,5428,499,1499,1026,451,216,3691
Wisconsin,Redgranite,1991,416,717,434,119,27,1713
Wisconsin,Wild Rose,798,57,241,185,41,26,550
Wisconsin,Sturtevant,6611,598,1814,1609,719,163,4903
Wisconsin,Wind Point,1766,28,223,322,463,353,1389
Wisconsin,Kellnersville,346,22,125,80,28,11,266
Wisconsin,Valders,974,47,217,253,71,15,603
Wisconsin,Elm Grove,6172,159,515,763,1643,1288,4368
Wisconsin,Little Chute,11225,469,2790,2835,1409,337,7840
Wisconsin,Merton,3632,29,335,555,874,423,2216
Wisconsin,West Milwaukee,4173,495,1010,843,449,115,2912
Wisconsin,Cedarburg,11501,319,1235,1951,2857,1825,8187
Wisconsin,West Allis,60250,3814,15501,15105,7770,2699,44889
Wisconsin,Ephraim,280,4,18,83,103,47,255
Wisconsin,Sturgeon Bay,8907,565,2092,2220,1145,551,6573
Wisconsin,Poplar,665,20,163,130,104,23,440
Wisconsin,Solon Springs,591,45,156,181,41,37,460
Wisconsin,Shell Lake,1348,98,327,339,140,66,970
Wisconsin,Sun Prairie,32757,848,4316,7031,6620,2961,21776
Wisconsin,Ixonia,1925,33,375,418,299,89,1214
Wisconsin,Palmyra,1737,118,486,426,117,54,1201
Wisconsin,Tainter Lake,2763,83,653,634,438,304,2112
Wisconsin,Blue Mounds,1002,54,201,214,135,52,656
Wisconsin,Fitchburg,28722,1012,3494,5490,6011,3846,19853
Wisconsin,Cascade,656,35,186,162,83,5,471
Wisconsin,Mazomanie,1820,81,393,429,251,91,1245
Wisconsin,Sheldon,224,32,46,60,19,0,157
Wisconsin,Luck,1165,66,436,277,97,42,918
Wisconsin,Nelsonville,94,5,16,22,12,7,62
Wisconsin,Appleton,74234,3861,13652,15872,10589,5038,49012
Wisconsin,Winneconne,2627,104,656,524,375,150,1809
Wisconsin,Butternut,426,22,130,92,25,11,280
Wisconsin,Mellen,687,58,201,192,63,17,531
Wisconsin,Kewaskum,4159,173,1017,1105,457,157,2909
Wisconsin,Edgerton,5522,254,1325,1106,724,257,3666
Wisconsin,Footville,872,93,287,207,28,10,625
Wisconsin,La Farge,845,83,279,148,63,18,591
Wisconsin,Fairchild,567,85,190,71,14,9,369
Wisconsin,Altoona,7499,341,1160,2061,797,701,5060
Wisconsin,Algoma,3069,181,837,674,423,81,2196
Wisconsin,White Lake,301,32,123,71,7,16,249
Wisconsin,Prairie Farm,489,26,173,116,41,13,369
Wisconsin,Birchwood,356,21,118,81,33,12,265
Wisconsin,Cambria,714,54,147,154,50,12,417
Wisconsin,Friesland,304,18,67,83,31,5,204
Wisconsin,Portage,10361,709,2819,2529,819,289,7165
Wisconsin,Wyocena,778,89,233,203,43,22,590
Wisconsin,Menomonie,16312,479,1959,2195,1616,1028,7277
Wisconsin,Rockdale,226,1,50,56,30,10,147
Wisconsin,Grafton,11627,135,1772,2645,2657,1062,8271
Wisconsin,Lake Delton,2984,253,646,650,429,71,2049
Wisconsin,La Valle,354,25,123,85,17,5,255
Wisconsin,Birnamwood,802,53,262,178,32,15,540
Wisconsin,Turtle Lake,945,43,324,200,25,28,620
Wisconsin,Shorewood Hills,2214,5,62,109,344,982,1502
Wisconsin,Waunakee,13522,212,1423,2619,2784,1642,8680
Wisconsin,Bangor,1293,70,285,384,155,63,957
Wisconsin,Clear Lake,996,29,387,210,63,7,696
Wisconsin,Fremont,593,14,153,224,78,23,492
Wisconsin,Wausaukee,516,37,165,116,48,7,373
Wisconsin,Chilton,3848,301,959,968,496,54,2778
Wisconsin,Chief Lake,506,29,135,95,47,16,322
Wisconsin,Bruce,738,71,216,124,85,12,508
Wisconsin,Osceola,2496,120,643,561,241,93,1658
Wisconsin,Clayton,466,20,118,87,33,23,281
Wisconsin,Thiensville,3182,99,378,577,811,374,2239
Wisconsin,Muskego,24868,690,5162,5172,4226,1882,17132
Wisconsin,Frederic,1037,99,303,244,45,44,735
Wisconsin,Lac La Belle,287,2,18,51,81,40,192
Wisconsin,Eagle,2069,56,396,569,277,59,1357
Wisconsin,Saukville,4456,238,840,1032,488,171,2769
Wisconsin,Shawano,9009,486,2358,2141,622,468,6075
Wisconsin,Wilton,475,13,128,124,20,15,300
Wisconsin,Tomah,9349,529,2359,1982,1027,423,6320
Wisconsin,Sparta,9656,562,2533,2235,1094,376,6800
Wisconsin,Green Lake,828,43,218,218,121,68,668
Wisconsin,Wonewoc,732,38,278,174,38,15,543
Wisconsin,Mauston,4375,401,1287,967,351,117,3123
Wisconsin,Lyndon Station,478,62,147,95,10,13,327
Wisconsin,Adams,1996,255,572,422,98,35,1382
Wisconsin,Exeland,225,11,60,41,19,3,134
Wisconsin,Couderay,73,2,23,28,7,1,61
Wisconsin,St. Croix Falls,1922,111,533,424,161,213,1442
Wisconsin,Webster,671,64,180,147,56,7,454
Wisconsin,Big Falls,42,7,18,15,0,2,42
Wisconsin,Embarrass,548,33,232,77,45,7,394
Wisconsin,Junction City,428,31,133,76,28,9,277
Wisconsin,Stevens Point,26402,990,3775,3919,3518,1889,14091
Wisconsin,Auburndale,752,66,189,115,91,32,493
Wisconsin,Biron,918,75,286,202,92,35,690
Wisconsin,Port Edwards,1688,70,472,427,169,120,1258
Wisconsin,Ladysmith,3188,384,939,478,231,179,2211
Wisconsin,Lac du Flambeau,1537,153,355,385,68,58,1019
Wisconsin,DeForest,9936,124,1627,2415,1696,645,6507
Wisconsin,Wheeler,360,42,112,67,23,3,247
Wisconsin,Ridgeland,260,28,76,59,12,3,178
Wisconsin,Poynette,2496,100,531,723,266,116,1736
Wisconsin,Minong,427,53,157,77,22,13,322
Wisconsin,South Wayne,404,41,151,78,11,10,291
Wisconsin,Dallas,403,18,123,108,18,3,270
Wisconsin,Stanley,3660,393,1098,1028,185,77,2781
Wisconsin,Haugen,334,31,78,97,22,10,238
Wisconsin,Brownsville,616,33,187,107,72,26,425
Wisconsin,Beaver Dam,16366,866,4631,3593,1244,730,11064
Wisconsin,Prentice,619,52,204,119,40,11,426
Wisconsin,Steuben,77,4,22,23,4,1,54
Wisconsin,Soldiers Grove,569,66,198,83,41,9,397
Wisconsin,Potosi,698,35,216,141,94,23,509
Wisconsin,Dickeyville,1227,33,325,314,99,21,792
Wisconsin,Boscobel,3150,340,823,759,302,122,2346
Wisconsin,Blue River,444,33,129,112,18,13,305
Wisconsin,Siren,824,53,219,194,59,32,557
Wisconsin,Fall Creek,1475,79,254,363,152,87,935
Wisconsin,De Pere,24836,590,3683,5356,4218,1603,15450
Wisconsin,Tennyson,301,19,89,71,31,10,220
Wisconsin,Coloma,413,49,132,84,26,4,295
Wisconsin,Park Ridge,507,2,66,113,133,65,379
Wisconsin,French Island,4360,114,943,1491,587,331,3466
Wisconsin,Lake Mills,5850,435,920,1255,1086,443,4139
Wisconsin,Cambridge,1250,31,217,339,240,123,950
Wisconsin,Holmen,9909,255,1722,2380,1406,577,6340
Wisconsin,Mount Horeb,7421,74,984,1485,1774,548,4865
Wisconsin,Sullivan,711,39,187,156,71,30,483
Wisconsin,Monona,8068,151,1002,1709,1813,1358,6033
Wisconsin,Marshall,3965,307,991,896,296,104,2594
Wisconsin,Spooner,2591,183,678,594,256,106,1817
Wisconsin,Brooklyn,1283,45,190,358,221,68,882
Wisconsin,Belleville,2459,51,392,667,348,164,1622
Wisconsin,Rice Lake,8324,416,2208,1883,844,436,5787
Wisconsin,Almena,685,38,229,145,42,4,458
Wisconsin,Manawa,1428,59,430,256,97,27,869
Wisconsin,Stockholm,88,3,12,24,16,16,71
Wisconsin,Crivitz,998,88,382,218,65,18,771
Wisconsin,Marion,1138,97,426,224,58,7,812
Wisconsin,Clintonville,4384,345,1055,871,562,128,2961
Wisconsin,Marinette,10678,643,3225,2590,773,356,7587
Wisconsin,Glendale,13015,387,1532,2575,2958,2263,9715
Wisconsin,Pigeon Falls,403,59,118,82,44,25,328
Wisconsin,Blair,1334,153,411,246,78,18,906
Wisconsin,Omro,3573,92,937,649,460,139,2277
Wisconsin,Reedsburg,9484,639,2293,1682,948,440,6002
Wisconsin,Lake Wazeecha,2426,48,487,790,298,156,1779
Wisconsin,Livingston,603,29,152,160,42,13,396
Wisconsin,Rio,1091,42,264,296,85,32,719
Wisconsin,Black Earth,1395,27,348,308,226,75,984
Wisconsin,Maple Bluff,1422,20,99,200,351,422,1092
Wisconsin,Verona,12743,172,1247,1945,2676,2031,8071
Wisconsin,Waterloo,3333,328,894,661,425,152,2460
Wisconsin,La Crosse,51866,1938,7461,9940,6266,3717,29322
Wisconsin,West Salem,5013,133,1038,1138,825,374,3508
Wisconsin,Eagle River,1550,118,393,338,158,57,1064
Wisconsin,Neshkoro,383,40,153,100,19,7,319
Wisconsin,East Troy,4330,171,993,1019,551,277,3011
Wisconsin,Friendship,628,116,221,108,42,16,503
Wisconsin,Tony,118,13,48,16,14,1,92
Wisconsin,Richland Center,5050,300,1221,996,379,322,3218
Wisconsin,Lone Rock,814,89,303,142,52,13,599
Wisconsin,Port Washington,11695,343,2127,2880,2069,816,8235
Wisconsin,Belgium,2210,93,395,565,356,105,1514
Wisconsin,Pewaukee,8207,271,1674,1944,1422,726,6037
Wisconsin,Nashotah,1200,24,132,219,329,155,859
Wisconsin,Mukwonago,7833,109,1804,1708,982,712,5315
Wisconsin,Hartland,9260,213,1322,2121,1628,826,6110
Wisconsin,Osseo,1694,123,428,423,145,64,1183
Wisconsin,Sheboygan,48531,3403,12035,10622,4723,1823,32606
Wisconsin,Ridgeway,663,49,171,135,73,25,453
Wisconsin,Dodgeville,4734,128,1377,1164,433,296,3398
Wisconsin,Brokaw,257,11,64,63,40,14,192
Wisconsin,Wyeville,159,9,35,43,5,2,94
Wisconsin,Norwalk,698,128,131,84,28,6,377
Wisconsin,Phillips,1437,116,409,306,153,16,1000
Wisconsin,Ferryville,159,16,41,59,18,9,143
Wisconsin,Albany,1207,62,363,273,78,24,800
Wisconsin,Brown Deer,12039,455,2152,3093,1980,1213,8893
Wisconsin,Monticello,1050,45,325,276,96,49,791
Wisconsin,Seymour,3461,236,825,729,358,180,2328
Wisconsin,Shiocton,852,59,283,157,62,17,578
Wisconsin,Cudahy,18349,1061,5091,4629,2050,877,13708
Wisconsin,River Hills,1479,12,42,212,374,455,1095
Wisconsin,Keshena,1377,19,363,229,46,20,677
Wisconsin,Legend Lake,1496,109,324,361,159,133,1086
Wisconsin,Ettrick,587,22,191,138,32,12,395
Wisconsin,Galesville,1794,134,466,349,211,65,1225
Wisconsin,Brice Prairie,2173,50,439,609,261,148,1507
Wisconsin,Onalaska,18546,727,2854,4500,2837,1888,12806
Wisconsin,Almond,482,58,101,96,41,10,306
Wisconsin,Ashland,7963,359,1666,1910,825,562,5322
Wisconsin,Boyceville,985,78,354,186,37,33,688
Wisconsin,Doylestown,234,13,111,34,12,1,171
Wisconsin,Elk Mound,1085,39,240,224,96,32,631
Wisconsin,Knapp,553,71,168,99,21,8,367
Wisconsin,Deerfield,2528,88,444,586,461,128,1707
Wisconsin,McFarland,8492,199,1236,2078,1642,849,6004
Wisconsin,Ashwaubenon,17181,752,3632,4107,2520,1104,12115
Wisconsin,Loyal,1265,55,410,260,83,42,850
Wisconsin,Theresa,1056,63,343,321,65,19,811
Wisconsin,Hurley,1533,147,443,456,125,47,1218
Wisconsin,Rib Mountain,6033,136,1265,1000,981,619,4001
Wisconsin,Mosinee,4009,240,1049,946,536,72,2843
Wisconsin,Somerset,2740,74,536,643,220,88,1561
Wisconsin,New Richmond,8890,291,1489,2601,1035,267,5683
Wisconsin,Elmwood Park,520,23,64,163,95,46,391
Wisconsin,Gratiot,261,12,95,61,17,3,188
Wisconsin,Browns Lake,2070,91,444,410,289,309,1543
Wisconsin,Wautoma,2122,356,513,269,90,100,1328
Wisconsin,Glenbeulah,425,12,130,86,65,25,318
Wisconsin,Cuba City,2168,87,481,513,245,104,1430
Wisconsin,Amherst,1028,75,189,202,145,40,651
Wisconsin,Pardeeville,2077,84,538,544,158,82,1406
Wisconsin,Lake Ripley,1845,14,314,446,462,209,1445
Wisconsin,Stoughton,13080,486,2494,2909,2128,902,8919
Wisconsin,Pittsville,902,83,249,241,62,22,657
Wisconsin,Stetsonville,601,26,190,119,19,16,370
Wisconsin,Kekoskee,179,11,76,53,8,1,149
Wisconsin,Bear Creek,383,61,115,81,5,5,267
Wisconsin,Black Creek,1379,55,426,261,99,27,868
Wisconsin,Fairwater,378,38,109,70,34,7,258
Wisconsin,Oakfield,1020,71,280,238,132,53,774
Wisconsin,Franklin,36185,1631,6670,7527,6753,3634,26215
Wisconsin,Marshfield,18305,873,4177,3898,2186,1800,12934
Wisconsin,Rudolph,463,30,158,106,43,10,347
Wisconsin,Lake Koshkonong,1133,71,277,298,158,101,905
Wisconsin,Fall River,1884,122,385,367,252,92,1218
Wisconsin,Middleton,19235,329,1927,3162,4618,3615,13651
Wisconsin,Chetek,2166,183,630,495,226,68,1602
Wisconsin,Neosho,629,44,185,125,43,14,411
Wisconsin,Randolph,1894,128,504,431,110,35,1208
Wisconsin,Helenville,234,12,36,55,56,13,172
Wisconsin,Lomira,2582,207,590,622,280,61,1760
Wisconsin,Johnson Creek,2969,98,488,695,464,207,1952
Wisconsin,Watertown,23677,1309,6499,5161,2092,940,16001
Wisconsin,Oshkosh,66610,3706,13953,13625,7703,2825,41812
Wisconsin,Mason,102,2,22,31,3,2,60
Wisconsin,Kennan,113,10,40,33,6,1,90
Wisconsin,Thorp,1502,121,480,340,97,52,1090
Wisconsin,Curtiss,299,58,57,25,6,0,146
Wisconsin,Greenwood,1009,111,301,244,60,35,751
Wisconsin,Owen,879,66,206,255,76,24,627
Wisconsin,Prairie du Chien,5695,337,1779,1372,513,228,4229
Wisconsin,Chenequa,560,13,51,106,143,120,433
Wisconsin,Menomonee Falls,36784,935,6518,7248,7775,3917,26393
Wisconsin,Boaz,132,8,52,38,4,2,104
Wisconsin,Yuba,45,4,21,17,0,0,42
Wisconsin,Delafield,7390,158,874,1481,1804,1003,5320
Wisconsin,Big Bend,1286,22,341,445,121,50,979
Wisconsin,Colfax,1106,47,266,284,95,54,746
Wisconsin,Pulaski,3558,88,825,642,403,86,2044
Wisconsin,Eland,154,13,58,31,12,1,115
Wisconsin,Juneau,2686,201,839,566,230,53,1889
Wisconsin,Mount Sterling,150,8,33,34,22,12,109
Wisconsin,Lowell,253,22,106,56,21,9,214
Wisconsin,Browntown,263,21,92,50,17,8,188
Wisconsin,Elroy,1361,182,449,244,109,40,1024
Wisconsin,Potter Lake,1164,28,232,398,154,98,910
Wisconsin,Williams Bay,2592,81,418,587,416,387,1889
Wisconsin,Bonduel,1378,82,370,282,94,63,891
Wisconsin,Elderon,326,113,45,30,8,2,198
Wisconsin,Hammond,2020,93,446,453,278,58,1328
Wisconsin,River Falls,15467,451,1766,2673,2072,1002,7964
Wisconsin,Cochrane,451,1,108,136,62,4,311
Wisconsin,Neopit,858,25,278,121,39,9,472
Wisconsin,Okauchee Lake,4409,68,586,760,1198,587,3199
Wisconsin,Pewaukee,14299,275,1896,2595,3706,1732,10204
Wisconsin,Wisconsin Dells,2752,161,698,679,331,101,1970
Wisconsin,Lake Wisconsin,4336,113,812,1230,744,407,3306
Wisconsin,Lena,518,36,193,108,12,13,362
Wisconsin,Oconto,4469,429,1442,886,324,108,3189
Wisconsin,Loganville,266,23,74,70,12,4,183
Wisconsin,Sauk City,3467,95,889,959,519,172,2634
Wisconsin,Powers Lake,970,44,232,252,148,44,720
Wisconsin,Black River Falls,3512,185,871,1010,213,215,2494
Wisconsin,Wind Lake,5266,158,1147,1298,765,346,3714
Wisconsin,Egg Harbor,244,0,19,81,76,37,213
Wisconsin,Necedah,944,70,294,215,38,43,660
Wisconsin,New Lisbon,2502,240,833,744,105,46,1968
Wisconsin,Spring Green,1716,88,325,456,286,138,1293
Wisconsin,Wausau,38801,2659,7797,8605,5277,2567,26905
Wisconsin,Rothschild,5281,158,1171,1236,795,308,3668
Wisconsin,Eleva,774,20,169,191,75,26,481
Wisconsin,Taylor,411,28,163,89,10,5,295
Wisconsin,Abbotsford,2175,219,753,320,109,21,1422
Wisconsin,Barneveld,1276,27,201,343,148,60,779
Wisconsin,Highland,986,59,239,196,95,22,611
Wisconsin,Elkhart Lake,1076,24,203,233,176,117,753
Wisconsin,Sheboygan Falls,7878,313,2258,1705,949,395,5620
Wisconsin,Waldo,634,22,173,174,49,10,428
Wisconsin,Plainfield,897,113,261,144,23,18,559
Wisconsin,Kenosha,99810,7269,20168,21477,10146,5310,64370
Wisconsin,Cottage Grove,6904,326,775,1289,1210,645,4245
Wisconsin,Fontana-on-Geneva Lake,1507,35,185,286,491,257,1254
Wisconsin,Dane,1098,82,201,280,179,32,774
Wisconsin,Oregon,10215,149,1222,1921,2089,1059,6440
Wisconsin,Hebron,170,3,100,35,14,3,155
Wisconsin,Barron,3334,408,614,663,216,64,1965
Wisconsin,Markesan,1260,119,355,221,135,45,875
Wisconsin,Conrath,76,18,24,6,5,2,55
Wisconsin,Glen Flora,97,3,12,38,8,0,61
Wisconsin,Francis Creek,550,9,177,151,47,19,403
Wisconsin,Reedsville,1132,56,351,247,89,40,783
Wisconsin,Bay City,468,35,160,93,32,0,320
Wyoming,Auburn,556,0,101,92,50,58,301
Wyoming,Thayne,451,49,108,78,24,24,283
Wyoming,Garland,282,31,58,90,0,11,190
Wyoming,Shoshoni,505,56,174,122,11,18,381
Wyoming,Byron,523,18,103,142,60,13,336
Wyoming,Albany,25,0,0,10,12,3,25
Wyoming,Moorcroft,905,15,195,221,64,27,522
Wyoming,Burlington,247,8,37,58,30,6,139
Wyoming,Atlantic City,0,0,0,0,0,0,0
Wyoming,Fort Washakie,1823,120,351,382,57,37,947
Wyoming,Jeffrey City,29,15,14,0,0,0,29
Wyoming,Slater,84,0,41,6,11,0,58
Wyoming,Fontenelle,18,0,18,0,0,0,18
Wyoming,Buffalo,4586,138,891,1222,701,323,3275
Wyoming,James Town,692,15,105,199,106,54,479
Wyoming,Lusk,1701,137,382,477,80,33,1109
Wyoming,Baggs,440,26,126,56,45,16,269
Wyoming,Fox Park,0,0,0,0,0,0,0
Wyoming,Whiting,99,0,64,35,0,0,99
Wyoming,Urie,491,0,126,220,33,0,379
Wyoming,Shell,138,0,20,86,0,0,106
Wyoming,Ryan Park,0,0,0,0,0,0,0
Wyoming,Osmond,266,8,85,84,0,55,232
Wyoming,Orin,74,0,0,20,34,20,74
Wyoming,Nordic,391,23,193,135,0,0,351
Wyoming,Mammoth,51,0,2,18,16,5,41
Wyoming,Kelly,0,0,0,0,0,0,0
Wyoming,Hillsdale,0,0,0,0,0,0,0
Wyoming,Freedom,247,17,0,72,41,0,130
Wyoming,Carpenter,380,0,190,69,21,0,280
Wyoming,Beulah,0,0,0,0,0,0,0
Wyoming,Arlington,6,0,0,6,0,0,6
Wyoming,Etna,41,19,22,0,0,0,41
Wyoming,Sleepy Hollow,1010,47,202,259,176,20,704
Wyoming,Chugwater,262,20,69,77,27,15,208
Wyoming,Casper Mountain,695,0,114,163,184,72,533
Wyoming,Carter,0,0,0,0,0,0,0
Wyoming,Moose Wilson Road,1479,43,229,276,550,153,1251
Wyoming,Arapahoe,1689,114,269,394,56,27,860
Wyoming,South Greeley,4345,539,796,1230,273,35,2873
Wyoming,Lost Springs,1,0,1,0,0,0,1
Wyoming,Saratoga,1445,69,396,407,177,60,1109
Wyoming,Meeteetse,295,9,58,107,40,35,249
Wyoming,Hartrandt,745,66,288,157,0,12,523
Wyoming,Parkman,116,26,18,49,23,0,116
Wyoming,Brookhurst,238,0,51,76,23,64,214
Wyoming,Ranchettes,6097,114,1055,1528,1259,686,4642
Wyoming,Evanston,11953,728,2980,2821,591,389,7509
Wyoming,Deaver,175,13,23,66,20,4,126
Wyoming,Fox Farm-College,4424,559,850,903,98,13,2423
Wyoming,Meadow Acres,173,0,16,94,8,10,128
Wyoming,Arrowhead Springs,131,0,13,24,12,40,89
Wyoming,Osage,104,0,76,0,0,0,76
Wyoming,Torrington,6717,321,1408,1687,669,406,4491
Wyoming,Granger,50,12,35,3,0,0,50
Wyoming,Bear River,619,17,166,153,40,10,386
Wyoming,Encampment,437,5,116,76,77,28,302
Wyoming,Star Valley Ranch,1869,70,407,531,310,112,1430
Wyoming,Veteran,70,15,0,16,0,0,31
Wyoming,Ranchester,1041,54,169,259,76,33,591
Wyoming,Story,639,0,86,327,35,84,532
Wyoming,Lonetree,0,0,0,0,0,0,0
Wyoming,Manville,107,41,20,35,5,2,103
Wyoming,Van Tassell,29,0,6,10,9,0,25
Wyoming,Alpine,716,68,163,258,102,8,599
Wyoming,Cheyenne,63243,2648,10832,16319,8195,4816,42810
Wyoming,Hyattville,112,0,9,57,34,12,112
Wyoming,Hoback,1227,17,213,344,209,118,901
Wyoming,Big Horn,490,0,40,132,70,74,316
Wyoming,Wilson,1731,0,0,286,665,316,1267
Wyoming,Edgerton,172,38,46,49,5,0,138
Wyoming,Casper,58756,2641,10344,16188,6213,3516,38902
Wyoming,Lingle,596,40,103,191,66,32,432
Wyoming,Bessemer Bend,183,0,79,58,12,16,165
Wyoming,Clearmont,147,14,43,25,11,11,104
Wyoming,Pinedale,2263,46,651,512,183,64,1456
Wyoming,Hawk Springs,7,0,0,0,0,7,7
Wyoming,Daniel,191,0,87,23,21,0,131
Wyoming,Cora,47,0,12,22,13,0,47
Wyoming,Hartville,71,4,35,16,12,4,71
Wyoming,La Barge,326,30,96,79,15,2,222
Wyoming,Huntley,0,0,0,0,0,0,0
Wyoming,Clearview Acres,1568,157,343,276,20,0,796
Wyoming,Little America,84,0,41,0,0,0,41
Wyoming,McKinnon,0,0,0,0,0,0,0
Wyoming,Vista West,1016,46,243,264,99,102,754
Wyoming,Ralston,478,0,141,170,15,0,326
Wyoming,Bairoil,197,10,69,56,17,0,152
Wyoming,Green River,12278,566,2539,3279,1245,479,8108
Wyoming,North Rock Springs,2128,43,741,573,114,34,1505
Wyoming,Table Rock,0,0,0,0,0,0,0
Wyoming,Wamsutter,160,16,55,29,21,0,121
Wyoming,Mountain View,55,0,22,28,5,0,55
Wyoming,Hill View Heights,63,0,37,20,6,0,63
Wyoming,Westview Circle,0,0,0,0,0,0,0
Wyoming,Cody,9761,208,1601,2616,1529,870,6824
Wyoming,Frannie,137,13,22,56,4,0,95
Wyoming,Eden,199,10,52,11,45,0,118
Wyoming,Purple Sage,812,159,224,15,18,0,416
Wyoming,Washam,0,0,0,0,0,0,0
Wyoming,Point of Rocks,141,0,9,47,34,0,90
Wyoming,Ten Sleep,176,8,44,56,36,12,156
Wyoming,South Park,1612,0,0,330,442,301,1073
Wyoming,Worland,5236,403,963,1334,496,207,3403
Wyoming,Newcastle,3461,205,699,1000,320,117,2341
Wyoming,Opal,113,22,32,36,2,0,92
Wyoming,Rock Springs,23633,1361,4609,5044,2566,1293,14873
Wyoming,Afton,2234,80,247,569,231,104,1231
Wyoming,Cokeville,579,10,106,122,50,33,321
Wyoming,Yoder,120,7,52,15,15,4,93
Wyoming,Glendo,239,9,76,67,15,0,167
Wyoming,Marbleton,1165,161,290,194,131,14,790
Wyoming,Upton,963,59,301,176,84,35,655
Wyoming,Arvada,39,0,5,14,7,0,26
Wyoming,Alcova,0,0,0,0,0,0,0
Wyoming,Bar Nunn,2787,81,596,790,201,54,1722
Wyoming,Farson,44,0,0,14,30,0,44
Wyoming,Reliance,496,75,141,125,14,17,372
Wyoming,Superior,307,19,76,96,12,4,207
Wyoming,Homa Hills,245,117,31,73,0,0,221
Wyoming,Powell,6349,405,1151,1301,542,581,3980
Wyoming,Sheridan,17825,689,3094,4944,2111,1534,12372
Wyoming,Basin,1596,119,422,397,165,33,1136
Wyoming,Greybull,1864,155,443,452,131,56,1237
Wyoming,Woods Landing-Jelm,120,0,57,19,20,0,96
Wyoming,Chugcreek,206,0,53,23,0,29,105
Wyoming,Red Butte,546,0,102,174,100,33,409
Wyoming,Mills,3848,350,1125,990,103,65,2633
Wyoming,Antelope Hills,0,0,0,0,0,0,0
Wyoming,Rolling Hills,458,23,131,100,30,24,308
Wyoming,Midwest,295,38,95,68,16,10,227
Wyoming,Ethete,1598,119,225,418,44,21,827
Wyoming,Wheatland,3609,190,832,1055,393,164,2634
Wyoming,Owl Creek,0,0,0,0,0,0,0
Wyoming,Laramie,32178,719,2448,5035,4755,3787,16744
Wyoming,Mountain View,1329,33,375,234,141,4,787
Wyoming,Medicine Bow,349,30,126,81,14,27,278
Wyoming,Esterbrook,58,0,29,16,0,13,58
Wyoming,Douglas,6402,441,1457,1634,417,224,4173
Wyoming,Bondurant,49,0,49,0,0,0,49
Wyoming,Lakeview North,148,0,41,42,27,0,110
Wyoming,Rock River,151,0,58,34,16,7,115
Wyoming,Fairview,175,0,0,76,24,0,100
Wyoming,Boulder,40,0,40,0,0,0,40
Wyoming,La Grange,361,15,34,81,36,5,171
Wyoming,Glenrock,2620,171,655,538,191,112,1667
Wyoming,Turnerville,79,0,0,45,0,17,62
Wyoming,Kemmerer,2730,119,447,770,336,129,1801
Wyoming,Alpine Northwest,16,0,16,0,0,0,16
Wyoming,Dubois,741,59,197,181,102,67,606
Wyoming,Crowheart,130,4,31,37,5,25,102
Wyoming,Boulder Flats,300,21,51,79,26,14,191
Wyoming,Dayton,723,19,131,191,104,77,522
Wyoming,Thermopolis,2884,114,614,899,309,193,2129
Wyoming,Warren AFB,2300,25,56,307,193,183,764
Wyoming,Sinclair,358,32,98,117,32,10,289
Wyoming,Hanna,765,46,179,141,50,44,460
Wyoming,Cowley,769,29,110,196,61,25,421
Wyoming,Teton Village,201,0,39,0,41,58,138
Wyoming,Jackson,10483,785,1150,1547,2889,1218,7589
Wyoming,Alta,369,0,12,207,19,73,311
Wyoming,Lyman,2218,93,389,524,214,69,1289
Wyoming,Dixon,95,2,9,33,9,6,59
Wyoming,Diamondville,708,31,230,202,31,12,506
Wyoming,Taylor,54,0,5,32,7,0,44
Wyoming,Kaycee,258,14,62,70,17,12,175
Wyoming,Riverside,39,0,15,14,4,6,39
Wyoming,Wright,1660,117,485,315,102,67,1086
Wyoming,Gillette,33056,1759,6391,7781,3030,978,19939
Wyoming,Burns,347,14,42,106,27,26,215
Wyoming,Big Piney,572,4,156,93,29,31,313
Wyoming,Y-O Ranch,84,14,55,15,0,0,84
Wyoming,Albin,144,33,11,31,7,2,84
Wyoming,Powder River,0,0,0,0,0,0,0
Wyoming,Guernsey,1179,75,313,245,40,38,711
Wyoming,Smoot,184,15,41,56,26,0,138
Wyoming,Oakley,0,0,0,0,0,0,0
Wyoming,Bedford,261,0,93,0,16,21,130
Wyoming,Lander,7621,353,1493,1574,1152,713,5285
Wyoming,Pine Haven,516,42,88,166,54,23,373
Wyoming,Kirby,85,16,18,25,2,8,69
Wyoming,Evansville,2944,228,751,698,229,37,1943
Wyoming,Alpine Northeast,0,0,0,0,0,0,0
Wyoming,Pine Bluffs,1119,92,253,260,132,37,774
Wyoming,Robertson,49,16,0,0,0,18,34
Wyoming,Grover,302,0,57,0,68,8,133
Wyoming,Riverton,11069,815,2299,2880,1021,405,7420
Wyoming,Lucerne,499,24,107,140,64,29,364
Wyoming,East Thermopolis,254,23,63,85,18,5,194
Wyoming,Centennial,257,0,17,67,123,39,246
Wyoming,Rawlins,8975,696,2203,1937,703,311,5850
Wyoming,Elk Mountain,192,7,37,60,27,8,139
Wyoming,Fort Bridger,201,0,151,12,0,0,163
Wyoming,Manderson,75,18,14,14,11,0,57
Wyoming,Rafter J Ranch,1748,63,221,224,483,422,1413
Wyoming,Lance Creek,18,0,18,0,0,0,18
Wyoming,Pavillion,219,11,45,61,17,6,140
Wyoming,Johnstown,225,17,51,67,23,5,163
Wyoming,Hudson,498,11,131,118,43,14,317
Wyoming,Sundance,1694,67,329,416,124,153,1089
Wyoming,Hulett,394,62,82,125,28,10,307
Wyoming,Lovell,2252,225,530,614,146,38,1553
Wyoming,Fort Laramie,247,5,62,103,12,11,193
